hash,ver,vin_sz,vout_sz,size,weight,fee,relayed_by,lock_time,tx_index,double_spend,time,block_index,block_height,inputs,out,result,balance
b0fd317c960c073fd118a98b964049fcb577aa454706fb85ec53af96ac8863bf,2,2,2,375,846,212,0.0.0.0,0,6733894901749226,False,1751813672,904319,904319,"[{'sequence': 2147483649, 'witness': '02483045022100886eb23c763a53fd96b296238dd06525318b555bd92551f189942fa3e73d82d20220716aa2d90d3a38d37e656b4ef925a387f2777f0f0928aa6e1168d5a36eca7d3201210348c4422daf3013e00ba1ed3c09fe82114d6a1152887c63380c2a673040b38aa1', 'script': '', 'index': 0, 'prev_out': {'type': 0, 'spent': True, 'value': 330, 'spending_outpoints': [{'tx_index': 6733894901749226, 'n': 0}], 'n': 0, 'tx_index': 1419382652654294, 'script': '001409ff72424b6bf9c657f2527095729290a3e04e7e', 'addr': 'bc1qp8lhysjtd0uuv4lj2fcf2u5jjz37qnn7j3pvan'}}, {'sequence': 2147483649, 'witness': '02483045022100be7e7651628cbe6dd6e44d541fe57ffd5343b51dba699530ec6885ab0d4c0fe7022003ce3059116ceb8d62ca93e27c2a206a947bd77be66d13e5ca13e8ed4871753201210348c4422daf3013e00ba1ed3c09fe82114d6a1152887c63380c2a673040b38aa1', 'script': '', 'index': 1, 'prev_out': {'type': 0, 'spent': True, 'value': 7012, 'spending_outpoints': [{'tx_index': 6733894901749226, 'n': 1}], 'n': 2, 'tx_index': 4959864685961962, 'script': '001409ff72424b6bf9c657f2527095729290a3e04e7e', 'addr': 'bc1qp8lhysjtd0uuv4lj2fcf2u5jjz37qnn7j3pvan'}}]","[{'type': 0, 'spent': False, 'value': 546, 'spending_outpoints': [], 'n': 0, 'tx_index': 6733894901749226, 'script': '76a91487ccbdb1aba7e6875f750c0823bd63bf972a2fa988ac', 'addr': '1DP3VYwN6ozHXDDaETbvNFLd86CAXfaewi'}, {'type': 0, 'spent': True, 'value': 6584, 'spending_outpoints': [{'tx_index': 6593062934675547, 'n': 0}], 'n': 1, 'tx_index': 6733894901749226, 'script': '001409ff72424b6bf9c657f2527095729290a3e04e7e', 'addr': 'bc1qp8lhysjtd0uuv4lj2fcf2u5jjz37qnn7j3pvan'}]",546,1000000592767
3ace6d64cf7c7206451813c1ea8d73e6de5fb98c64761b97e9b66e18e451601a,2,1,1,314,569,152,0.0.0.0,0,928031778737622,False,1744407327,891979,891979,"[{'sequence': 4294967295, 'witness': '034047ced2592bd1644cc89d2c754e3b9df80497c51e5a98a1c31700f8ccf1f9c83bea8c5c81e78f637960aaecc0afa76bae19b0439a504cff803985fa8f98defedd7e2066ebbbe72466468fbd884e182966ba9c42196e3dc9a5f2c728cd05e63d93f584ac0063036f7264010118746578742f706c61696e3b636861727365743d7574662d3800387b2270223a226272632d3230222c226f70223a226d696e74222c227469636b223a22f09386ab222c22616d74223a223231312e313131227d6821c166ebbbe72466468fbd884e182966ba9c42196e3dc9a5f2c728cd05e63d93f584', 'script': '', 'index': 0, 'prev_out': {'type': 0, 'spent': True, 'value': 698, 'spending_outpoints': [{'tx_index': 928031778737622, 'n': 0}], 'n': 175, 'tx_index': 1888887378221180, 'script': '51206fc1c55b777f1519df9875e7d4d2ec2558687ca9929b385a20424a9cc2c7fe08', 'addr': 'bc1pdlqu2kmh0u23nhucwhnaf5hvy4vxsl9fj2dnsk3qgf9fesk8lcyq89z6vr'}}]","[{'type': 0, 'spent': False, 'value': 546, 'spending_outpoints': [], 'n': 0, 'tx_index': 928031778737622, 'script': '76a91487ccbdb1aba7e6875f750c0823bd63bf972a2fa988ac', 'addr': '1DP3VYwN6ozHXDDaETbvNFLd86CAXfaewi'}]",546,1000000592221
31fb43d3981769d50a5555475d566a8042ecc7744d8508f0d2e2c398e976af35,2,1,187,8300,32513,8513,0.0.0.0,0,1888887378221180,False,1744406630,891978,891978,"[{'sequence': 4294967293, 'witness': '034012b18dd685e1cc6deaca7a09b67e11b905de76f0d2cb9e3f4238d235602fb42e0f284646038a955be5663358fc66874b77f3da8f7242771f232a447cd43a68567e2066ebbbe72466468fbd884e182966ba9c42196e3dc9a5f2c728cd05e63d93f584ac0063036f7264010118746578742f706c61696e3b636861727365743d7574662d3800387b2270223a226272632d3230222c226f70223a226d696e74222c227469636b223a22f09386ab222c22616d74223a223231312e313131227d6821c166ebbbe72466468fbd884e182966ba9c42196e3dc9a5f2c728cd05e63d93f584', 'script': '', 'index': 0, 'prev_out': {'type': 0, 'spent': True, 'value': 143188, 'spending_outpoints': [{'tx_index': 1888887378221180, 'n': 0}], 'n': 0, 'tx_index': 587319365600597, 'script': '51206fc1c55b777f1519df9875e7d4d2ec2558687ca9929b385a20424a9cc2c7fe08', 'addr': 'bc1pdlqu2kmh0u23nhucwhnaf5hvy4vxsl9fj2dnsk3qgf9fesk8lcyq89z6vr'}}]","[{'type': 0, 'spent': False, 'value': 546, 'spending_outpoints': [], 'n': 0, 'tx_index': 1888887378221180, 'script': '76a91487ccbdb1aba7e6875f750c0823bd63bf972a2fa988ac', 'addr': '1DP3VYwN6ozHXDDaETbvNFLd86CAXfaewi'}, {'type': 0, 'spent': True, 'value': 698, 'spending_outpoints': [{'tx_index': 3454692361628902, 'n': 0}], 'n': 1, 'tx_index': 1888887378221180, 'script': '51206fc1c55b777f1519df9875e7d4d2ec2558687ca9929b385a20424a9cc2c7fe08', 'addr': 'bc1pdlqu2kmh0u23nhucwhnaf5hvy4vxsl9fj2dnsk3qgf9fesk8lcyq89z6vr'}, {'type': 0, 'spent': True, 'value': 698, 'spending_outpoints': [{'tx_index': 3294111212057976, 'n': 0}], 'n': 2, 'tx_index': 1888887378221180, 'script': '51206fc1c55b777f1519df9875e7d4d2ec2558687ca9929b385a20424a9cc2c7fe08', 'addr': 'bc1pdlqu2kmh0u23nhucwhnaf5hvy4vxsl9fj2dnsk3qgf9fesk8lcyq89z6vr'}, {'type': 0, 'spent': True, 'value': 698, 'spending_outpoints': [{'tx_index': 6432075181825048, 'n': 0}], 'n': 3, 'tx_index': 1888887378221180, 'script': '51206fc1c55b777f1519df9875e7d4d2ec2558687ca9929b385a20424a9cc2c7fe08', 'addr': 'bc1pdlqu2kmh0u23nhucwhnaf5hvy4vxsl9fj2dnsk3qgf9fesk8lcyq89z6vr'}, {'type': 0, 'spent': True, 'value': 698, 'spending_outpoints': [{'tx_index': 2945450912494099, 'n': 0}], 'n': 4, 'tx_index': 1888887378221180, 'script': '51206fc1c55b777f1519df9875e7d4d2ec2558687ca9929b385a20424a9cc2c7fe08', 'addr': 'bc1pdlqu2kmh0u23nhucwhnaf5hvy4vxsl9fj2dnsk3qgf9fesk8lcyq89z6vr'}, {'type': 0, 'spent': True, 'value': 698, 'spending_outpoints': [{'tx_index': 1640749539296962, 'n': 0}], 'n': 5, 'tx_index': 1888887378221180, 'script': '51206fc1c55b777f1519df9875e7d4d2ec2558687ca9929b385a20424a9cc2c7fe08', 'addr': 'bc1pdlqu2kmh0u23nhucwhnaf5hvy4vxsl9fj2dnsk3qgf9fesk8lcyq89z6vr'}, {'type': 0, 'spent': True, 'value': 696, 'spending_outpoints': [{'tx_index': 1536466792518889, 'n': 0}], 'n': 6, 'tx_index': 1888887378221180, 'script': '51206fc1c55b777f1519df9875e7d4d2ec2558687ca9929b385a20424a9cc2c7fe08', 'addr': 'bc1pdlqu2kmh0u23nhucwhnaf5hvy4vxsl9fj2dnsk3qgf9fesk8lcyq89z6vr'}, {'type': 0, 'spent': True, 'value': 696, 'spending_outpoints': [{'tx_index': 3285590405876308, 'n': 0}], 'n': 7, 'tx_index': 1888887378221180, 'script': '51206fc1c55b777f1519df9875e7d4d2ec2558687ca9929b385a20424a9cc2c7fe08', 'addr': 'bc1pdlqu2kmh0u23nhucwhnaf5hvy4vxsl9fj2dnsk3qgf9fesk8lcyq89z6vr'}, {'type': 0, 'spent': True, 'value': 695, 'spending_outpoints': [{'tx_index': 5666521829323303, 'n': 0}], 'n': 8, 'tx_index': 1888887378221180, 'script': '51206fc1c55b777f1519df9875e7d4d2ec2558687ca9929b385a20424a9cc2c7fe08', 'addr': 'bc1pdlqu2kmh0u23nhucwhnaf5hvy4vxsl9fj2dnsk3qgf9fesk8lcyq89z6vr'}, {'type': 0, 'spent': True, 'value': 695, 'spending_outpoints': [{'tx_index': 8987193391104877, 'n': 0}], 'n': 9, 'tx_index': 1888887378221180, 'script': '51206fc1c55b777f1519df9875e7d4d2ec2558687ca9929b385a20424a9cc2c7fe08', 'addr': 'bc1pdlqu2kmh0u23nhucwhnaf5hvy4vxsl9fj2dnsk3qgf9fesk8lcyq89z6vr'}, {'type': 0, 'spent': True, 'value': 695, 'spending_outpoints': [{'tx_index': 4636911631804787, 'n': 0}], 'n': 10, 'tx_index': 1888887378221180, 'script': '51206fc1c55b777f1519df9875e7d4d2ec2558687ca9929b385a20424a9cc2c7fe08', 'addr': 'bc1pdlqu2kmh0u23nhucwhnaf5hvy4vxsl9fj2dnsk3qgf9fesk8lcyq89z6vr'}, {'type': 0, 'spent': True, 'value': 695, 'spending_outpoints': [{'tx_index': 4768697421246326, 'n': 0}], 'n': 11, 'tx_index': 1888887378221180, 'script': '51206fc1c55b777f1519df9875e7d4d2ec2558687ca9929b385a20424a9cc2c7fe08', 'addr': 'bc1pdlqu2kmh0u23nhucwhnaf5hvy4vxsl9fj2dnsk3qgf9fesk8lcyq89z6vr'}, {'type': 0, 'spent': True, 'value': 708, 'spending_outpoints': [{'tx_index': 8685130077887140, 'n': 0}], 'n': 12, 'tx_index': 1888887378221180, 'script': '51206fc1c55b777f1519df9875e7d4d2ec2558687ca9929b385a20424a9cc2c7fe08', 'addr': 'bc1pdlqu2kmh0u23nhucwhnaf5hvy4vxsl9fj2dnsk3qgf9fesk8lcyq89z6vr'}, {'type': 0, 'spent': True, 'value': 708, 'spending_outpoints': [{'tx_index': 2984970454530185, 'n': 0}], 'n': 13, 'tx_index': 1888887378221180, 'script': '51206fc1c55b777f1519df9875e7d4d2ec2558687ca9929b385a20424a9cc2c7fe08', 'addr': 'bc1pdlqu2kmh0u23nhucwhnaf5hvy4vxsl9fj2dnsk3qgf9fesk8lcyq89z6vr'}, {'type': 0, 'spent': True, 'value': 695, 'spending_outpoints': [{'tx_index': 4878338706171129, 'n': 0}], 'n': 14, 'tx_index': 1888887378221180, 'script': '51206fc1c55b777f1519df9875e7d4d2ec2558687ca9929b385a20424a9cc2c7fe08', 'addr': 'bc1pdlqu2kmh0u23nhucwhnaf5hvy4vxsl9fj2dnsk3qgf9fesk8lcyq89z6vr'}, {'type': 0, 'spent': True, 'value': 708, 'spending_outpoints': [{'tx_index': 1971799156984742, 'n': 0}], 'n': 15, 'tx_index': 1888887378221180, 'script': '51206fc1c55b777f1519df9875e7d4d2ec2558687ca9929b385a20424a9cc2c7fe08', 'addr': 'bc1pdlqu2kmh0u23nhucwhnaf5hvy4vxsl9fj2dnsk3qgf9fesk8lcyq89z6vr'}, {'type': 0, 'spent': True, 'value': 708, 'spending_outpoints': [{'tx_index': 1129728413075721, 'n': 0}], 'n': 16, 'tx_index': 1888887378221180, 'script': '51206fc1c55b777f1519df9875e7d4d2ec2558687ca9929b385a20424a9cc2c7fe08', 'addr': 'bc1pdlqu2kmh0u23nhucwhnaf5hvy4vxsl9fj2dnsk3qgf9fesk8lcyq89z6vr'}, {'type': 0, 'spent': True, 'value': 695, 'spending_outpoints': [{'tx_index': 5172073920779363, 'n': 0}], 'n': 17, 'tx_index': 1888887378221180, 'script': '51206fc1c55b777f1519df9875e7d4d2ec2558687ca9929b385a20424a9cc2c7fe08', 'addr': 'bc1pdlqu2kmh0u23nhucwhnaf5hvy4vxsl9fj2dnsk3qgf9fesk8lcyq89z6vr'}, {'type': 0, 'spent': True, 'value': 696, 'spending_outpoints': [{'tx_index': 8936273949117849, 'n': 0}], 'n': 18, 'tx_index': 1888887378221180, 'script': '51206fc1c55b777f1519df9875e7d4d2ec2558687ca9929b385a20424a9cc2c7fe08', 'addr': 'bc1pdlqu2kmh0u23nhucwhnaf5hvy4vxsl9fj2dnsk3qgf9fesk8lcyq89z6vr'}, {'type': 0, 'spent': True, 'value': 708, 'spending_outpoints': [{'tx_index': 5033992293208775, 'n': 0}], 'n': 19, 'tx_index': 1888887378221180, 'script': '51206fc1c55b777f1519df9875e7d4d2ec2558687ca9929b385a20424a9cc2c7fe08', 'addr': 'bc1pdlqu2kmh0u23nhucwhnaf5hvy4vxsl9fj2dnsk3qgf9fesk8lcyq89z6vr'}, {'type': 0, 'spent': True, 'value': 695, 'spending_outpoints': [{'tx_index': 7287318386388862, 'n': 0}], 'n': 20, 'tx_index': 1888887378221180, 'script': '51206fc1c55b777f1519df9875e7d4d2ec2558687ca9929b385a20424a9cc2c7fe08', 'addr': 'bc1pdlqu2kmh0u23nhucwhnaf5hvy4vxsl9fj2dnsk3qgf9fesk8lcyq89z6vr'}, {'type': 0, 'spent': True, 'value': 696, 'spending_outpoints': [{'tx_index': 4195577382347896, 'n': 0}], 'n': 21, 'tx_index': 1888887378221180, 'script': '51206fc1c55b777f1519df9875e7d4d2ec2558687ca9929b385a20424a9cc2c7fe08', 'addr': 'bc1pdlqu2kmh0u23nhucwhnaf5hvy4vxsl9fj2dnsk3qgf9fesk8lcyq89z6vr'}, {'type': 0, 'spent': True, 'value': 698, 'spending_outpoints': [{'tx_index': 4344601948297059, 'n': 0}], 'n': 22, 'tx_index': 1888887378221180, 'script': '51206fc1c55b777f1519df9875e7d4d2ec2558687ca9929b385a20424a9cc2c7fe08', 'addr': 'bc1pdlqu2kmh0u23nhucwhnaf5hvy4vxsl9fj2dnsk3qgf9fesk8lcyq89z6vr'}, {'type': 0, 'spent': True, 'value': 708, 'spending_outpoints': [{'tx_index': 5485072575862281, 'n': 0}], 'n': 23, 'tx_index': 1888887378221180, 'script': '51206fc1c55b777f1519df9875e7d4d2ec2558687ca9929b385a20424a9cc2c7fe08', 'addr': 'bc1pdlqu2kmh0u23nhucwhnaf5hvy4vxsl9fj2dnsk3qgf9fesk8lcyq89z6vr'}, {'type': 0, 'spent': True, 'value': 695, 'spending_outpoints': [{'tx_index': 7908965352216943, 'n': 0}], 'n': 24, 'tx_index': 1888887378221180, 'script': '51206fc1c55b777f1519df9875e7d4d2ec2558687ca9929b385a20424a9cc2c7fe08', 'addr': 'bc1pdlqu2kmh0u23nhucwhnaf5hvy4vxsl9fj2dnsk3qgf9fesk8lcyq89z6vr'}, {'type': 0, 'spent': True, 'value': 696, 'spending_outpoints': [{'tx_index': 5920951271807909, 'n': 0}], 'n': 25, 'tx_index': 1888887378221180, 'script': '51206fc1c55b777f1519df9875e7d4d2ec2558687ca9929b385a20424a9cc2c7fe08', 'addr': 'bc1pdlqu2kmh0u23nhucwhnaf5hvy4vxsl9fj2dnsk3qgf9fesk8lcyq89z6vr'}, {'type': 0, 'spent': True, 'value': 698, 'spending_outpoints': [{'tx_index': 2865141382772485, 'n': 0}], 'n': 26, 'tx_index': 1888887378221180, 'script': '51206fc1c55b777f1519df9875e7d4d2ec2558687ca9929b385a20424a9cc2c7fe08', 'addr': 'bc1pdlqu2kmh0u23nhucwhnaf5hvy4vxsl9fj2dnsk3qgf9fesk8lcyq89z6vr'}, {'type': 0, 'spent': True, 'value': 708, 'spending_outpoints': [{'tx_index': 62979410531668, 'n': 0}], 'n': 27, 'tx_index': 1888887378221180, 'script': '51206fc1c55b777f1519df9875e7d4d2ec2558687ca9929b385a20424a9cc2c7fe08', 'addr': 'bc1pdlqu2kmh0u23nhucwhnaf5hvy4vxsl9fj2dnsk3qgf9fesk8lcyq89z6vr'}, {'type': 0, 'spent': True, 'value': 695, 'spending_outpoints': [{'tx_index': 413423764690515, 'n': 0}], 'n': 28, 'tx_index': 1888887378221180, 'script': '51206fc1c55b777f1519df9875e7d4d2ec2558687ca9929b385a20424a9cc2c7fe08', 'addr': 'bc1pdlqu2kmh0u23nhucwhnaf5hvy4vxsl9fj2dnsk3qgf9fesk8lcyq89z6vr'}, {'type': 0, 'spent': True, 'value': 696, 'spending_outpoints': [{'tx_index': 8843908517854841, 'n': 0}], 'n': 29, 'tx_index': 1888887378221180, 'script': '51206fc1c55b777f1519df9875e7d4d2ec2558687ca9929b385a20424a9cc2c7fe08', 'addr': 'bc1pdlqu2kmh0u23nhucwhnaf5hvy4vxsl9fj2dnsk3qgf9fesk8lcyq89z6vr'}, {'type': 0, 'spent': True, 'value': 708, 'spending_outpoints': [{'tx_index': 1012241599178754, 'n': 0}], 'n': 30, 'tx_index': 1888887378221180, 'script': '51206fc1c55b777f1519df9875e7d4d2ec2558687ca9929b385a20424a9cc2c7fe08', 'addr': 'bc1pdlqu2kmh0u23nhucwhnaf5hvy4vxsl9fj2dnsk3qgf9fesk8lcyq89z6vr'}, {'type': 0, 'spent': True, 'value': 695, 'spending_outpoints': [{'tx_index': 2497179669530849, 'n': 0}], 'n': 31, 'tx_index': 1888887378221180, 'script': '51206fc1c55b777f1519df9875e7d4d2ec2558687ca9929b385a20424a9cc2c7fe08', 'addr': 'bc1pdlqu2kmh0u23nhucwhnaf5hvy4vxsl9fj2dnsk3qgf9fesk8lcyq89z6vr'}, {'type': 0, 'spent': True, 'value': 708, 'spending_outpoints': [{'tx_index': 4273926453934285, 'n': 0}], 'n': 32, 'tx_index': 1888887378221180, 'script': '51206fc1c55b777f1519df9875e7d4d2ec2558687ca9929b385a20424a9cc2c7fe08', 'addr': 'bc1pdlqu2kmh0u23nhucwhnaf5hvy4vxsl9fj2dnsk3qgf9fesk8lcyq89z6vr'}, {'type': 0, 'spent': True, 'value': 695, 'spending_outpoints': [{'tx_index': 6986342574785549, 'n': 0}], 'n': 33, 'tx_index': 1888887378221180, 'script': '51206fc1c55b777f1519df9875e7d4d2ec2558687ca9929b385a20424a9cc2c7fe08', 'addr': 'bc1pdlqu2kmh0u23nhucwhnaf5hvy4vxsl9fj2dnsk3qgf9fesk8lcyq89z6vr'}, {'type': 0, 'spent': True, 'value': 696, 'spending_outpoints': [{'tx_index': 5124301584903517, 'n': 0}], 'n': 34, 'tx_index': 1888887378221180, 'script': '51206fc1c55b777f1519df9875e7d4d2ec2558687ca9929b385a20424a9cc2c7fe08', 'addr': 'bc1pdlqu2kmh0u23nhucwhnaf5hvy4vxsl9fj2dnsk3qgf9fesk8lcyq89z6vr'}, {'type': 0, 'spent': True, 'value': 698, 'spending_outpoints': [{'tx_index': 1150130840461841, 'n': 0}], 'n': 35, 'tx_index': 1888887378221180, 'script': '51206fc1c55b777f1519df9875e7d4d2ec2558687ca9929b385a20424a9cc2c7fe08', 'addr': 'bc1pdlqu2kmh0u23nhucwhnaf5hvy4vxsl9fj2dnsk3qgf9fesk8lcyq89z6vr'}, {'type': 0, 'spent': True, 'value': 695, 'spending_outpoints': [{'tx_index': 1481883627263201, 'n': 0}], 'n': 36, 'tx_index': 1888887378221180, 'script': '51206fc1c55b777f1519df9875e7d4d2ec2558687ca9929b385a20424a9cc2c7fe08', 'addr': 'bc1pdlqu2kmh0u23nhucwhnaf5hvy4vxsl9fj2dnsk3qgf9fesk8lcyq89z6vr'}, {'type': 0, 'spent': True, 'value': 708, 'spending_outpoints': [{'tx_index': 8485036437980476, 'n': 0}], 'n': 37, 'tx_index': 1888887378221180, 'script': '51206fc1c55b777f1519df9875e7d4d2ec2558687ca9929b385a20424a9cc2c7fe08', 'addr': 'bc1pdlqu2kmh0u23nhucwhnaf5hvy4vxsl9fj2dnsk3qgf9fesk8lcyq89z6vr'}, {'type': 0, 'spent': True, 'value': 696, 'spending_outpoints': [{'tx_index': 1818734248316037, 'n': 0}], 'n': 38, 'tx_index': 1888887378221180, 'script': '51206fc1c55b777f1519df9875e7d4d2ec2558687ca9929b385a20424a9cc2c7fe08', 'addr': 'bc1pdlqu2kmh0u23nhucwhnaf5hvy4vxsl9fj2dnsk3qgf9fesk8lcyq89z6vr'}, {'type': 0, 'spent': True, 'value': 695, 'spending_outpoints': [{'tx_index': 7527408298331707, 'n': 0}], 'n': 39, 'tx_index': 1888887378221180, 'script': '51206fc1c55b777f1519df9875e7d4d2ec2558687ca9929b385a20424a9cc2c7fe08', 'addr': 'bc1pdlqu2kmh0u23nhucwhnaf5hvy4vxsl9fj2dnsk3qgf9fesk8lcyq89z6vr'}, {'type': 0, 'spent': True, 'value': 696, 'spending_outpoints': [{'tx_index': 1668459315876669, 'n': 0}], 'n': 40, 'tx_index': 1888887378221180, 'script': '51206fc1c55b777f1519df9875e7d4d2ec2558687ca9929b385a20424a9cc2c7fe08', 'addr': 'bc1pdlqu2kmh0u23nhucwhnaf5hvy4vxsl9fj2dnsk3qgf9fesk8lcyq89z6vr'}, {'type': 0, 'spent': True, 'value': 696, 'spending_outpoints': [{'tx_index': 5444038356461994, 'n': 0}], 'n': 41, 'tx_index': 1888887378221180, 'script': '51206fc1c55b777f1519df9875e7d4d2ec2558687ca9929b385a20424a9cc2c7fe08', 'addr': 'bc1pdlqu2kmh0u23nhucwhnaf5hvy4vxsl9fj2dnsk3qgf9fesk8lcyq89z6vr'}, {'type': 0, 'spent': True, 'value': 696, 'spending_outpoints': [{'tx_index': 5603966736534950, 'n': 0}], 'n': 42, 'tx_index': 1888887378221180, 'script': '51206fc1c55b777f1519df9875e7d4d2ec2558687ca9929b385a20424a9cc2c7fe08', 'addr': 'bc1pdlqu2kmh0u23nhucwhnaf5hvy4vxsl9fj2dnsk3qgf9fesk8lcyq89z6vr'}, {'type': 0, 'spent': True, 'value': 696, 'spending_outpoints': [{'tx_index': 419727803293742, 'n': 0}], 'n': 43, 'tx_index': 1888887378221180, 'script': '51206fc1c55b777f1519df9875e7d4d2ec2558687ca9929b385a20424a9cc2c7fe08', 'addr': 'bc1pdlqu2kmh0u23nhucwhnaf5hvy4vxsl9fj2dnsk3qgf9fesk8lcyq89z6vr'}, {'type': 0, 'spent': True, 'value': 695, 'spending_outpoints': [{'tx_index': 3461871008415448, 'n': 0}], 'n': 44, 'tx_index': 1888887378221180, 'script': '51206fc1c55b777f1519df9875e7d4d2ec2558687ca9929b385a20424a9cc2c7fe08', 'addr': 'bc1pdlqu2kmh0u23nhucwhnaf5hvy4vxsl9fj2dnsk3qgf9fesk8lcyq89z6vr'}, {'type': 0, 'spent': True, 'value': 696, 'spending_outpoints': [{'tx_index': 6956943274775504, 'n': 0}], 'n': 45, 'tx_index': 1888887378221180, 'script': '51206fc1c55b777f1519df9875e7d4d2ec2558687ca9929b385a20424a9cc2c7fe08', 'addr': 'bc1pdlqu2kmh0u23nhucwhnaf5hvy4vxsl9fj2dnsk3qgf9fesk8lcyq89z6vr'}, {'type': 0, 'spent': True, 'value': 708, 'spending_outpoints': [{'tx_index': 547243816976637, 'n': 0}], 'n': 46, 'tx_index': 1888887378221180, 'script': '51206fc1c55b777f1519df9875e7d4d2ec2558687ca9929b385a20424a9cc2c7fe08', 'addr': 'bc1pdlqu2kmh0u23nhucwhnaf5hvy4vxsl9fj2dnsk3qgf9fesk8lcyq89z6vr'}, {'type': 0, 'spent': True, 'value': 696, 'spending_outpoints': [{'tx_index': 2118925787855944, 'n': 0}], 'n': 47, 'tx_index': 1888887378221180, 'script': '51206fc1c55b777f1519df9875e7d4d2ec2558687ca9929b385a20424a9cc2c7fe08', 'addr': 'bc1pdlqu2kmh0u23nhucwhnaf5hvy4vxsl9fj2dnsk3qgf9fesk8lcyq89z6vr'}, {'type': 0, 'spent': True, 'value': 695, 'spending_outpoints': [{'tx_index': 1834631065233469, 'n': 0}], 'n': 48, 'tx_index': 1888887378221180, 'script': '51206fc1c55b777f1519df9875e7d4d2ec2558687ca9929b385a20424a9cc2c7fe08', 'addr': 'bc1pdlqu2kmh0u23nhucwhnaf5hvy4vxsl9fj2dnsk3qgf9fesk8lcyq89z6vr'}, {'type': 0, 'spent': True, 'value': 708, 'spending_outpoints': [{'tx_index': 8543782512368515, 'n': 0}], 'n': 49, 'tx_index': 1888887378221180, 'script': '51206fc1c55b777f1519df9875e7d4d2ec2558687ca9929b385a20424a9cc2c7fe08', 'addr': 'bc1pdlqu2kmh0u23nhucwhnaf5hvy4vxsl9fj2dnsk3qgf9fesk8lcyq89z6vr'}, {'type': 0, 'spent': True, 'value': 696, 'spending_outpoints': [{'tx_index': 6323359392415084, 'n': 0}], 'n': 50, 'tx_index': 1888887378221180, 'script': '51206fc1c55b777f1519df9875e7d4d2ec2558687ca9929b385a20424a9cc2c7fe08', 'addr': 'bc1pdlqu2kmh0u23nhucwhnaf5hvy4vxsl9fj2dnsk3qgf9fesk8lcyq89z6vr'}, {'type': 0, 'spent': True, 'value': 708, 'spending_outpoints': [{'tx_index': 5771805400723535, 'n': 0}], 'n': 51, 'tx_index': 1888887378221180, 'script': '51206fc1c55b777f1519df9875e7d4d2ec2558687ca9929b385a20424a9cc2c7fe08', 'addr': 'bc1pdlqu2kmh0u23nhucwhnaf5hvy4vxsl9fj2dnsk3qgf9fesk8lcyq89z6vr'}, {'type': 0, 'spent': True, 'value': 695, 'spending_outpoints': [{'tx_index': 8097128444179064, 'n': 0}], 'n': 52, 'tx_index': 1888887378221180, 'script': '51206fc1c55b777f1519df9875e7d4d2ec2558687ca9929b385a20424a9cc2c7fe08', 'addr': 'bc1pdlqu2kmh0u23nhucwhnaf5hvy4vxsl9fj2dnsk3qgf9fesk8lcyq89z6vr'}, {'type': 0, 'spent': True, 'value': 708, 'spending_outpoints': [{'tx_index': 7476089949150782, 'n': 0}], 'n': 53, 'tx_index': 1888887378221180, 'script': '51206fc1c55b777f1519df9875e7d4d2ec2558687ca9929b385a20424a9cc2c7fe08', 'addr': 'bc1pdlqu2kmh0u23nhucwhnaf5hvy4vxsl9fj2dnsk3qgf9fesk8lcyq89z6vr'}, {'type': 0, 'spent': True, 'value': 695, 'spending_outpoints': [{'tx_index': 8384341530125305, 'n': 0}], 'n': 54, 'tx_index': 1888887378221180, 'script': '51206fc1c55b777f1519df9875e7d4d2ec2558687ca9929b385a20424a9cc2c7fe08', 'addr': 'bc1pdlqu2kmh0u23nhucwhnaf5hvy4vxsl9fj2dnsk3qgf9fesk8lcyq89z6vr'}, {'type': 0, 'spent': True, 'value': 696, 'spending_outpoints': [{'tx_index': 6217359577205175, 'n': 0}], 'n': 55, 'tx_index': 1888887378221180, 'script': '51206fc1c55b777f1519df9875e7d4d2ec2558687ca9929b385a20424a9cc2c7fe08', 'addr': 'bc1pdlqu2kmh0u23nhucwhnaf5hvy4vxsl9fj2dnsk3qgf9fesk8lcyq89z6vr'}, {'type': 0, 'spent': True, 'value': 708, 'spending_outpoints': [{'tx_index': 6599166044870090, 'n': 0}], 'n': 56, 'tx_index': 1888887378221180, 'script': '51206fc1c55b777f1519df9875e7d4d2ec2558687ca9929b385a20424a9cc2c7fe08', 'addr': 'bc1pdlqu2kmh0u23nhucwhnaf5hvy4vxsl9fj2dnsk3qgf9fesk8lcyq89z6vr'}, {'type': 0, 'spent': True, 'value': 696, 'spending_outpoints': [{'tx_index': 7869083884370804, 'n': 0}], 'n': 57, 'tx_index': 1888887378221180, 'script': '51206fc1c55b777f1519df9875e7d4d2ec2558687ca9929b385a20424a9cc2c7fe08', 'addr': 'bc1pdlqu2kmh0u23nhucwhnaf5hvy4vxsl9fj2dnsk3qgf9fesk8lcyq89z6vr'}, {'type': 0, 'spent': True, 'value': 698, 'spending_outpoints': [{'tx_index': 8402835430185471, 'n': 0}], 'n': 58, 'tx_index': 1888887378221180, 'script': '51206fc1c55b777f1519df9875e7d4d2ec2558687ca9929b385a20424a9cc2c7fe08', 'addr': 'bc1pdlqu2kmh0u23nhucwhnaf5hvy4vxsl9fj2dnsk3qgf9fesk8lcyq89z6vr'}, {'type': 0, 'spent': True, 'value': 698, 'spending_outpoints': [{'tx_index': 8753631928011451, 'n': 0}], 'n': 59, 'tx_index': 1888887378221180, 'script': '51206fc1c55b777f1519df9875e7d4d2ec2558687ca9929b385a20424a9cc2c7fe08', 'addr': 'bc1pdlqu2kmh0u23nhucwhnaf5hvy4vxsl9fj2dnsk3qgf9fesk8lcyq89z6vr'}, {'type': 0, 'spent': True, 'value': 698, 'spending_outpoints': [{'tx_index': 1949087942700920, 'n': 0}], 'n': 60, 'tx_index': 1888887378221180, 'script': '51206fc1c55b777f1519df9875e7d4d2ec2558687ca9929b385a20424a9cc2c7fe08', 'addr': 'bc1pdlqu2kmh0u23nhucwhnaf5hvy4vxsl9fj2dnsk3qgf9fesk8lcyq89z6vr'}, {'type': 0, 'spent': True, 'value': 698, 'spending_outpoints': [{'tx_index': 7034863842825062, 'n': 0}], 'n': 61, 'tx_index': 1888887378221180, 'script': '51206fc1c55b777f1519df9875e7d4d2ec2558687ca9929b385a20424a9cc2c7fe08', 'addr': 'bc1pdlqu2kmh0u23nhucwhnaf5hvy4vxsl9fj2dnsk3qgf9fesk8lcyq89z6vr'}, {'type': 0, 'spent': True, 'value': 696, 'spending_outpoints': [{'tx_index': 1266061706452727, 'n': 0}], 'n': 62, 'tx_index': 1888887378221180, 'script': '51206fc1c55b777f1519df9875e7d4d2ec2558687ca9929b385a20424a9cc2c7fe08', 'addr': 'bc1pdlqu2kmh0u23nhucwhnaf5hvy4vxsl9fj2dnsk3qgf9fesk8lcyq89z6vr'}, {'type': 0, 'spent': True, 'value': 696, 'spending_outpoints': [{'tx_index': 5405377824414313, 'n': 0}], 'n': 63, 'tx_index': 1888887378221180, 'script': '51206fc1c55b777f1519df9875e7d4d2ec2558687ca9929b385a20424a9cc2c7fe08', 'addr': 'bc1pdlqu2kmh0u23nhucwhnaf5hvy4vxsl9fj2dnsk3qgf9fesk8lcyq89z6vr'}, {'type': 0, 'spent': True, 'value': 696, 'spending_outpoints': [{'tx_index': 3802419349615596, 'n': 0}], 'n': 64, 'tx_index': 1888887378221180, 'script': '51206fc1c55b777f1519df9875e7d4d2ec2558687ca9929b385a20424a9cc2c7fe08', 'addr': 'bc1pdlqu2kmh0u23nhucwhnaf5hvy4vxsl9fj2dnsk3qgf9fesk8lcyq89z6vr'}, {'type': 0, 'spent': True, 'value': 708, 'spending_outpoints': [{'tx_index': 5003039712154588, 'n': 0}], 'n': 65, 'tx_index': 1888887378221180, 'script': '51206fc1c55b777f1519df9875e7d4d2ec2558687ca9929b385a20424a9cc2c7fe08', 'addr': 'bc1pdlqu2kmh0u23nhucwhnaf5hvy4vxsl9fj2dnsk3qgf9fesk8lcyq89z6vr'}, {'type': 0, 'spent': True, 'value': 696, 'spending_outpoints': [{'tx_index': 3894851925386681, 'n': 0}], 'n': 66, 'tx_index': 1888887378221180, 'script': '51206fc1c55b777f1519df9875e7d4d2ec2558687ca9929b385a20424a9cc2c7fe08', 'addr': 'bc1pdlqu2kmh0u23nhucwhnaf5hvy4vxsl9fj2dnsk3qgf9fesk8lcyq89z6vr'}, {'type': 0, 'spent': True, 'value': 695, 'spending_outpoints': [{'tx_index': 7282912528752871, 'n': 0}], 'n': 67, 'tx_index': 1888887378221180, 'script': '51206fc1c55b777f1519df9875e7d4d2ec2558687ca9929b385a20424a9cc2c7fe08', 'addr': 'bc1pdlqu2kmh0u23nhucwhnaf5hvy4vxsl9fj2dnsk3qgf9fesk8lcyq89z6vr'}, {'type': 0, 'spent': True, 'value': 696, 'spending_outpoints': [{'tx_index': 7792386325767583, 'n': 0}], 'n': 68, 'tx_index': 1888887378221180, 'script': '51206fc1c55b777f1519df9875e7d4d2ec2558687ca9929b385a20424a9cc2c7fe08', 'addr': 'bc1pdlqu2kmh0u23nhucwhnaf5hvy4vxsl9fj2dnsk3qgf9fesk8lcyq89z6vr'}, {'type': 0, 'spent': True, 'value': 696, 'spending_outpoints': [{'tx_index': 5794604616428159, 'n': 0}], 'n': 69, 'tx_index': 1888887378221180, 'script': '51206fc1c55b777f1519df9875e7d4d2ec2558687ca9929b385a20424a9cc2c7fe08', 'addr': 'bc1pdlqu2kmh0u23nhucwhnaf5hvy4vxsl9fj2dnsk3qgf9fesk8lcyq89z6vr'}, {'type': 0, 'spent': True, 'value': 698, 'spending_outpoints': [{'tx_index': 5569411890303708, 'n': 0}], 'n': 70, 'tx_index': 1888887378221180, 'script': '51206fc1c55b777f1519df9875e7d4d2ec2558687ca9929b385a20424a9cc2c7fe08', 'addr': 'bc1pdlqu2kmh0u23nhucwhnaf5hvy4vxsl9fj2dnsk3qgf9fesk8lcyq89z6vr'}, {'type': 0, 'spent': True, 'value': 698, 'spending_outpoints': [{'tx_index': 7710356969810461, 'n': 0}], 'n': 71, 'tx_index': 1888887378221180, 'script': '51206fc1c55b777f1519df9875e7d4d2ec2558687ca9929b385a20424a9cc2c7fe08', 'addr': 'bc1pdlqu2kmh0u23nhucwhnaf5hvy4vxsl9fj2dnsk3qgf9fesk8lcyq89z6vr'}, {'type': 0, 'spent': True, 'value': 698, 'spending_outpoints': [{'tx_index': 315226094290306, 'n': 0}], 'n': 72, 'tx_index': 1888887378221180, 'script': '51206fc1c55b777f1519df9875e7d4d2ec2558687ca9929b385a20424a9cc2c7fe08', 'addr': 'bc1pdlqu2kmh0u23nhucwhnaf5hvy4vxsl9fj2dnsk3qgf9fesk8lcyq89z6vr'}, {'type': 0, 'spent': True, 'value': 708, 'spending_outpoints': [{'tx_index': 3134687932269891, 'n': 0}], 'n': 73, 'tx_index': 1888887378221180, 'script': '51206fc1c55b777f1519df9875e7d4d2ec2558687ca9929b385a20424a9cc2c7fe08', 'addr': 'bc1pdlqu2kmh0u23nhucwhnaf5hvy4vxsl9fj2dnsk3qgf9fesk8lcyq89z6vr'}, {'type': 0, 'spent': True, 'value': 695, 'spending_outpoints': [{'tx_index': 4448079002819766, 'n': 0}], 'n': 74, 'tx_index': 1888887378221180, 'script': '51206fc1c55b777f1519df9875e7d4d2ec2558687ca9929b385a20424a9cc2c7fe08', 'addr': 'bc1pdlqu2kmh0u23nhucwhnaf5hvy4vxsl9fj2dnsk3qgf9fesk8lcyq89z6vr'}, {'type': 0, 'spent': True, 'value': 696, 'spending_outpoints': [{'tx_index': 6644624493511458, 'n': 0}], 'n': 75, 'tx_index': 1888887378221180, 'script': '51206fc1c55b777f1519df9875e7d4d2ec2558687ca9929b385a20424a9cc2c7fe08', 'addr': 'bc1pdlqu2kmh0u23nhucwhnaf5hvy4vxsl9fj2dnsk3qgf9fesk8lcyq89z6vr'}, {'type': 0, 'spent': True, 'value': 708, 'spending_outpoints': [{'tx_index': 2291745398356174, 'n': 0}], 'n': 76, 'tx_index': 1888887378221180, 'script': '51206fc1c55b777f1519df9875e7d4d2ec2558687ca9929b385a20424a9cc2c7fe08', 'addr': 'bc1pdlqu2kmh0u23nhucwhnaf5hvy4vxsl9fj2dnsk3qgf9fesk8lcyq89z6vr'}, {'type': 0, 'spent': True, 'value': 695, 'spending_outpoints': [{'tx_index': 8708217743118238, 'n': 0}], 'n': 77, 'tx_index': 1888887378221180, 'script': '51206fc1c55b777f1519df9875e7d4d2ec2558687ca9929b385a20424a9cc2c7fe08', 'addr': 'bc1pdlqu2kmh0u23nhucwhnaf5hvy4vxsl9fj2dnsk3qgf9fesk8lcyq89z6vr'}, {'type': 0, 'spent': True, 'value': 695, 'spending_outpoints': [{'tx_index': 7854106304162103, 'n': 0}], 'n': 78, 'tx_index': 1888887378221180, 'script': '51206fc1c55b777f1519df9875e7d4d2ec2558687ca9929b385a20424a9cc2c7fe08', 'addr': 'bc1pdlqu2kmh0u23nhucwhnaf5hvy4vxsl9fj2dnsk3qgf9fesk8lcyq89z6vr'}, {'type': 0, 'spent': True, 'value': 696, 'spending_outpoints': [{'tx_index': 4903323901160233, 'n': 0}], 'n': 79, 'tx_index': 1888887378221180, 'script': '51206fc1c55b777f1519df9875e7d4d2ec2558687ca9929b385a20424a9cc2c7fe08', 'addr': 'bc1pdlqu2kmh0u23nhucwhnaf5hvy4vxsl9fj2dnsk3qgf9fesk8lcyq89z6vr'}, {'type': 0, 'spent': True, 'value': 698, 'spending_outpoints': [{'tx_index': 1381217532713572, 'n': 0}], 'n': 80, 'tx_index': 1888887378221180, 'script': '51206fc1c55b777f1519df9875e7d4d2ec2558687ca9929b385a20424a9cc2c7fe08', 'addr': 'bc1pdlqu2kmh0u23nhucwhnaf5hvy4vxsl9fj2dnsk3qgf9fesk8lcyq89z6vr'}, {'type': 0, 'spent': True, 'value': 695, 'spending_outpoints': [{'tx_index': 3350169208473262, 'n': 0}], 'n': 81, 'tx_index': 1888887378221180, 'script': '51206fc1c55b777f1519df9875e7d4d2ec2558687ca9929b385a20424a9cc2c7fe08', 'addr': 'bc1pdlqu2kmh0u23nhucwhnaf5hvy4vxsl9fj2dnsk3qgf9fesk8lcyq89z6vr'}, {'type': 0, 'spent': True, 'value': 708, 'spending_outpoints': [{'tx_index': 6096761313529222, 'n': 0}], 'n': 82, 'tx_index': 1888887378221180, 'script': '51206fc1c55b777f1519df9875e7d4d2ec2558687ca9929b385a20424a9cc2c7fe08', 'addr': 'bc1pdlqu2kmh0u23nhucwhnaf5hvy4vxsl9fj2dnsk3qgf9fesk8lcyq89z6vr'}, {'type': 0, 'spent': True, 'value': 696, 'spending_outpoints': [{'tx_index': 7481380794887362, 'n': 0}], 'n': 83, 'tx_index': 1888887378221180, 'script': '51206fc1c55b777f1519df9875e7d4d2ec2558687ca9929b385a20424a9cc2c7fe08', 'addr': 'bc1pdlqu2kmh0u23nhucwhnaf5hvy4vxsl9fj2dnsk3qgf9fesk8lcyq89z6vr'}, {'type': 0, 'spent': True, 'value': 695, 'spending_outpoints': [{'tx_index': 314860501447567, 'n': 0}], 'n': 84, 'tx_index': 1888887378221180, 'script': '51206fc1c55b777f1519df9875e7d4d2ec2558687ca9929b385a20424a9cc2c7fe08', 'addr': 'bc1pdlqu2kmh0u23nhucwhnaf5hvy4vxsl9fj2dnsk3qgf9fesk8lcyq89z6vr'}, {'type': 0, 'spent': True, 'value': 696, 'spending_outpoints': [{'tx_index': 257217385386669, 'n': 0}], 'n': 85, 'tx_index': 1888887378221180, 'script': '51206fc1c55b777f1519df9875e7d4d2ec2558687ca9929b385a20424a9cc2c7fe08', 'addr': 'bc1pdlqu2kmh0u23nhucwhnaf5hvy4vxsl9fj2dnsk3qgf9fesk8lcyq89z6vr'}, {'type': 0, 'spent': True, 'value': 698, 'spending_outpoints': [{'tx_index': 2343573063404918, 'n': 0}], 'n': 86, 'tx_index': 1888887378221180, 'script': '51206fc1c55b777f1519df9875e7d4d2ec2558687ca9929b385a20424a9cc2c7fe08', 'addr': 'bc1pdlqu2kmh0u23nhucwhnaf5hvy4vxsl9fj2dnsk3qgf9fesk8lcyq89z6vr'}, {'type': 0, 'spent': True, 'value': 708, 'spending_outpoints': [{'tx_index': 8176028564279631, 'n': 0}], 'n': 87, 'tx_index': 1888887378221180, 'script': '51206fc1c55b777f1519df9875e7d4d2ec2558687ca9929b385a20424a9cc2c7fe08', 'addr': 'bc1pdlqu2kmh0u23nhucwhnaf5hvy4vxsl9fj2dnsk3qgf9fesk8lcyq89z6vr'}, {'type': 0, 'spent': True, 'value': 698, 'spending_outpoints': [{'tx_index': 5113458398366372, 'n': 0}], 'n': 88, 'tx_index': 1888887378221180, 'script': '51206fc1c55b777f1519df9875e7d4d2ec2558687ca9929b385a20424a9cc2c7fe08', 'addr': 'bc1pdlqu2kmh0u23nhucwhnaf5hvy4vxsl9fj2dnsk3qgf9fesk8lcyq89z6vr'}, {'type': 0, 'spent': True, 'value': 698, 'spending_outpoints': [{'tx_index': 2985176905706198, 'n': 0}], 'n': 89, 'tx_index': 1888887378221180, 'script': '51206fc1c55b777f1519df9875e7d4d2ec2558687ca9929b385a20424a9cc2c7fe08', 'addr': 'bc1pdlqu2kmh0u23nhucwhnaf5hvy4vxsl9fj2dnsk3qgf9fesk8lcyq89z6vr'}, {'type': 0, 'spent': True, 'value': 696, 'spending_outpoints': [{'tx_index': 2241528921557552, 'n': 0}], 'n': 90, 'tx_index': 1888887378221180, 'script': '51206fc1c55b777f1519df9875e7d4d2ec2558687ca9929b385a20424a9cc2c7fe08', 'addr': 'bc1pdlqu2kmh0u23nhucwhnaf5hvy4vxsl9fj2dnsk3qgf9fesk8lcyq89z6vr'}, {'type': 0, 'spent': True, 'value': 708, 'spending_outpoints': [{'tx_index': 2639324166803453, 'n': 0}], 'n': 91, 'tx_index': 1888887378221180, 'script': '51206fc1c55b777f1519df9875e7d4d2ec2558687ca9929b385a20424a9cc2c7fe08', 'addr': 'bc1pdlqu2kmh0u23nhucwhnaf5hvy4vxsl9fj2dnsk3qgf9fesk8lcyq89z6vr'}, {'type': 0, 'spent': True, 'value': 698, 'spending_outpoints': [{'tx_index': 213325571273403, 'n': 0}], 'n': 92, 'tx_index': 1888887378221180, 'script': '51206fc1c55b777f1519df9875e7d4d2ec2558687ca9929b385a20424a9cc2c7fe08', 'addr': 'bc1pdlqu2kmh0u23nhucwhnaf5hvy4vxsl9fj2dnsk3qgf9fesk8lcyq89z6vr'}, {'type': 0, 'spent': True, 'value': 708, 'spending_outpoints': [{'tx_index': 3693060762489088, 'n': 0}], 'n': 93, 'tx_index': 1888887378221180, 'script': '51206fc1c55b777f1519df9875e7d4d2ec2558687ca9929b385a20424a9cc2c7fe08', 'addr': 'bc1pdlqu2kmh0u23nhucwhnaf5hvy4vxsl9fj2dnsk3qgf9fesk8lcyq89z6vr'}, {'type': 0, 'spent': True, 'value': 696, 'spending_outpoints': [{'tx_index': 1784653796402027, 'n': 0}], 'n': 94, 'tx_index': 1888887378221180, 'script': '51206fc1c55b777f1519df9875e7d4d2ec2558687ca9929b385a20424a9cc2c7fe08', 'addr': 'bc1pdlqu2kmh0u23nhucwhnaf5hvy4vxsl9fj2dnsk3qgf9fesk8lcyq89z6vr'}, {'type': 0, 'spent': True, 'value': 695, 'spending_outpoints': [{'tx_index': 1960787703354740, 'n': 0}], 'n': 95, 'tx_index': 1888887378221180, 'script': '51206fc1c55b777f1519df9875e7d4d2ec2558687ca9929b385a20424a9cc2c7fe08', 'addr': 'bc1pdlqu2kmh0u23nhucwhnaf5hvy4vxsl9fj2dnsk3qgf9fesk8lcyq89z6vr'}, {'type': 0, 'spent': True, 'value': 698, 'spending_outpoints': [{'tx_index': 4906708681599857, 'n': 0}], 'n': 96, 'tx_index': 1888887378221180, 'script': '51206fc1c55b777f1519df9875e7d4d2ec2558687ca9929b385a20424a9cc2c7fe08', 'addr': 'bc1pdlqu2kmh0u23nhucwhnaf5hvy4vxsl9fj2dnsk3qgf9fesk8lcyq89z6vr'}, {'type': 0, 'spent': True, 'value': 695, 'spending_outpoints': [{'tx_index': 2032567006783376, 'n': 0}], 'n': 97, 'tx_index': 1888887378221180, 'script': '51206fc1c55b777f1519df9875e7d4d2ec2558687ca9929b385a20424a9cc2c7fe08', 'addr': 'bc1pdlqu2kmh0u23nhucwhnaf5hvy4vxsl9fj2dnsk3qgf9fesk8lcyq89z6vr'}, {'type': 0, 'spent': True, 'value': 695, 'spending_outpoints': [{'tx_index': 8911286347966432, 'n': 0}], 'n': 98, 'tx_index': 1888887378221180, 'script': '51206fc1c55b777f1519df9875e7d4d2ec2558687ca9929b385a20424a9cc2c7fe08', 'addr': 'bc1pdlqu2kmh0u23nhucwhnaf5hvy4vxsl9fj2dnsk3qgf9fesk8lcyq89z6vr'}, {'type': 0, 'spent': True, 'value': 696, 'spending_outpoints': [{'tx_index': 888212266602909, 'n': 0}], 'n': 99, 'tx_index': 1888887378221180, 'script': '51206fc1c55b777f1519df9875e7d4d2ec2558687ca9929b385a20424a9cc2c7fe08', 'addr': 'bc1pdlqu2kmh0u23nhucwhnaf5hvy4vxsl9fj2dnsk3qgf9fesk8lcyq89z6vr'}, {'type': 0, 'spent': True, 'value': 698, 'spending_outpoints': [{'tx_index': 734435354166783, 'n': 0}], 'n': 100, 'tx_index': 1888887378221180, 'script': '51206fc1c55b777f1519df9875e7d4d2ec2558687ca9929b385a20424a9cc2c7fe08', 'addr': 'bc1pdlqu2kmh0u23nhucwhnaf5hvy4vxsl9fj2dnsk3qgf9fesk8lcyq89z6vr'}, {'type': 0, 'spent': True, 'value': 695, 'spending_outpoints': [{'tx_index': 5767082782166088, 'n': 0}], 'n': 101, 'tx_index': 1888887378221180, 'script': '51206fc1c55b777f1519df9875e7d4d2ec2558687ca9929b385a20424a9cc2c7fe08', 'addr': 'bc1pdlqu2kmh0u23nhucwhnaf5hvy4vxsl9fj2dnsk3qgf9fesk8lcyq89z6vr'}, {'type': 0, 'spent': True, 'value': 698, 'spending_outpoints': [{'tx_index': 752537598405528, 'n': 0}], 'n': 102, 'tx_index': 1888887378221180, 'script': '51206fc1c55b777f1519df9875e7d4d2ec2558687ca9929b385a20424a9cc2c7fe08', 'addr': 'bc1pdlqu2kmh0u23nhucwhnaf5hvy4vxsl9fj2dnsk3qgf9fesk8lcyq89z6vr'}, {'type': 0, 'spent': True, 'value': 698, 'spending_outpoints': [{'tx_index': 6403886199960395, 'n': 0}], 'n': 103, 'tx_index': 1888887378221180, 'script': '51206fc1c55b777f1519df9875e7d4d2ec2558687ca9929b385a20424a9cc2c7fe08', 'addr': 'bc1pdlqu2kmh0u23nhucwhnaf5hvy4vxsl9fj2dnsk3qgf9fesk8lcyq89z6vr'}, {'type': 0, 'spent': True, 'value': 696, 'spending_outpoints': [{'tx_index': 1704347976663488, 'n': 0}], 'n': 104, 'tx_index': 1888887378221180, 'script': '51206fc1c55b777f1519df9875e7d4d2ec2558687ca9929b385a20424a9cc2c7fe08', 'addr': 'bc1pdlqu2kmh0u23nhucwhnaf5hvy4vxsl9fj2dnsk3qgf9fesk8lcyq89z6vr'}, {'type': 0, 'spent': True, 'value': 698, 'spending_outpoints': [{'tx_index': 2140474374386385, 'n': 0}], 'n': 105, 'tx_index': 1888887378221180, 'script': '51206fc1c55b777f1519df9875e7d4d2ec2558687ca9929b385a20424a9cc2c7fe08', 'addr': 'bc1pdlqu2kmh0u23nhucwhnaf5hvy4vxsl9fj2dnsk3qgf9fesk8lcyq89z6vr'}, {'type': 0, 'spent': True, 'value': 696, 'spending_outpoints': [{'tx_index': 6956580847987721, 'n': 0}], 'n': 106, 'tx_index': 1888887378221180, 'script': '51206fc1c55b777f1519df9875e7d4d2ec2558687ca9929b385a20424a9cc2c7fe08', 'addr': 'bc1pdlqu2kmh0u23nhucwhnaf5hvy4vxsl9fj2dnsk3qgf9fesk8lcyq89z6vr'}, {'type': 0, 'spent': True, 'value': 698, 'spending_outpoints': [{'tx_index': 3377823420092865, 'n': 0}], 'n': 107, 'tx_index': 1888887378221180, 'script': '51206fc1c55b777f1519df9875e7d4d2ec2558687ca9929b385a20424a9cc2c7fe08', 'addr': 'bc1pdlqu2kmh0u23nhucwhnaf5hvy4vxsl9fj2dnsk3qgf9fesk8lcyq89z6vr'}, {'type': 0, 'spent': True, 'value': 698, 'spending_outpoints': [{'tx_index': 3341594946954316, 'n': 0}], 'n': 108, 'tx_index': 1888887378221180, 'script': '51206fc1c55b777f1519df9875e7d4d2ec2558687ca9929b385a20424a9cc2c7fe08', 'addr': 'bc1pdlqu2kmh0u23nhucwhnaf5hvy4vxsl9fj2dnsk3qgf9fesk8lcyq89z6vr'}, {'type': 0, 'spent': True, 'value': 695, 'spending_outpoints': [{'tx_index': 7165914039986733, 'n': 0}], 'n': 109, 'tx_index': 1888887378221180, 'script': '51206fc1c55b777f1519df9875e7d4d2ec2558687ca9929b385a20424a9cc2c7fe08', 'addr': 'bc1pdlqu2kmh0u23nhucwhnaf5hvy4vxsl9fj2dnsk3qgf9fesk8lcyq89z6vr'}, {'type': 0, 'spent': True, 'value': 695, 'spending_outpoints': [{'tx_index': 5346032407889696, 'n': 0}], 'n': 110, 'tx_index': 1888887378221180, 'script': '51206fc1c55b777f1519df9875e7d4d2ec2558687ca9929b385a20424a9cc2c7fe08', 'addr': 'bc1pdlqu2kmh0u23nhucwhnaf5hvy4vxsl9fj2dnsk3qgf9fesk8lcyq89z6vr'}, {'type': 0, 'spent': True, 'value': 698, 'spending_outpoints': [{'tx_index': 2213935954498182, 'n': 0}], 'n': 111, 'tx_index': 1888887378221180, 'script': '51206fc1c55b777f1519df9875e7d4d2ec2558687ca9929b385a20424a9cc2c7fe08', 'addr': 'bc1pdlqu2kmh0u23nhucwhnaf5hvy4vxsl9fj2dnsk3qgf9fesk8lcyq89z6vr'}, {'type': 0, 'spent': True, 'value': 708, 'spending_outpoints': [{'tx_index': 6697116177293805, 'n': 0}], 'n': 112, 'tx_index': 1888887378221180, 'script': '51206fc1c55b777f1519df9875e7d4d2ec2558687ca9929b385a20424a9cc2c7fe08', 'addr': 'bc1pdlqu2kmh0u23nhucwhnaf5hvy4vxsl9fj2dnsk3qgf9fesk8lcyq89z6vr'}, {'type': 0, 'spent': True, 'value': 698, 'spending_outpoints': [{'tx_index': 3745934414913154, 'n': 0}], 'n': 113, 'tx_index': 1888887378221180, 'script': '51206fc1c55b777f1519df9875e7d4d2ec2558687ca9929b385a20424a9cc2c7fe08', 'addr': 'bc1pdlqu2kmh0u23nhucwhnaf5hvy4vxsl9fj2dnsk3qgf9fesk8lcyq89z6vr'}, {'type': 0, 'spent': True, 'value': 695, 'spending_outpoints': [{'tx_index': 6141478011396390, 'n': 0}], 'n': 114, 'tx_index': 1888887378221180, 'script': '51206fc1c55b777f1519df9875e7d4d2ec2558687ca9929b385a20424a9cc2c7fe08', 'addr': 'bc1pdlqu2kmh0u23nhucwhnaf5hvy4vxsl9fj2dnsk3qgf9fesk8lcyq89z6vr'}, {'type': 0, 'spent': True, 'value': 698, 'spending_outpoints': [{'tx_index': 6469132637845871, 'n': 0}], 'n': 115, 'tx_index': 1888887378221180, 'script': '51206fc1c55b777f1519df9875e7d4d2ec2558687ca9929b385a20424a9cc2c7fe08', 'addr': 'bc1pdlqu2kmh0u23nhucwhnaf5hvy4vxsl9fj2dnsk3qgf9fesk8lcyq89z6vr'}, {'type': 0, 'spent': True, 'value': 696, 'spending_outpoints': [{'tx_index': 6525788956658702, 'n': 0}], 'n': 116, 'tx_index': 1888887378221180, 'script': '51206fc1c55b777f1519df9875e7d4d2ec2558687ca9929b385a20424a9cc2c7fe08', 'addr': 'bc1pdlqu2kmh0u23nhucwhnaf5hvy4vxsl9fj2dnsk3qgf9fesk8lcyq89z6vr'}, {'type': 0, 'spent': True, 'value': 696, 'spending_outpoints': [{'tx_index': 4413213553167612, 'n': 0}], 'n': 117, 'tx_index': 1888887378221180, 'script': '51206fc1c55b777f1519df9875e7d4d2ec2558687ca9929b385a20424a9cc2c7fe08', 'addr': 'bc1pdlqu2kmh0u23nhucwhnaf5hvy4vxsl9fj2dnsk3qgf9fesk8lcyq89z6vr'}, {'type': 0, 'spent': True, 'value': 696, 'spending_outpoints': [{'tx_index': 787330697349333, 'n': 0}], 'n': 118, 'tx_index': 1888887378221180, 'script': '51206fc1c55b777f1519df9875e7d4d2ec2558687ca9929b385a20424a9cc2c7fe08', 'addr': 'bc1pdlqu2kmh0u23nhucwhnaf5hvy4vxsl9fj2dnsk3qgf9fesk8lcyq89z6vr'}, {'type': 0, 'spent': True, 'value': 695, 'spending_outpoints': [{'tx_index': 7470418149893508, 'n': 0}], 'n': 119, 'tx_index': 1888887378221180, 'script': '51206fc1c55b777f1519df9875e7d4d2ec2558687ca9929b385a20424a9cc2c7fe08', 'addr': 'bc1pdlqu2kmh0u23nhucwhnaf5hvy4vxsl9fj2dnsk3qgf9fesk8lcyq89z6vr'}, {'type': 0, 'spent': True, 'value': 695, 'spending_outpoints': [{'tx_index': 3345966463800415, 'n': 0}], 'n': 120, 'tx_index': 1888887378221180, 'script': '51206fc1c55b777f1519df9875e7d4d2ec2558687ca9929b385a20424a9cc2c7fe08', 'addr': 'bc1pdlqu2kmh0u23nhucwhnaf5hvy4vxsl9fj2dnsk3qgf9fesk8lcyq89z6vr'}, {'type': 0, 'spent': True, 'value': 695, 'spending_outpoints': [{'tx_index': 7417490616997916, 'n': 0}], 'n': 121, 'tx_index': 1888887378221180, 'script': '51206fc1c55b777f1519df9875e7d4d2ec2558687ca9929b385a20424a9cc2c7fe08', 'addr': 'bc1pdlqu2kmh0u23nhucwhnaf5hvy4vxsl9fj2dnsk3qgf9fesk8lcyq89z6vr'}, {'type': 0, 'spent': True, 'value': 695, 'spending_outpoints': [{'tx_index': 991215077114208, 'n': 0}], 'n': 122, 'tx_index': 1888887378221180, 'script': '51206fc1c55b777f1519df9875e7d4d2ec2558687ca9929b385a20424a9cc2c7fe08', 'addr': 'bc1pdlqu2kmh0u23nhucwhnaf5hvy4vxsl9fj2dnsk3qgf9fesk8lcyq89z6vr'}, {'type': 0, 'spent': True, 'value': 696, 'spending_outpoints': [{'tx_index': 3959991008783918, 'n': 0}], 'n': 123, 'tx_index': 1888887378221180, 'script': '51206fc1c55b777f1519df9875e7d4d2ec2558687ca9929b385a20424a9cc2c7fe08', 'addr': 'bc1pdlqu2kmh0u23nhucwhnaf5hvy4vxsl9fj2dnsk3qgf9fesk8lcyq89z6vr'}, {'type': 0, 'spent': True, 'value': 708, 'spending_outpoints': [{'tx_index': 124202709046363, 'n': 0}], 'n': 124, 'tx_index': 1888887378221180, 'script': '51206fc1c55b777f1519df9875e7d4d2ec2558687ca9929b385a20424a9cc2c7fe08', 'addr': 'bc1pdlqu2kmh0u23nhucwhnaf5hvy4vxsl9fj2dnsk3qgf9fesk8lcyq89z6vr'}, {'type': 0, 'spent': True, 'value': 698, 'spending_outpoints': [{'tx_index': 7837025093647818, 'n': 0}], 'n': 125, 'tx_index': 1888887378221180, 'script': '51206fc1c55b777f1519df9875e7d4d2ec2558687ca9929b385a20424a9cc2c7fe08', 'addr': 'bc1pdlqu2kmh0u23nhucwhnaf5hvy4vxsl9fj2dnsk3qgf9fesk8lcyq89z6vr'}, {'type': 0, 'spent': True, 'value': 698, 'spending_outpoints': [{'tx_index': 4440714196136537, 'n': 0}], 'n': 126, 'tx_index': 1888887378221180, 'script': '51206fc1c55b777f1519df9875e7d4d2ec2558687ca9929b385a20424a9cc2c7fe08', 'addr': 'bc1pdlqu2kmh0u23nhucwhnaf5hvy4vxsl9fj2dnsk3qgf9fesk8lcyq89z6vr'}, {'type': 0, 'spent': True, 'value': 695, 'spending_outpoints': [{'tx_index': 4604138039492977, 'n': 0}], 'n': 127, 'tx_index': 1888887378221180, 'script': '51206fc1c55b777f1519df9875e7d4d2ec2558687ca9929b385a20424a9cc2c7fe08', 'addr': 'bc1pdlqu2kmh0u23nhucwhnaf5hvy4vxsl9fj2dnsk3qgf9fesk8lcyq89z6vr'}, {'type': 0, 'spent': True, 'value': 696, 'spending_outpoints': [{'tx_index': 3401776047444469, 'n': 0}], 'n': 128, 'tx_index': 1888887378221180, 'script': '51206fc1c55b777f1519df9875e7d4d2ec2558687ca9929b385a20424a9cc2c7fe08', 'addr': 'bc1pdlqu2kmh0u23nhucwhnaf5hvy4vxsl9fj2dnsk3qgf9fesk8lcyq89z6vr'}, {'type': 0, 'spent': True, 'value': 695, 'spending_outpoints': [{'tx_index': 855408367840488, 'n': 0}], 'n': 129, 'tx_index': 1888887378221180, 'script': '51206fc1c55b777f1519df9875e7d4d2ec2558687ca9929b385a20424a9cc2c7fe08', 'addr': 'bc1pdlqu2kmh0u23nhucwhnaf5hvy4vxsl9fj2dnsk3qgf9fesk8lcyq89z6vr'}, {'type': 0, 'spent': True, 'value': 698, 'spending_outpoints': [{'tx_index': 5217229183916039, 'n': 0}], 'n': 130, 'tx_index': 1888887378221180, 'script': '51206fc1c55b777f1519df9875e7d4d2ec2558687ca9929b385a20424a9cc2c7fe08', 'addr': 'bc1pdlqu2kmh0u23nhucwhnaf5hvy4vxsl9fj2dnsk3qgf9fesk8lcyq89z6vr'}, {'type': 0, 'spent': True, 'value': 695, 'spending_outpoints': [{'tx_index': 1952413549694825, 'n': 0}], 'n': 131, 'tx_index': 1888887378221180, 'script': '51206fc1c55b777f1519df9875e7d4d2ec2558687ca9929b385a20424a9cc2c7fe08', 'addr': 'bc1pdlqu2kmh0u23nhucwhnaf5hvy4vxsl9fj2dnsk3qgf9fesk8lcyq89z6vr'}, {'type': 0, 'spent': True, 'value': 696, 'spending_outpoints': [{'tx_index': 5013952885448379, 'n': 0}], 'n': 132, 'tx_index': 1888887378221180, 'script': '51206fc1c55b777f1519df9875e7d4d2ec2558687ca9929b385a20424a9cc2c7fe08', 'addr': 'bc1pdlqu2kmh0u23nhucwhnaf5hvy4vxsl9fj2dnsk3qgf9fesk8lcyq89z6vr'}, {'type': 0, 'spent': True, 'value': 695, 'spending_outpoints': [{'tx_index': 7717365672194975, 'n': 0}], 'n': 133, 'tx_index': 1888887378221180, 'script': '51206fc1c55b777f1519df9875e7d4d2ec2558687ca9929b385a20424a9cc2c7fe08', 'addr': 'bc1pdlqu2kmh0u23nhucwhnaf5hvy4vxsl9fj2dnsk3qgf9fesk8lcyq89z6vr'}, {'type': 0, 'spent': True, 'value': 695, 'spending_outpoints': [{'tx_index': 2321147118170529, 'n': 0}], 'n': 134, 'tx_index': 1888887378221180, 'script': '51206fc1c55b777f1519df9875e7d4d2ec2558687ca9929b385a20424a9cc2c7fe08', 'addr': 'bc1pdlqu2kmh0u23nhucwhnaf5hvy4vxsl9fj2dnsk3qgf9fesk8lcyq89z6vr'}, {'type': 0, 'spent': True, 'value': 698, 'spending_outpoints': [{'tx_index': 1438076581355014, 'n': 0}], 'n': 135, 'tx_index': 1888887378221180, 'script': '51206fc1c55b777f1519df9875e7d4d2ec2558687ca9929b385a20424a9cc2c7fe08', 'addr': 'bc1pdlqu2kmh0u23nhucwhnaf5hvy4vxsl9fj2dnsk3qgf9fesk8lcyq89z6vr'}, {'type': 0, 'spent': True, 'value': 698, 'spending_outpoints': [{'tx_index': 3564614495343017, 'n': 0}], 'n': 136, 'tx_index': 1888887378221180, 'script': '51206fc1c55b777f1519df9875e7d4d2ec2558687ca9929b385a20424a9cc2c7fe08', 'addr': 'bc1pdlqu2kmh0u23nhucwhnaf5hvy4vxsl9fj2dnsk3qgf9fesk8lcyq89z6vr'}, {'type': 0, 'spent': True, 'value': 696, 'spending_outpoints': [{'tx_index': 5749375876185094, 'n': 0}], 'n': 137, 'tx_index': 1888887378221180, 'script': '51206fc1c55b777f1519df9875e7d4d2ec2558687ca9929b385a20424a9cc2c7fe08', 'addr': 'bc1pdlqu2kmh0u23nhucwhnaf5hvy4vxsl9fj2dnsk3qgf9fesk8lcyq89z6vr'}, {'type': 0, 'spent': True, 'value': 708, 'spending_outpoints': [{'tx_index': 1245257351461218, 'n': 0}], 'n': 138, 'tx_index': 1888887378221180, 'script': '51206fc1c55b777f1519df9875e7d4d2ec2558687ca9929b385a20424a9cc2c7fe08', 'addr': 'bc1pdlqu2kmh0u23nhucwhnaf5hvy4vxsl9fj2dnsk3qgf9fesk8lcyq89z6vr'}, {'type': 0, 'spent': True, 'value': 696, 'spending_outpoints': [{'tx_index': 886108293442528, 'n': 0}], 'n': 139, 'tx_index': 1888887378221180, 'script': '51206fc1c55b777f1519df9875e7d4d2ec2558687ca9929b385a20424a9cc2c7fe08', 'addr': 'bc1pdlqu2kmh0u23nhucwhnaf5hvy4vxsl9fj2dnsk3qgf9fesk8lcyq89z6vr'}, {'type': 0, 'spent': True, 'value': 695, 'spending_outpoints': [{'tx_index': 7083802270547234, 'n': 0}], 'n': 140, 'tx_index': 1888887378221180, 'script': '51206fc1c55b777f1519df9875e7d4d2ec2558687ca9929b385a20424a9cc2c7fe08', 'addr': 'bc1pdlqu2kmh0u23nhucwhnaf5hvy4vxsl9fj2dnsk3qgf9fesk8lcyq89z6vr'}, {'type': 0, 'spent': True, 'value': 696, 'spending_outpoints': [{'tx_index': 6744582070961340, 'n': 0}], 'n': 141, 'tx_index': 1888887378221180, 'script': '51206fc1c55b777f1519df9875e7d4d2ec2558687ca9929b385a20424a9cc2c7fe08', 'addr': 'bc1pdlqu2kmh0u23nhucwhnaf5hvy4vxsl9fj2dnsk3qgf9fesk8lcyq89z6vr'}, {'type': 0, 'spent': True, 'value': 698, 'spending_outpoints': [{'tx_index': 4570409270084901, 'n': 0}], 'n': 142, 'tx_index': 1888887378221180, 'script': '51206fc1c55b777f1519df9875e7d4d2ec2558687ca9929b385a20424a9cc2c7fe08', 'addr': 'bc1pdlqu2kmh0u23nhucwhnaf5hvy4vxsl9fj2dnsk3qgf9fesk8lcyq89z6vr'}, {'type': 0, 'spent': True, 'value': 698, 'spending_outpoints': [{'tx_index': 8846461499230436, 'n': 0}], 'n': 143, 'tx_index': 1888887378221180, 'script': '51206fc1c55b777f1519df9875e7d4d2ec2558687ca9929b385a20424a9cc2c7fe08', 'addr': 'bc1pdlqu2kmh0u23nhucwhnaf5hvy4vxsl9fj2dnsk3qgf9fesk8lcyq89z6vr'}, {'type': 0, 'spent': True, 'value': 695, 'spending_outpoints': [{'tx_index': 1899809547310578, 'n': 0}], 'n': 144, 'tx_index': 1888887378221180, 'script': '51206fc1c55b777f1519df9875e7d4d2ec2558687ca9929b385a20424a9cc2c7fe08', 'addr': 'bc1pdlqu2kmh0u23nhucwhnaf5hvy4vxsl9fj2dnsk3qgf9fesk8lcyq89z6vr'}, {'type': 0, 'spent': True, 'value': 695, 'spending_outpoints': [{'tx_index': 884962181187217, 'n': 0}], 'n': 145, 'tx_index': 1888887378221180, 'script': '51206fc1c55b777f1519df9875e7d4d2ec2558687ca9929b385a20424a9cc2c7fe08', 'addr': 'bc1pdlqu2kmh0u23nhucwhnaf5hvy4vxsl9fj2dnsk3qgf9fesk8lcyq89z6vr'}, {'type': 0, 'spent': True, 'value': 695, 'spending_outpoints': [{'tx_index': 7596775248138411, 'n': 0}], 'n': 146, 'tx_index': 1888887378221180, 'script': '51206fc1c55b777f1519df9875e7d4d2ec2558687ca9929b385a20424a9cc2c7fe08', 'addr': 'bc1pdlqu2kmh0u23nhucwhnaf5hvy4vxsl9fj2dnsk3qgf9fesk8lcyq89z6vr'}, {'type': 0, 'spent': True, 'value': 698, 'spending_outpoints': [{'tx_index': 101338834766244, 'n': 0}], 'n': 147, 'tx_index': 1888887378221180, 'script': '51206fc1c55b777f1519df9875e7d4d2ec2558687ca9929b385a20424a9cc2c7fe08', 'addr': 'bc1pdlqu2kmh0u23nhucwhnaf5hvy4vxsl9fj2dnsk3qgf9fesk8lcyq89z6vr'}, {'type': 0, 'spent': True, 'value': 695, 'spending_outpoints': [{'tx_index': 8688991730612313, 'n': 0}], 'n': 148, 'tx_index': 1888887378221180, 'script': '51206fc1c55b777f1519df9875e7d4d2ec2558687ca9929b385a20424a9cc2c7fe08', 'addr': 'bc1pdlqu2kmh0u23nhucwhnaf5hvy4vxsl9fj2dnsk3qgf9fesk8lcyq89z6vr'}, {'type': 0, 'spent': True, 'value': 695, 'spending_outpoints': [{'tx_index': 4936436208957156, 'n': 0}], 'n': 149, 'tx_index': 1888887378221180, 'script': '51206fc1c55b777f1519df9875e7d4d2ec2558687ca9929b385a20424a9cc2c7fe08', 'addr': 'bc1pdlqu2kmh0u23nhucwhnaf5hvy4vxsl9fj2dnsk3qgf9fesk8lcyq89z6vr'}, {'type': 0, 'spent': True, 'value': 695, 'spending_outpoints': [{'tx_index': 5348743780809387, 'n': 0}], 'n': 150, 'tx_index': 1888887378221180, 'script': '51206fc1c55b777f1519df9875e7d4d2ec2558687ca9929b385a20424a9cc2c7fe08', 'addr': 'bc1pdlqu2kmh0u23nhucwhnaf5hvy4vxsl9fj2dnsk3qgf9fesk8lcyq89z6vr'}, {'type': 0, 'spent': True, 'value': 695, 'spending_outpoints': [{'tx_index': 2116220883472865, 'n': 0}], 'n': 151, 'tx_index': 1888887378221180, 'script': '51206fc1c55b777f1519df9875e7d4d2ec2558687ca9929b385a20424a9cc2c7fe08', 'addr': 'bc1pdlqu2kmh0u23nhucwhnaf5hvy4vxsl9fj2dnsk3qgf9fesk8lcyq89z6vr'}, {'type': 0, 'spent': True, 'value': 698, 'spending_outpoints': [{'tx_index': 4390405492898230, 'n': 0}], 'n': 152, 'tx_index': 1888887378221180, 'script': '51206fc1c55b777f1519df9875e7d4d2ec2558687ca9929b385a20424a9cc2c7fe08', 'addr': 'bc1pdlqu2kmh0u23nhucwhnaf5hvy4vxsl9fj2dnsk3qgf9fesk8lcyq89z6vr'}, {'type': 0, 'spent': True, 'value': 695, 'spending_outpoints': [{'tx_index': 3853730905894764, 'n': 0}], 'n': 153, 'tx_index': 1888887378221180, 'script': '51206fc1c55b777f1519df9875e7d4d2ec2558687ca9929b385a20424a9cc2c7fe08', 'addr': 'bc1pdlqu2kmh0u23nhucwhnaf5hvy4vxsl9fj2dnsk3qgf9fesk8lcyq89z6vr'}, {'type': 0, 'spent': True, 'value': 695, 'spending_outpoints': [{'tx_index': 5441966319981536, 'n': 0}], 'n': 154, 'tx_index': 1888887378221180, 'script': '51206fc1c55b777f1519df9875e7d4d2ec2558687ca9929b385a20424a9cc2c7fe08', 'addr': 'bc1pdlqu2kmh0u23nhucwhnaf5hvy4vxsl9fj2dnsk3qgf9fesk8lcyq89z6vr'}, {'type': 0, 'spent': True, 'value': 696, 'spending_outpoints': [{'tx_index': 8660019848575592, 'n': 0}], 'n': 155, 'tx_index': 1888887378221180, 'script': '51206fc1c55b777f1519df9875e7d4d2ec2558687ca9929b385a20424a9cc2c7fe08', 'addr': 'bc1pdlqu2kmh0u23nhucwhnaf5hvy4vxsl9fj2dnsk3qgf9fesk8lcyq89z6vr'}, {'type': 0, 'spent': True, 'value': 698, 'spending_outpoints': [{'tx_index': 8746355253068459, 'n': 0}], 'n': 156, 'tx_index': 1888887378221180, 'script': '51206fc1c55b777f1519df9875e7d4d2ec2558687ca9929b385a20424a9cc2c7fe08', 'addr': 'bc1pdlqu2kmh0u23nhucwhnaf5hvy4vxsl9fj2dnsk3qgf9fesk8lcyq89z6vr'}, {'type': 0, 'spent': True, 'value': 695, 'spending_outpoints': [{'tx_index': 7827956466372454, 'n': 0}], 'n': 157, 'tx_index': 1888887378221180, 'script': '51206fc1c55b777f1519df9875e7d4d2ec2558687ca9929b385a20424a9cc2c7fe08', 'addr': 'bc1pdlqu2kmh0u23nhucwhnaf5hvy4vxsl9fj2dnsk3qgf9fesk8lcyq89z6vr'}, {'type': 0, 'spent': True, 'value': 695, 'spending_outpoints': [{'tx_index': 2499745746946744, 'n': 0}], 'n': 158, 'tx_index': 1888887378221180, 'script': '51206fc1c55b777f1519df9875e7d4d2ec2558687ca9929b385a20424a9cc2c7fe08', 'addr': 'bc1pdlqu2kmh0u23nhucwhnaf5hvy4vxsl9fj2dnsk3qgf9fesk8lcyq89z6vr'}, {'type': 0, 'spent': True, 'value': 698, 'spending_outpoints': [{'tx_index': 7039995110910875, 'n': 0}], 'n': 159, 'tx_index': 1888887378221180, 'script': '51206fc1c55b777f1519df9875e7d4d2ec2558687ca9929b385a20424a9cc2c7fe08', 'addr': 'bc1pdlqu2kmh0u23nhucwhnaf5hvy4vxsl9fj2dnsk3qgf9fesk8lcyq89z6vr'}, {'type': 0, 'spent': True, 'value': 698, 'spending_outpoints': [{'tx_index': 3521831641902988, 'n': 0}], 'n': 160, 'tx_index': 1888887378221180, 'script': '51206fc1c55b777f1519df9875e7d4d2ec2558687ca9929b385a20424a9cc2c7fe08', 'addr': 'bc1pdlqu2kmh0u23nhucwhnaf5hvy4vxsl9fj2dnsk3qgf9fesk8lcyq89z6vr'}, {'type': 0, 'spent': True, 'value': 698, 'spending_outpoints': [{'tx_index': 5749980161990597, 'n': 0}], 'n': 161, 'tx_index': 1888887378221180, 'script': '51206fc1c55b777f1519df9875e7d4d2ec2558687ca9929b385a20424a9cc2c7fe08', 'addr': 'bc1pdlqu2kmh0u23nhucwhnaf5hvy4vxsl9fj2dnsk3qgf9fesk8lcyq89z6vr'}, {'type': 0, 'spent': True, 'value': 698, 'spending_outpoints': [{'tx_index': 7072361814343205, 'n': 0}], 'n': 162, 'tx_index': 1888887378221180, 'script': '51206fc1c55b777f1519df9875e7d4d2ec2558687ca9929b385a20424a9cc2c7fe08', 'addr': 'bc1pdlqu2kmh0u23nhucwhnaf5hvy4vxsl9fj2dnsk3qgf9fesk8lcyq89z6vr'}, {'type': 0, 'spent': True, 'value': 698, 'spending_outpoints': [{'tx_index': 7846864759899057, 'n': 0}], 'n': 163, 'tx_index': 1888887378221180, 'script': '51206fc1c55b777f1519df9875e7d4d2ec2558687ca9929b385a20424a9cc2c7fe08', 'addr': 'bc1pdlqu2kmh0u23nhucwhnaf5hvy4vxsl9fj2dnsk3qgf9fesk8lcyq89z6vr'}, {'type': 0, 'spent': True, 'value': 698, 'spending_outpoints': [{'tx_index': 1468027053076021, 'n': 0}], 'n': 164, 'tx_index': 1888887378221180, 'script': '51206fc1c55b777f1519df9875e7d4d2ec2558687ca9929b385a20424a9cc2c7fe08', 'addr': 'bc1pdlqu2kmh0u23nhucwhnaf5hvy4vxsl9fj2dnsk3qgf9fesk8lcyq89z6vr'}, {'type': 0, 'spent': True, 'value': 698, 'spending_outpoints': [{'tx_index': 2664974049099130, 'n': 0}], 'n': 165, 'tx_index': 1888887378221180, 'script': '51206fc1c55b777f1519df9875e7d4d2ec2558687ca9929b385a20424a9cc2c7fe08', 'addr': 'bc1pdlqu2kmh0u23nhucwhnaf5hvy4vxsl9fj2dnsk3qgf9fesk8lcyq89z6vr'}, {'type': 0, 'spent': True, 'value': 698, 'spending_outpoints': [{'tx_index': 2572355152679112, 'n': 0}], 'n': 166, 'tx_index': 1888887378221180, 'script': '51206fc1c55b777f1519df9875e7d4d2ec2558687ca9929b385a20424a9cc2c7fe08', 'addr': 'bc1pdlqu2kmh0u23nhucwhnaf5hvy4vxsl9fj2dnsk3qgf9fesk8lcyq89z6vr'}, {'type': 0, 'spent': True, 'value': 698, 'spending_outpoints': [{'tx_index': 3635776187042138, 'n': 0}], 'n': 167, 'tx_index': 1888887378221180, 'script': '51206fc1c55b777f1519df9875e7d4d2ec2558687ca9929b385a20424a9cc2c7fe08', 'addr': 'bc1pdlqu2kmh0u23nhucwhnaf5hvy4vxsl9fj2dnsk3qgf9fesk8lcyq89z6vr'}, {'type': 0, 'spent': True, 'value': 698, 'spending_outpoints': [{'tx_index': 4786428601809152, 'n': 0}], 'n': 168, 'tx_index': 1888887378221180, 'script': '51206fc1c55b777f1519df9875e7d4d2ec2558687ca9929b385a20424a9cc2c7fe08', 'addr': 'bc1pdlqu2kmh0u23nhucwhnaf5hvy4vxsl9fj2dnsk3qgf9fesk8lcyq89z6vr'}, {'type': 0, 'spent': True, 'value': 698, 'spending_outpoints': [{'tx_index': 6821346132531588, 'n': 0}], 'n': 169, 'tx_index': 1888887378221180, 'script': '51206fc1c55b777f1519df9875e7d4d2ec2558687ca9929b385a20424a9cc2c7fe08', 'addr': 'bc1pdlqu2kmh0u23nhucwhnaf5hvy4vxsl9fj2dnsk3qgf9fesk8lcyq89z6vr'}, {'type': 0, 'spent': True, 'value': 698, 'spending_outpoints': [{'tx_index': 1091162918545797, 'n': 0}], 'n': 170, 'tx_index': 1888887378221180, 'script': '51206fc1c55b777f1519df9875e7d4d2ec2558687ca9929b385a20424a9cc2c7fe08', 'addr': 'bc1pdlqu2kmh0u23nhucwhnaf5hvy4vxsl9fj2dnsk3qgf9fesk8lcyq89z6vr'}, {'type': 0, 'spent': True, 'value': 698, 'spending_outpoints': [{'tx_index': 2362168287885136, 'n': 0}], 'n': 171, 'tx_index': 1888887378221180, 'script': '51206fc1c55b777f1519df9875e7d4d2ec2558687ca9929b385a20424a9cc2c7fe08', 'addr': 'bc1pdlqu2kmh0u23nhucwhnaf5hvy4vxsl9fj2dnsk3qgf9fesk8lcyq89z6vr'}, {'type': 0, 'spent': True, 'value': 698, 'spending_outpoints': [{'tx_index': 3105494331185963, 'n': 0}], 'n': 172, 'tx_index': 1888887378221180, 'script': '51206fc1c55b777f1519df9875e7d4d2ec2558687ca9929b385a20424a9cc2c7fe08', 'addr': 'bc1pdlqu2kmh0u23nhucwhnaf5hvy4vxsl9fj2dnsk3qgf9fesk8lcyq89z6vr'}, {'type': 0, 'spent': True, 'value': 698, 'spending_outpoints': [{'tx_index': 6917029581861718, 'n': 0}], 'n': 173, 'tx_index': 1888887378221180, 'script': '51206fc1c55b777f1519df9875e7d4d2ec2558687ca9929b385a20424a9cc2c7fe08', 'addr': 'bc1pdlqu2kmh0u23nhucwhnaf5hvy4vxsl9fj2dnsk3qgf9fesk8lcyq89z6vr'}, {'type': 0, 'spent': True, 'value': 698, 'spending_outpoints': [{'tx_index': 5542713828974955, 'n': 0}], 'n': 174, 'tx_index': 1888887378221180, 'script': '51206fc1c55b777f1519df9875e7d4d2ec2558687ca9929b385a20424a9cc2c7fe08', 'addr': 'bc1pdlqu2kmh0u23nhucwhnaf5hvy4vxsl9fj2dnsk3qgf9fesk8lcyq89z6vr'}, {'type': 0, 'spent': True, 'value': 698, 'spending_outpoints': [{'tx_index': 928031778737622, 'n': 0}], 'n': 175, 'tx_index': 1888887378221180, 'script': '51206fc1c55b777f1519df9875e7d4d2ec2558687ca9929b385a20424a9cc2c7fe08', 'addr': 'bc1pdlqu2kmh0u23nhucwhnaf5hvy4vxsl9fj2dnsk3qgf9fesk8lcyq89z6vr'}, {'type': 0, 'spent': True, 'value': 698, 'spending_outpoints': [{'tx_index': 6961068060514872, 'n': 0}], 'n': 176, 'tx_index': 1888887378221180, 'script': '51206fc1c55b777f1519df9875e7d4d2ec2558687ca9929b385a20424a9cc2c7fe08', 'addr': 'bc1pdlqu2kmh0u23nhucwhnaf5hvy4vxsl9fj2dnsk3qgf9fesk8lcyq89z6vr'}, {'type': 0, 'spent': True, 'value': 698, 'spending_outpoints': [{'tx_index': 3743146707087321, 'n': 0}], 'n': 177, 'tx_index': 1888887378221180, 'script': '51206fc1c55b777f1519df9875e7d4d2ec2558687ca9929b385a20424a9cc2c7fe08', 'addr': 'bc1pdlqu2kmh0u23nhucwhnaf5hvy4vxsl9fj2dnsk3qgf9fesk8lcyq89z6vr'}, {'type': 0, 'spent': True, 'value': 698, 'spending_outpoints': [{'tx_index': 2306056467502762, 'n': 0}], 'n': 178, 'tx_index': 1888887378221180, 'script': '51206fc1c55b777f1519df9875e7d4d2ec2558687ca9929b385a20424a9cc2c7fe08', 'addr': 'bc1pdlqu2kmh0u23nhucwhnaf5hvy4vxsl9fj2dnsk3qgf9fesk8lcyq89z6vr'}, {'type': 0, 'spent': True, 'value': 698, 'spending_outpoints': [{'tx_index': 8272231898745272, 'n': 0}], 'n': 179, 'tx_index': 1888887378221180, 'script': '51206fc1c55b777f1519df9875e7d4d2ec2558687ca9929b385a20424a9cc2c7fe08', 'addr': 'bc1pdlqu2kmh0u23nhucwhnaf5hvy4vxsl9fj2dnsk3qgf9fesk8lcyq89z6vr'}, {'type': 0, 'spent': True, 'value': 698, 'spending_outpoints': [{'tx_index': 8833122211770345, 'n': 0}], 'n': 180, 'tx_index': 1888887378221180, 'script': '51206fc1c55b777f1519df9875e7d4d2ec2558687ca9929b385a20424a9cc2c7fe08', 'addr': 'bc1pdlqu2kmh0u23nhucwhnaf5hvy4vxsl9fj2dnsk3qgf9fesk8lcyq89z6vr'}, {'type': 0, 'spent': True, 'value': 696, 'spending_outpoints': [{'tx_index': 1846683710435996, 'n': 0}], 'n': 181, 'tx_index': 1888887378221180, 'script': '51206fc1c55b777f1519df9875e7d4d2ec2558687ca9929b385a20424a9cc2c7fe08', 'addr': 'bc1pdlqu2kmh0u23nhucwhnaf5hvy4vxsl9fj2dnsk3qgf9fesk8lcyq89z6vr'}, {'type': 0, 'spent': True, 'value': 696, 'spending_outpoints': [{'tx_index': 6617186604654906, 'n': 0}], 'n': 182, 'tx_index': 1888887378221180, 'script': '51206fc1c55b777f1519df9875e7d4d2ec2558687ca9929b385a20424a9cc2c7fe08', 'addr': 'bc1pdlqu2kmh0u23nhucwhnaf5hvy4vxsl9fj2dnsk3qgf9fesk8lcyq89z6vr'}, {'type': 0, 'spent': True, 'value': 695, 'spending_outpoints': [{'tx_index': 3436787881461741, 'n': 0}], 'n': 183, 'tx_index': 1888887378221180, 'script': '51206fc1c55b777f1519df9875e7d4d2ec2558687ca9929b385a20424a9cc2c7fe08', 'addr': 'bc1pdlqu2kmh0u23nhucwhnaf5hvy4vxsl9fj2dnsk3qgf9fesk8lcyq89z6vr'}, {'type': 0, 'spent': True, 'value': 695, 'spending_outpoints': [{'tx_index': 701968243281578, 'n': 0}], 'n': 184, 'tx_index': 1888887378221180, 'script': '51206fc1c55b777f1519df9875e7d4d2ec2558687ca9929b385a20424a9cc2c7fe08', 'addr': 'bc1pdlqu2kmh0u23nhucwhnaf5hvy4vxsl9fj2dnsk3qgf9fesk8lcyq89z6vr'}, {'type': 0, 'spent': True, 'value': 695, 'spending_outpoints': [{'tx_index': 6001363168966257, 'n': 0}], 'n': 185, 'tx_index': 1888887378221180, 'script': '51206fc1c55b777f1519df9875e7d4d2ec2558687ca9929b385a20424a9cc2c7fe08', 'addr': 'bc1pdlqu2kmh0u23nhucwhnaf5hvy4vxsl9fj2dnsk3qgf9fesk8lcyq89z6vr'}, {'type': 0, 'spent': False, 'value': 4999, 'spending_outpoints': [], 'n': 186, 'tx_index': 1888887378221180, 'script': '001481b23b9144bb105843a86b88978dc3ec6e8ef57a', 'addr': 'bc1qsxerhy2yhvg9ssagdwyf0rwra3hgaat6dduxke'}]",546,1000000591675
ec12b981c46d6410bf8d37df9b0f5a5d411b4b77506791d9001cda2b85b0b1c1,2,1,1,323,578,163,0.0.0.0,0,6815005276470083,False,1744371043,891920,891920,"[{'sequence': 4294967295, 'witness': '034051fbf1a20acf09f7d3d21d8bfb7e33bf35810a46d4ff107a2de54c0c22d1067a59dacde02aa26c6d376a7f3b8c6cd819287342c95b4ad0b4c378b05c824d884887209c01c53503f79de218eb338dc13e6ef4c9ee790b8d61b77638d4c661940c88f5ac0063036f7264010118746578742f706c61696e3b636861727365743d7574662d3800417b2270223a226272632d3230222c226f70223a226d696e74222c227469636b223a22f096b98a222c22616d74223a223134393539393635303137302e363639227d6821c19c01c53503f79de218eb338dc13e6ef4c9ee790b8d61b77638d4c661940c88f5', 'script': '', 'index': 0, 'prev_out': {'type': 0, 'spent': True, 'value': 709, 'spending_outpoints': [{'tx_index': 6815005276470083, 'n': 0}], 'n': 100, 'tx_index': 8145581441475352, 'script': '51200bfa41a67145a200443371bc42f640b03d10a250cd463b01b570d8b457086c35', 'addr': 'bc1pp0ayrfn3gk3qq3pnwx7y9ajqkq73pgjse4rrkqd4wrvtg4cgds6s3yrwvm'}}]","[{'type': 0, 'spent': False, 'value': 546, 'spending_outpoints': [], 'n': 0, 'tx_index': 6815005276470083, 'script': '76a91487ccbdb1aba7e6875f750c0823bd63bf972a2fa988ac', 'addr': '1DP3VYwN6ozHXDDaETbvNFLd86CAXfaewi'}]",546,1000000591129
6b6e81cea0ce65302ead5b69730c93e8528b388198e516568d3a7613aad29dfb,2,1,181,8047,31486,8765,0.0.0.0,0,8852968409558727,False,1744369282,891916,891916,"[{'sequence': 4294967293, 'witness': '03409d0b8adff78c5e7060f4e45ff1ea17079c1386290f8b801bad9ae269871dec510a06701135b0fd861d7f7ffc7c56bb6802e7f6a0197608c3b7e352d7f8519dab83202c156ad3c1c827a0ee53f8227ef395a6e2300b7e9236e39561543ff0e8b749edac0063036f7264010118746578742f706c61696e3b636861727365743d7574662d38003d7b2270223a226272632d3230222c226f70223a226d696e74222c227469636b223a22f096b98a222c22616d74223a22313439353939363530313731227d6821c12c156ad3c1c827a0ee53f8227ef395a6e2300b7e9236e39561543ff0e8b749ed', 'script': '', 'index': 0, 'prev_out': {'type': 0, 'spent': True, 'value': 141265, 'spending_outpoints': [{'tx_index': 8852968409558727, 'n': 0}], 'n': 0, 'tx_index': 799714163664737, 'script': '5120ed50a03b4d9207f6f92814dfb2689293dd64c2aa44d10a59e6bd59cef101b433', 'addr': 'bc1pa4g2qw6djgrld7fgzn0my6yjj0wkfs42gngs5k0xh4vuaugpksesyvpqv3'}}]","[{'type': 0, 'spent': False, 'value': 546, 'spending_outpoints': [], 'n': 0, 'tx_index': 8852968409558727, 'script': '76a91487ccbdb1aba7e6875f750c0823bd63bf972a2fa988ac', 'addr': '1DP3VYwN6ozHXDDaETbvNFLd86CAXfaewi'}, {'type': 0, 'spent': True, 'value': 708, 'spending_outpoints': [{'tx_index': 6295323315462790, 'n': 0}], 'n': 1, 'tx_index': 8852968409558727, 'script': '5120ed50a03b4d9207f6f92814dfb2689293dd64c2aa44d10a59e6bd59cef101b433', 'addr': 'bc1pa4g2qw6djgrld7fgzn0my6yjj0wkfs42gngs5k0xh4vuaugpksesyvpqv3'}, {'type': 0, 'spent': True, 'value': 708, 'spending_outpoints': [{'tx_index': 2695245642130698, 'n': 0}], 'n': 2, 'tx_index': 8852968409558727, 'script': '5120ed50a03b4d9207f6f92814dfb2689293dd64c2aa44d10a59e6bd59cef101b433', 'addr': 'bc1pa4g2qw6djgrld7fgzn0my6yjj0wkfs42gngs5k0xh4vuaugpksesyvpqv3'}, {'type': 0, 'spent': True, 'value': 708, 'spending_outpoints': [{'tx_index': 3855986051725574, 'n': 0}], 'n': 3, 'tx_index': 8852968409558727, 'script': '5120ed50a03b4d9207f6f92814dfb2689293dd64c2aa44d10a59e6bd59cef101b433', 'addr': 'bc1pa4g2qw6djgrld7fgzn0my6yjj0wkfs42gngs5k0xh4vuaugpksesyvpqv3'}, {'type': 0, 'spent': True, 'value': 708, 'spending_outpoints': [{'tx_index': 1246941124379910, 'n': 0}], 'n': 4, 'tx_index': 8852968409558727, 'script': '5120ed50a03b4d9207f6f92814dfb2689293dd64c2aa44d10a59e6bd59cef101b433', 'addr': 'bc1pa4g2qw6djgrld7fgzn0my6yjj0wkfs42gngs5k0xh4vuaugpksesyvpqv3'}, {'type': 0, 'spent': True, 'value': 708, 'spending_outpoints': [{'tx_index': 1492244012226376, 'n': 0}], 'n': 5, 'tx_index': 8852968409558727, 'script': '5120ed50a03b4d9207f6f92814dfb2689293dd64c2aa44d10a59e6bd59cef101b433', 'addr': 'bc1pa4g2qw6djgrld7fgzn0my6yjj0wkfs42gngs5k0xh4vuaugpksesyvpqv3'}, {'type': 0, 'spent': True, 'value': 706, 'spending_outpoints': [{'tx_index': 8815260056539364, 'n': 0}], 'n': 6, 'tx_index': 8852968409558727, 'script': '5120ed50a03b4d9207f6f92814dfb2689293dd64c2aa44d10a59e6bd59cef101b433', 'addr': 'bc1pa4g2qw6djgrld7fgzn0my6yjj0wkfs42gngs5k0xh4vuaugpksesyvpqv3'}, {'type': 0, 'spent': True, 'value': 706, 'spending_outpoints': [{'tx_index': 8850178694464263, 'n': 0}], 'n': 7, 'tx_index': 8852968409558727, 'script': '5120ed50a03b4d9207f6f92814dfb2689293dd64c2aa44d10a59e6bd59cef101b433', 'addr': 'bc1pa4g2qw6djgrld7fgzn0my6yjj0wkfs42gngs5k0xh4vuaugpksesyvpqv3'}, {'type': 0, 'spent': True, 'value': 705, 'spending_outpoints': [{'tx_index': 2325628222199207, 'n': 0}], 'n': 8, 'tx_index': 8852968409558727, 'script': '5120ed50a03b4d9207f6f92814dfb2689293dd64c2aa44d10a59e6bd59cef101b433', 'addr': 'bc1pa4g2qw6djgrld7fgzn0my6yjj0wkfs42gngs5k0xh4vuaugpksesyvpqv3'}, {'type': 0, 'spent': True, 'value': 705, 'spending_outpoints': [{'tx_index': 7796961388461521, 'n': 0}], 'n': 9, 'tx_index': 8852968409558727, 'script': '5120ed50a03b4d9207f6f92814dfb2689293dd64c2aa44d10a59e6bd59cef101b433', 'addr': 'bc1pa4g2qw6djgrld7fgzn0my6yjj0wkfs42gngs5k0xh4vuaugpksesyvpqv3'}, {'type': 0, 'spent': True, 'value': 705, 'spending_outpoints': [{'tx_index': 4762516231015233, 'n': 0}], 'n': 10, 'tx_index': 8852968409558727, 'script': '5120ed50a03b4d9207f6f92814dfb2689293dd64c2aa44d10a59e6bd59cef101b433', 'addr': 'bc1pa4g2qw6djgrld7fgzn0my6yjj0wkfs42gngs5k0xh4vuaugpksesyvpqv3'}, {'type': 0, 'spent': True, 'value': 705, 'spending_outpoints': [{'tx_index': 6970176369871467, 'n': 0}], 'n': 11, 'tx_index': 8852968409558727, 'script': '5120ed50a03b4d9207f6f92814dfb2689293dd64c2aa44d10a59e6bd59cef101b433', 'addr': 'bc1pa4g2qw6djgrld7fgzn0my6yjj0wkfs42gngs5k0xh4vuaugpksesyvpqv3'}, {'type': 0, 'spent': True, 'value': 718, 'spending_outpoints': [{'tx_index': 7322144087171922, 'n': 0}], 'n': 12, 'tx_index': 8852968409558727, 'script': '5120ed50a03b4d9207f6f92814dfb2689293dd64c2aa44d10a59e6bd59cef101b433', 'addr': 'bc1pa4g2qw6djgrld7fgzn0my6yjj0wkfs42gngs5k0xh4vuaugpksesyvpqv3'}, {'type': 0, 'spent': True, 'value': 718, 'spending_outpoints': [{'tx_index': 3818208976940076, 'n': 0}], 'n': 13, 'tx_index': 8852968409558727, 'script': '5120ed50a03b4d9207f6f92814dfb2689293dd64c2aa44d10a59e6bd59cef101b433', 'addr': 'bc1pa4g2qw6djgrld7fgzn0my6yjj0wkfs42gngs5k0xh4vuaugpksesyvpqv3'}, {'type': 0, 'spent': True, 'value': 705, 'spending_outpoints': [{'tx_index': 6400889676604683, 'n': 0}], 'n': 14, 'tx_index': 8852968409558727, 'script': '5120ed50a03b4d9207f6f92814dfb2689293dd64c2aa44d10a59e6bd59cef101b433', 'addr': 'bc1pa4g2qw6djgrld7fgzn0my6yjj0wkfs42gngs5k0xh4vuaugpksesyvpqv3'}, {'type': 0, 'spent': True, 'value': 718, 'spending_outpoints': [{'tx_index': 3385753889009818, 'n': 0}], 'n': 15, 'tx_index': 8852968409558727, 'script': '5120ed50a03b4d9207f6f92814dfb2689293dd64c2aa44d10a59e6bd59cef101b433', 'addr': 'bc1pa4g2qw6djgrld7fgzn0my6yjj0wkfs42gngs5k0xh4vuaugpksesyvpqv3'}, {'type': 0, 'spent': True, 'value': 718, 'spending_outpoints': [{'tx_index': 2196711491572112, 'n': 0}], 'n': 16, 'tx_index': 8852968409558727, 'script': '5120ed50a03b4d9207f6f92814dfb2689293dd64c2aa44d10a59e6bd59cef101b433', 'addr': 'bc1pa4g2qw6djgrld7fgzn0my6yjj0wkfs42gngs5k0xh4vuaugpksesyvpqv3'}, {'type': 0, 'spent': True, 'value': 705, 'spending_outpoints': [{'tx_index': 7647102879128819, 'n': 0}], 'n': 17, 'tx_index': 8852968409558727, 'script': '5120ed50a03b4d9207f6f92814dfb2689293dd64c2aa44d10a59e6bd59cef101b433', 'addr': 'bc1pa4g2qw6djgrld7fgzn0my6yjj0wkfs42gngs5k0xh4vuaugpksesyvpqv3'}, {'type': 0, 'spent': True, 'value': 706, 'spending_outpoints': [{'tx_index': 4222235847957158, 'n': 0}], 'n': 18, 'tx_index': 8852968409558727, 'script': '5120ed50a03b4d9207f6f92814dfb2689293dd64c2aa44d10a59e6bd59cef101b433', 'addr': 'bc1pa4g2qw6djgrld7fgzn0my6yjj0wkfs42gngs5k0xh4vuaugpksesyvpqv3'}, {'type': 0, 'spent': True, 'value': 718, 'spending_outpoints': [{'tx_index': 671420509103396, 'n': 0}], 'n': 19, 'tx_index': 8852968409558727, 'script': '5120ed50a03b4d9207f6f92814dfb2689293dd64c2aa44d10a59e6bd59cef101b433', 'addr': 'bc1pa4g2qw6djgrld7fgzn0my6yjj0wkfs42gngs5k0xh4vuaugpksesyvpqv3'}, {'type': 0, 'spent': True, 'value': 705, 'spending_outpoints': [{'tx_index': 6127458760854665, 'n': 0}], 'n': 20, 'tx_index': 8852968409558727, 'script': '5120ed50a03b4d9207f6f92814dfb2689293dd64c2aa44d10a59e6bd59cef101b433', 'addr': 'bc1pa4g2qw6djgrld7fgzn0my6yjj0wkfs42gngs5k0xh4vuaugpksesyvpqv3'}, {'type': 0, 'spent': True, 'value': 706, 'spending_outpoints': [{'tx_index': 8361947591522354, 'n': 0}], 'n': 21, 'tx_index': 8852968409558727, 'script': '5120ed50a03b4d9207f6f92814dfb2689293dd64c2aa44d10a59e6bd59cef101b433', 'addr': 'bc1pa4g2qw6djgrld7fgzn0my6yjj0wkfs42gngs5k0xh4vuaugpksesyvpqv3'}, {'type': 0, 'spent': True, 'value': 708, 'spending_outpoints': [{'tx_index': 6041241774205467, 'n': 0}], 'n': 22, 'tx_index': 8852968409558727, 'script': '5120ed50a03b4d9207f6f92814dfb2689293dd64c2aa44d10a59e6bd59cef101b433', 'addr': 'bc1pa4g2qw6djgrld7fgzn0my6yjj0wkfs42gngs5k0xh4vuaugpksesyvpqv3'}, {'type': 0, 'spent': True, 'value': 718, 'spending_outpoints': [{'tx_index': 1738749051666930, 'n': 0}], 'n': 23, 'tx_index': 8852968409558727, 'script': '5120ed50a03b4d9207f6f92814dfb2689293dd64c2aa44d10a59e6bd59cef101b433', 'addr': 'bc1pa4g2qw6djgrld7fgzn0my6yjj0wkfs42gngs5k0xh4vuaugpksesyvpqv3'}, {'type': 0, 'spent': True, 'value': 705, 'spending_outpoints': [{'tx_index': 960751491486693, 'n': 0}], 'n': 24, 'tx_index': 8852968409558727, 'script': '5120ed50a03b4d9207f6f92814dfb2689293dd64c2aa44d10a59e6bd59cef101b433', 'addr': 'bc1pa4g2qw6djgrld7fgzn0my6yjj0wkfs42gngs5k0xh4vuaugpksesyvpqv3'}, {'type': 0, 'spent': True, 'value': 706, 'spending_outpoints': [{'tx_index': 2816092558613227, 'n': 0}], 'n': 25, 'tx_index': 8852968409558727, 'script': '5120ed50a03b4d9207f6f92814dfb2689293dd64c2aa44d10a59e6bd59cef101b433', 'addr': 'bc1pa4g2qw6djgrld7fgzn0my6yjj0wkfs42gngs5k0xh4vuaugpksesyvpqv3'}, {'type': 0, 'spent': True, 'value': 708, 'spending_outpoints': [{'tx_index': 4233137075291004, 'n': 0}], 'n': 26, 'tx_index': 8852968409558727, 'script': '5120ed50a03b4d9207f6f92814dfb2689293dd64c2aa44d10a59e6bd59cef101b433', 'addr': 'bc1pa4g2qw6djgrld7fgzn0my6yjj0wkfs42gngs5k0xh4vuaugpksesyvpqv3'}, {'type': 0, 'spent': True, 'value': 718, 'spending_outpoints': [{'tx_index': 870629535066517, 'n': 0}], 'n': 27, 'tx_index': 8852968409558727, 'script': '5120ed50a03b4d9207f6f92814dfb2689293dd64c2aa44d10a59e6bd59cef101b433', 'addr': 'bc1pa4g2qw6djgrld7fgzn0my6yjj0wkfs42gngs5k0xh4vuaugpksesyvpqv3'}, {'type': 0, 'spent': True, 'value': 705, 'spending_outpoints': [{'tx_index': 418847733009570, 'n': 0}], 'n': 28, 'tx_index': 8852968409558727, 'script': '5120ed50a03b4d9207f6f92814dfb2689293dd64c2aa44d10a59e6bd59cef101b433', 'addr': 'bc1pa4g2qw6djgrld7fgzn0my6yjj0wkfs42gngs5k0xh4vuaugpksesyvpqv3'}, {'type': 0, 'spent': True, 'value': 706, 'spending_outpoints': [{'tx_index': 4949298514937084, 'n': 0}], 'n': 29, 'tx_index': 8852968409558727, 'script': '5120ed50a03b4d9207f6f92814dfb2689293dd64c2aa44d10a59e6bd59cef101b433', 'addr': 'bc1pa4g2qw6djgrld7fgzn0my6yjj0wkfs42gngs5k0xh4vuaugpksesyvpqv3'}, {'type': 0, 'spent': True, 'value': 718, 'spending_outpoints': [{'tx_index': 831862715666848, 'n': 0}], 'n': 30, 'tx_index': 8852968409558727, 'script': '5120ed50a03b4d9207f6f92814dfb2689293dd64c2aa44d10a59e6bd59cef101b433', 'addr': 'bc1pa4g2qw6djgrld7fgzn0my6yjj0wkfs42gngs5k0xh4vuaugpksesyvpqv3'}, {'type': 0, 'spent': True, 'value': 705, 'spending_outpoints': [{'tx_index': 4353871251414623, 'n': 0}], 'n': 31, 'tx_index': 8852968409558727, 'script': '5120ed50a03b4d9207f6f92814dfb2689293dd64c2aa44d10a59e6bd59cef101b433', 'addr': 'bc1pa4g2qw6djgrld7fgzn0my6yjj0wkfs42gngs5k0xh4vuaugpksesyvpqv3'}, {'type': 0, 'spent': True, 'value': 718, 'spending_outpoints': [{'tx_index': 1395773814731874, 'n': 0}], 'n': 32, 'tx_index': 8852968409558727, 'script': '5120ed50a03b4d9207f6f92814dfb2689293dd64c2aa44d10a59e6bd59cef101b433', 'addr': 'bc1pa4g2qw6djgrld7fgzn0my6yjj0wkfs42gngs5k0xh4vuaugpksesyvpqv3'}, {'type': 0, 'spent': True, 'value': 705, 'spending_outpoints': [{'tx_index': 2144745023071997, 'n': 0}], 'n': 33, 'tx_index': 8852968409558727, 'script': '5120ed50a03b4d9207f6f92814dfb2689293dd64c2aa44d10a59e6bd59cef101b433', 'addr': 'bc1pa4g2qw6djgrld7fgzn0my6yjj0wkfs42gngs5k0xh4vuaugpksesyvpqv3'}, {'type': 0, 'spent': True, 'value': 706, 'spending_outpoints': [{'tx_index': 3914649903877790, 'n': 0}], 'n': 34, 'tx_index': 8852968409558727, 'script': '5120ed50a03b4d9207f6f92814dfb2689293dd64c2aa44d10a59e6bd59cef101b433', 'addr': 'bc1pa4g2qw6djgrld7fgzn0my6yjj0wkfs42gngs5k0xh4vuaugpksesyvpqv3'}, {'type': 0, 'spent': True, 'value': 708, 'spending_outpoints': [{'tx_index': 7108237338777003, 'n': 0}], 'n': 35, 'tx_index': 8852968409558727, 'script': '5120ed50a03b4d9207f6f92814dfb2689293dd64c2aa44d10a59e6bd59cef101b433', 'addr': 'bc1pa4g2qw6djgrld7fgzn0my6yjj0wkfs42gngs5k0xh4vuaugpksesyvpqv3'}, {'type': 0, 'spent': True, 'value': 705, 'spending_outpoints': [{'tx_index': 5105715988667743, 'n': 0}], 'n': 36, 'tx_index': 8852968409558727, 'script': '5120ed50a03b4d9207f6f92814dfb2689293dd64c2aa44d10a59e6bd59cef101b433', 'addr': 'bc1pa4g2qw6djgrld7fgzn0my6yjj0wkfs42gngs5k0xh4vuaugpksesyvpqv3'}, {'type': 0, 'spent': True, 'value': 718, 'spending_outpoints': [{'tx_index': 6049767153510485, 'n': 0}], 'n': 37, 'tx_index': 8852968409558727, 'script': '5120ed50a03b4d9207f6f92814dfb2689293dd64c2aa44d10a59e6bd59cef101b433', 'addr': 'bc1pa4g2qw6djgrld7fgzn0my6yjj0wkfs42gngs5k0xh4vuaugpksesyvpqv3'}, {'type': 0, 'spent': True, 'value': 706, 'spending_outpoints': [{'tx_index': 2074165156780592, 'n': 0}], 'n': 38, 'tx_index': 8852968409558727, 'script': '5120ed50a03b4d9207f6f92814dfb2689293dd64c2aa44d10a59e6bd59cef101b433', 'addr': 'bc1pa4g2qw6djgrld7fgzn0my6yjj0wkfs42gngs5k0xh4vuaugpksesyvpqv3'}, {'type': 0, 'spent': True, 'value': 705, 'spending_outpoints': [{'tx_index': 2525291953494009, 'n': 0}], 'n': 39, 'tx_index': 8852968409558727, 'script': '5120ed50a03b4d9207f6f92814dfb2689293dd64c2aa44d10a59e6bd59cef101b433', 'addr': 'bc1pa4g2qw6djgrld7fgzn0my6yjj0wkfs42gngs5k0xh4vuaugpksesyvpqv3'}, {'type': 0, 'spent': True, 'value': 706, 'spending_outpoints': [{'tx_index': 670206883966814, 'n': 0}], 'n': 40, 'tx_index': 8852968409558727, 'script': '5120ed50a03b4d9207f6f92814dfb2689293dd64c2aa44d10a59e6bd59cef101b433', 'addr': 'bc1pa4g2qw6djgrld7fgzn0my6yjj0wkfs42gngs5k0xh4vuaugpksesyvpqv3'}, {'type': 0, 'spent': True, 'value': 706, 'spending_outpoints': [{'tx_index': 8444128078939684, 'n': 0}], 'n': 41, 'tx_index': 8852968409558727, 'script': '5120ed50a03b4d9207f6f92814dfb2689293dd64c2aa44d10a59e6bd59cef101b433', 'addr': 'bc1pa4g2qw6djgrld7fgzn0my6yjj0wkfs42gngs5k0xh4vuaugpksesyvpqv3'}, {'type': 0, 'spent': True, 'value': 706, 'spending_outpoints': [{'tx_index': 2217830146130398, 'n': 0}], 'n': 42, 'tx_index': 8852968409558727, 'script': '5120ed50a03b4d9207f6f92814dfb2689293dd64c2aa44d10a59e6bd59cef101b433', 'addr': 'bc1pa4g2qw6djgrld7fgzn0my6yjj0wkfs42gngs5k0xh4vuaugpksesyvpqv3'}, {'type': 0, 'spent': True, 'value': 706, 'spending_outpoints': [{'tx_index': 5256868346664821, 'n': 0}], 'n': 43, 'tx_index': 8852968409558727, 'script': '5120ed50a03b4d9207f6f92814dfb2689293dd64c2aa44d10a59e6bd59cef101b433', 'addr': 'bc1pa4g2qw6djgrld7fgzn0my6yjj0wkfs42gngs5k0xh4vuaugpksesyvpqv3'}, {'type': 0, 'spent': True, 'value': 705, 'spending_outpoints': [{'tx_index': 1785074134712174, 'n': 0}], 'n': 44, 'tx_index': 8852968409558727, 'script': '5120ed50a03b4d9207f6f92814dfb2689293dd64c2aa44d10a59e6bd59cef101b433', 'addr': 'bc1pa4g2qw6djgrld7fgzn0my6yjj0wkfs42gngs5k0xh4vuaugpksesyvpqv3'}, {'type': 0, 'spent': True, 'value': 706, 'spending_outpoints': [{'tx_index': 1844409038217018, 'n': 0}], 'n': 45, 'tx_index': 8852968409558727, 'script': '5120ed50a03b4d9207f6f92814dfb2689293dd64c2aa44d10a59e6bd59cef101b433', 'addr': 'bc1pa4g2qw6djgrld7fgzn0my6yjj0wkfs42gngs5k0xh4vuaugpksesyvpqv3'}, {'type': 0, 'spent': True, 'value': 718, 'spending_outpoints': [{'tx_index': 3949929241891266, 'n': 0}], 'n': 46, 'tx_index': 8852968409558727, 'script': '5120ed50a03b4d9207f6f92814dfb2689293dd64c2aa44d10a59e6bd59cef101b433', 'addr': 'bc1pa4g2qw6djgrld7fgzn0my6yjj0wkfs42gngs5k0xh4vuaugpksesyvpqv3'}, {'type': 0, 'spent': True, 'value': 706, 'spending_outpoints': [{'tx_index': 4615909089834077, 'n': 0}], 'n': 47, 'tx_index': 8852968409558727, 'script': '5120ed50a03b4d9207f6f92814dfb2689293dd64c2aa44d10a59e6bd59cef101b433', 'addr': 'bc1pa4g2qw6djgrld7fgzn0my6yjj0wkfs42gngs5k0xh4vuaugpksesyvpqv3'}, {'type': 0, 'spent': True, 'value': 705, 'spending_outpoints': [{'tx_index': 38914758266062, 'n': 0}], 'n': 48, 'tx_index': 8852968409558727, 'script': '5120ed50a03b4d9207f6f92814dfb2689293dd64c2aa44d10a59e6bd59cef101b433', 'addr': 'bc1pa4g2qw6djgrld7fgzn0my6yjj0wkfs42gngs5k0xh4vuaugpksesyvpqv3'}, {'type': 0, 'spent': True, 'value': 718, 'spending_outpoints': [{'tx_index': 346460984440273, 'n': 0}], 'n': 49, 'tx_index': 8852968409558727, 'script': '5120ed50a03b4d9207f6f92814dfb2689293dd64c2aa44d10a59e6bd59cef101b433', 'addr': 'bc1pa4g2qw6djgrld7fgzn0my6yjj0wkfs42gngs5k0xh4vuaugpksesyvpqv3'}, {'type': 0, 'spent': True, 'value': 706, 'spending_outpoints': [{'tx_index': 4983762771952231, 'n': 0}], 'n': 50, 'tx_index': 8852968409558727, 'script': '5120ed50a03b4d9207f6f92814dfb2689293dd64c2aa44d10a59e6bd59cef101b433', 'addr': 'bc1pa4g2qw6djgrld7fgzn0my6yjj0wkfs42gngs5k0xh4vuaugpksesyvpqv3'}, {'type': 0, 'spent': True, 'value': 718, 'spending_outpoints': [{'tx_index': 3164365413651712, 'n': 0}], 'n': 51, 'tx_index': 8852968409558727, 'script': '5120ed50a03b4d9207f6f92814dfb2689293dd64c2aa44d10a59e6bd59cef101b433', 'addr': 'bc1pa4g2qw6djgrld7fgzn0my6yjj0wkfs42gngs5k0xh4vuaugpksesyvpqv3'}, {'type': 0, 'spent': True, 'value': 705, 'spending_outpoints': [{'tx_index': 4354406326951798, 'n': 0}], 'n': 52, 'tx_index': 8852968409558727, 'script': '5120ed50a03b4d9207f6f92814dfb2689293dd64c2aa44d10a59e6bd59cef101b433', 'addr': 'bc1pa4g2qw6djgrld7fgzn0my6yjj0wkfs42gngs5k0xh4vuaugpksesyvpqv3'}, {'type': 0, 'spent': True, 'value': 718, 'spending_outpoints': [{'tx_index': 3702537882829540, 'n': 0}], 'n': 53, 'tx_index': 8852968409558727, 'script': '5120ed50a03b4d9207f6f92814dfb2689293dd64c2aa44d10a59e6bd59cef101b433', 'addr': 'bc1pa4g2qw6djgrld7fgzn0my6yjj0wkfs42gngs5k0xh4vuaugpksesyvpqv3'}, {'type': 0, 'spent': True, 'value': 705, 'spending_outpoints': [{'tx_index': 7446678144583503, 'n': 0}], 'n': 54, 'tx_index': 8852968409558727, 'script': '5120ed50a03b4d9207f6f92814dfb2689293dd64c2aa44d10a59e6bd59cef101b433', 'addr': 'bc1pa4g2qw6djgrld7fgzn0my6yjj0wkfs42gngs5k0xh4vuaugpksesyvpqv3'}, {'type': 0, 'spent': True, 'value': 706, 'spending_outpoints': [{'tx_index': 110912636825632, 'n': 0}], 'n': 55, 'tx_index': 8852968409558727, 'script': '5120ed50a03b4d9207f6f92814dfb2689293dd64c2aa44d10a59e6bd59cef101b433', 'addr': 'bc1pa4g2qw6djgrld7fgzn0my6yjj0wkfs42gngs5k0xh4vuaugpksesyvpqv3'}, {'type': 0, 'spent': True, 'value': 718, 'spending_outpoints': [{'tx_index': 3436399208616216, 'n': 0}], 'n': 56, 'tx_index': 8852968409558727, 'script': '5120ed50a03b4d9207f6f92814dfb2689293dd64c2aa44d10a59e6bd59cef101b433', 'addr': 'bc1pa4g2qw6djgrld7fgzn0my6yjj0wkfs42gngs5k0xh4vuaugpksesyvpqv3'}, {'type': 0, 'spent': True, 'value': 706, 'spending_outpoints': [{'tx_index': 4956184862261020, 'n': 0}], 'n': 57, 'tx_index': 8852968409558727, 'script': '5120ed50a03b4d9207f6f92814dfb2689293dd64c2aa44d10a59e6bd59cef101b433', 'addr': 'bc1pa4g2qw6djgrld7fgzn0my6yjj0wkfs42gngs5k0xh4vuaugpksesyvpqv3'}, {'type': 0, 'spent': True, 'value': 708, 'spending_outpoints': [{'tx_index': 1557346786047946, 'n': 0}], 'n': 58, 'tx_index': 8852968409558727, 'script': '5120ed50a03b4d9207f6f92814dfb2689293dd64c2aa44d10a59e6bd59cef101b433', 'addr': 'bc1pa4g2qw6djgrld7fgzn0my6yjj0wkfs42gngs5k0xh4vuaugpksesyvpqv3'}, {'type': 0, 'spent': True, 'value': 708, 'spending_outpoints': [{'tx_index': 3751049012096067, 'n': 0}], 'n': 59, 'tx_index': 8852968409558727, 'script': '5120ed50a03b4d9207f6f92814dfb2689293dd64c2aa44d10a59e6bd59cef101b433', 'addr': 'bc1pa4g2qw6djgrld7fgzn0my6yjj0wkfs42gngs5k0xh4vuaugpksesyvpqv3'}, {'type': 0, 'spent': True, 'value': 708, 'spending_outpoints': [{'tx_index': 5559144209024680, 'n': 0}], 'n': 60, 'tx_index': 8852968409558727, 'script': '5120ed50a03b4d9207f6f92814dfb2689293dd64c2aa44d10a59e6bd59cef101b433', 'addr': 'bc1pa4g2qw6djgrld7fgzn0my6yjj0wkfs42gngs5k0xh4vuaugpksesyvpqv3'}, {'type': 0, 'spent': True, 'value': 708, 'spending_outpoints': [{'tx_index': 2340434468288657, 'n': 0}], 'n': 61, 'tx_index': 8852968409558727, 'script': '5120ed50a03b4d9207f6f92814dfb2689293dd64c2aa44d10a59e6bd59cef101b433', 'addr': 'bc1pa4g2qw6djgrld7fgzn0my6yjj0wkfs42gngs5k0xh4vuaugpksesyvpqv3'}, {'type': 0, 'spent': True, 'value': 706, 'spending_outpoints': [{'tx_index': 4486514703443418, 'n': 0}], 'n': 62, 'tx_index': 8852968409558727, 'script': '5120ed50a03b4d9207f6f92814dfb2689293dd64c2aa44d10a59e6bd59cef101b433', 'addr': 'bc1pa4g2qw6djgrld7fgzn0my6yjj0wkfs42gngs5k0xh4vuaugpksesyvpqv3'}, {'type': 0, 'spent': True, 'value': 706, 'spending_outpoints': [{'tx_index': 6515451884715674, 'n': 0}], 'n': 63, 'tx_index': 8852968409558727, 'script': '5120ed50a03b4d9207f6f92814dfb2689293dd64c2aa44d10a59e6bd59cef101b433', 'addr': 'bc1pa4g2qw6djgrld7fgzn0my6yjj0wkfs42gngs5k0xh4vuaugpksesyvpqv3'}, {'type': 0, 'spent': True, 'value': 706, 'spending_outpoints': [{'tx_index': 3608756085347728, 'n': 0}], 'n': 64, 'tx_index': 8852968409558727, 'script': '5120ed50a03b4d9207f6f92814dfb2689293dd64c2aa44d10a59e6bd59cef101b433', 'addr': 'bc1pa4g2qw6djgrld7fgzn0my6yjj0wkfs42gngs5k0xh4vuaugpksesyvpqv3'}, {'type': 0, 'spent': True, 'value': 718, 'spending_outpoints': [{'tx_index': 5620189184335689, 'n': 0}], 'n': 65, 'tx_index': 8852968409558727, 'script': '5120ed50a03b4d9207f6f92814dfb2689293dd64c2aa44d10a59e6bd59cef101b433', 'addr': 'bc1pa4g2qw6djgrld7fgzn0my6yjj0wkfs42gngs5k0xh4vuaugpksesyvpqv3'}, {'type': 0, 'spent': True, 'value': 706, 'spending_outpoints': [{'tx_index': 2562789454848792, 'n': 0}], 'n': 66, 'tx_index': 8852968409558727, 'script': '5120ed50a03b4d9207f6f92814dfb2689293dd64c2aa44d10a59e6bd59cef101b433', 'addr': 'bc1pa4g2qw6djgrld7fgzn0my6yjj0wkfs42gngs5k0xh4vuaugpksesyvpqv3'}, {'type': 0, 'spent': True, 'value': 705, 'spending_outpoints': [{'tx_index': 1728254377076037, 'n': 0}], 'n': 67, 'tx_index': 8852968409558727, 'script': '5120ed50a03b4d9207f6f92814dfb2689293dd64c2aa44d10a59e6bd59cef101b433', 'addr': 'bc1pa4g2qw6djgrld7fgzn0my6yjj0wkfs42gngs5k0xh4vuaugpksesyvpqv3'}, {'type': 0, 'spent': True, 'value': 706, 'spending_outpoints': [{'tx_index': 5863785055011264, 'n': 0}], 'n': 68, 'tx_index': 8852968409558727, 'script': '5120ed50a03b4d9207f6f92814dfb2689293dd64c2aa44d10a59e6bd59cef101b433', 'addr': 'bc1pa4g2qw6djgrld7fgzn0my6yjj0wkfs42gngs5k0xh4vuaugpksesyvpqv3'}, {'type': 0, 'spent': True, 'value': 706, 'spending_outpoints': [{'tx_index': 8588736516147208, 'n': 0}], 'n': 69, 'tx_index': 8852968409558727, 'script': '5120ed50a03b4d9207f6f92814dfb2689293dd64c2aa44d10a59e6bd59cef101b433', 'addr': 'bc1pa4g2qw6djgrld7fgzn0my6yjj0wkfs42gngs5k0xh4vuaugpksesyvpqv3'}, {'type': 0, 'spent': True, 'value': 708, 'spending_outpoints': [{'tx_index': 8566286086760894, 'n': 0}], 'n': 70, 'tx_index': 8852968409558727, 'script': '5120ed50a03b4d9207f6f92814dfb2689293dd64c2aa44d10a59e6bd59cef101b433', 'addr': 'bc1pa4g2qw6djgrld7fgzn0my6yjj0wkfs42gngs5k0xh4vuaugpksesyvpqv3'}, {'type': 0, 'spent': True, 'value': 708, 'spending_outpoints': [{'tx_index': 5000262985321752, 'n': 0}], 'n': 71, 'tx_index': 8852968409558727, 'script': '5120ed50a03b4d9207f6f92814dfb2689293dd64c2aa44d10a59e6bd59cef101b433', 'addr': 'bc1pa4g2qw6djgrld7fgzn0my6yjj0wkfs42gngs5k0xh4vuaugpksesyvpqv3'}, {'type': 0, 'spent': True, 'value': 708, 'spending_outpoints': [{'tx_index': 1943591353926759, 'n': 0}], 'n': 72, 'tx_index': 8852968409558727, 'script': '5120ed50a03b4d9207f6f92814dfb2689293dd64c2aa44d10a59e6bd59cef101b433', 'addr': 'bc1pa4g2qw6djgrld7fgzn0my6yjj0wkfs42gngs5k0xh4vuaugpksesyvpqv3'}, {'type': 0, 'spent': True, 'value': 718, 'spending_outpoints': [{'tx_index': 6826697211177544, 'n': 0}], 'n': 73, 'tx_index': 8852968409558727, 'script': '5120ed50a03b4d9207f6f92814dfb2689293dd64c2aa44d10a59e6bd59cef101b433', 'addr': 'bc1pa4g2qw6djgrld7fgzn0my6yjj0wkfs42gngs5k0xh4vuaugpksesyvpqv3'}, {'type': 0, 'spent': True, 'value': 705, 'spending_outpoints': [{'tx_index': 2996781146363579, 'n': 0}], 'n': 74, 'tx_index': 8852968409558727, 'script': '5120ed50a03b4d9207f6f92814dfb2689293dd64c2aa44d10a59e6bd59cef101b433', 'addr': 'bc1pa4g2qw6djgrld7fgzn0my6yjj0wkfs42gngs5k0xh4vuaugpksesyvpqv3'}, {'type': 0, 'spent': True, 'value': 718, 'spending_outpoints': [{'tx_index': 3697632651377023, 'n': 0}], 'n': 75, 'tx_index': 8852968409558727, 'script': '5120ed50a03b4d9207f6f92814dfb2689293dd64c2aa44d10a59e6bd59cef101b433', 'addr': 'bc1pa4g2qw6djgrld7fgzn0my6yjj0wkfs42gngs5k0xh4vuaugpksesyvpqv3'}, {'type': 0, 'spent': True, 'value': 708, 'spending_outpoints': [{'tx_index': 8709716416806375, 'n': 0}], 'n': 76, 'tx_index': 8852968409558727, 'script': '5120ed50a03b4d9207f6f92814dfb2689293dd64c2aa44d10a59e6bd59cef101b433', 'addr': 'bc1pa4g2qw6djgrld7fgzn0my6yjj0wkfs42gngs5k0xh4vuaugpksesyvpqv3'}, {'type': 0, 'spent': True, 'value': 705, 'spending_outpoints': [{'tx_index': 2058115046501058, 'n': 0}], 'n': 77, 'tx_index': 8852968409558727, 'script': '5120ed50a03b4d9207f6f92814dfb2689293dd64c2aa44d10a59e6bd59cef101b433', 'addr': 'bc1pa4g2qw6djgrld7fgzn0my6yjj0wkfs42gngs5k0xh4vuaugpksesyvpqv3'}, {'type': 0, 'spent': True, 'value': 706, 'spending_outpoints': [{'tx_index': 4130351325965759, 'n': 0}], 'n': 78, 'tx_index': 8852968409558727, 'script': '5120ed50a03b4d9207f6f92814dfb2689293dd64c2aa44d10a59e6bd59cef101b433', 'addr': 'bc1pa4g2qw6djgrld7fgzn0my6yjj0wkfs42gngs5k0xh4vuaugpksesyvpqv3'}, {'type': 0, 'spent': True, 'value': 718, 'spending_outpoints': [{'tx_index': 3729738731801005, 'n': 0}], 'n': 79, 'tx_index': 8852968409558727, 'script': '5120ed50a03b4d9207f6f92814dfb2689293dd64c2aa44d10a59e6bd59cef101b433', 'addr': 'bc1pa4g2qw6djgrld7fgzn0my6yjj0wkfs42gngs5k0xh4vuaugpksesyvpqv3'}, {'type': 0, 'spent': True, 'value': 705, 'spending_outpoints': [{'tx_index': 1530321472032697, 'n': 0}], 'n': 80, 'tx_index': 8852968409558727, 'script': '5120ed50a03b4d9207f6f92814dfb2689293dd64c2aa44d10a59e6bd59cef101b433', 'addr': 'bc1pa4g2qw6djgrld7fgzn0my6yjj0wkfs42gngs5k0xh4vuaugpksesyvpqv3'}, {'type': 0, 'spent': True, 'value': 705, 'spending_outpoints': [{'tx_index': 3814963056032170, 'n': 0}], 'n': 81, 'tx_index': 8852968409558727, 'script': '5120ed50a03b4d9207f6f92814dfb2689293dd64c2aa44d10a59e6bd59cef101b433', 'addr': 'bc1pa4g2qw6djgrld7fgzn0my6yjj0wkfs42gngs5k0xh4vuaugpksesyvpqv3'}, {'type': 0, 'spent': True, 'value': 706, 'spending_outpoints': [{'tx_index': 1449671236873568, 'n': 0}], 'n': 82, 'tx_index': 8852968409558727, 'script': '5120ed50a03b4d9207f6f92814dfb2689293dd64c2aa44d10a59e6bd59cef101b433', 'addr': 'bc1pa4g2qw6djgrld7fgzn0my6yjj0wkfs42gngs5k0xh4vuaugpksesyvpqv3'}, {'type': 0, 'spent': True, 'value': 708, 'spending_outpoints': [{'tx_index': 1432068288930469, 'n': 0}], 'n': 83, 'tx_index': 8852968409558727, 'script': '5120ed50a03b4d9207f6f92814dfb2689293dd64c2aa44d10a59e6bd59cef101b433', 'addr': 'bc1pa4g2qw6djgrld7fgzn0my6yjj0wkfs42gngs5k0xh4vuaugpksesyvpqv3'}, {'type': 0, 'spent': True, 'value': 705, 'spending_outpoints': [{'tx_index': 2839065500683971, 'n': 0}], 'n': 84, 'tx_index': 8852968409558727, 'script': '5120ed50a03b4d9207f6f92814dfb2689293dd64c2aa44d10a59e6bd59cef101b433', 'addr': 'bc1pa4g2qw6djgrld7fgzn0my6yjj0wkfs42gngs5k0xh4vuaugpksesyvpqv3'}, {'type': 0, 'spent': True, 'value': 706, 'spending_outpoints': [{'tx_index': 8726837901521304, 'n': 0}], 'n': 85, 'tx_index': 8852968409558727, 'script': '5120ed50a03b4d9207f6f92814dfb2689293dd64c2aa44d10a59e6bd59cef101b433', 'addr': 'bc1pa4g2qw6djgrld7fgzn0my6yjj0wkfs42gngs5k0xh4vuaugpksesyvpqv3'}, {'type': 0, 'spent': True, 'value': 718, 'spending_outpoints': [{'tx_index': 8704692235622805, 'n': 0}], 'n': 86, 'tx_index': 8852968409558727, 'script': '5120ed50a03b4d9207f6f92814dfb2689293dd64c2aa44d10a59e6bd59cef101b433', 'addr': 'bc1pa4g2qw6djgrld7fgzn0my6yjj0wkfs42gngs5k0xh4vuaugpksesyvpqv3'}, {'type': 0, 'spent': True, 'value': 708, 'spending_outpoints': [{'tx_index': 2505214995723494, 'n': 0}], 'n': 87, 'tx_index': 8852968409558727, 'script': '5120ed50a03b4d9207f6f92814dfb2689293dd64c2aa44d10a59e6bd59cef101b433', 'addr': 'bc1pa4g2qw6djgrld7fgzn0my6yjj0wkfs42gngs5k0xh4vuaugpksesyvpqv3'}, {'type': 0, 'spent': True, 'value': 705, 'spending_outpoints': [{'tx_index': 8492042098524652, 'n': 0}], 'n': 88, 'tx_index': 8852968409558727, 'script': '5120ed50a03b4d9207f6f92814dfb2689293dd64c2aa44d10a59e6bd59cef101b433', 'addr': 'bc1pa4g2qw6djgrld7fgzn0my6yjj0wkfs42gngs5k0xh4vuaugpksesyvpqv3'}, {'type': 0, 'spent': True, 'value': 706, 'spending_outpoints': [{'tx_index': 6424378847718543, 'n': 0}], 'n': 89, 'tx_index': 8852968409558727, 'script': '5120ed50a03b4d9207f6f92814dfb2689293dd64c2aa44d10a59e6bd59cef101b433', 'addr': 'bc1pa4g2qw6djgrld7fgzn0my6yjj0wkfs42gngs5k0xh4vuaugpksesyvpqv3'}, {'type': 0, 'spent': True, 'value': 718, 'spending_outpoints': [{'tx_index': 7921549049269353, 'n': 0}], 'n': 90, 'tx_index': 8852968409558727, 'script': '5120ed50a03b4d9207f6f92814dfb2689293dd64c2aa44d10a59e6bd59cef101b433', 'addr': 'bc1pa4g2qw6djgrld7fgzn0my6yjj0wkfs42gngs5k0xh4vuaugpksesyvpqv3'}, {'type': 0, 'spent': True, 'value': 708, 'spending_outpoints': [{'tx_index': 1620933792727899, 'n': 0}], 'n': 91, 'tx_index': 8852968409558727, 'script': '5120ed50a03b4d9207f6f92814dfb2689293dd64c2aa44d10a59e6bd59cef101b433', 'addr': 'bc1pa4g2qw6djgrld7fgzn0my6yjj0wkfs42gngs5k0xh4vuaugpksesyvpqv3'}, {'type': 0, 'spent': True, 'value': 706, 'spending_outpoints': [{'tx_index': 8068025811217848, 'n': 0}], 'n': 92, 'tx_index': 8852968409558727, 'script': '5120ed50a03b4d9207f6f92814dfb2689293dd64c2aa44d10a59e6bd59cef101b433', 'addr': 'bc1pa4g2qw6djgrld7fgzn0my6yjj0wkfs42gngs5k0xh4vuaugpksesyvpqv3'}, {'type': 0, 'spent': True, 'value': 705, 'spending_outpoints': [{'tx_index': 8858478973777073, 'n': 0}], 'n': 93, 'tx_index': 8852968409558727, 'script': '5120ed50a03b4d9207f6f92814dfb2689293dd64c2aa44d10a59e6bd59cef101b433', 'addr': 'bc1pa4g2qw6djgrld7fgzn0my6yjj0wkfs42gngs5k0xh4vuaugpksesyvpqv3'}, {'type': 0, 'spent': True, 'value': 718, 'spending_outpoints': [{'tx_index': 2644208511898853, 'n': 0}], 'n': 94, 'tx_index': 8852968409558727, 'script': '5120ed50a03b4d9207f6f92814dfb2689293dd64c2aa44d10a59e6bd59cef101b433', 'addr': 'bc1pa4g2qw6djgrld7fgzn0my6yjj0wkfs42gngs5k0xh4vuaugpksesyvpqv3'}, {'type': 0, 'spent': True, 'value': 708, 'spending_outpoints': [{'tx_index': 650865372163514, 'n': 0}], 'n': 95, 'tx_index': 8852968409558727, 'script': '5120ed50a03b4d9207f6f92814dfb2689293dd64c2aa44d10a59e6bd59cef101b433', 'addr': 'bc1pa4g2qw6djgrld7fgzn0my6yjj0wkfs42gngs5k0xh4vuaugpksesyvpqv3'}, {'type': 0, 'spent': True, 'value': 706, 'spending_outpoints': [{'tx_index': 3327742925711495, 'n': 0}], 'n': 96, 'tx_index': 8852968409558727, 'script': '5120ed50a03b4d9207f6f92814dfb2689293dd64c2aa44d10a59e6bd59cef101b433', 'addr': 'bc1pa4g2qw6djgrld7fgzn0my6yjj0wkfs42gngs5k0xh4vuaugpksesyvpqv3'}, {'type': 0, 'spent': True, 'value': 705, 'spending_outpoints': [{'tx_index': 927895990162533, 'n': 0}], 'n': 97, 'tx_index': 8852968409558727, 'script': '5120ed50a03b4d9207f6f92814dfb2689293dd64c2aa44d10a59e6bd59cef101b433', 'addr': 'bc1pa4g2qw6djgrld7fgzn0my6yjj0wkfs42gngs5k0xh4vuaugpksesyvpqv3'}, {'type': 0, 'spent': True, 'value': 718, 'spending_outpoints': [{'tx_index': 7703728731058313, 'n': 0}], 'n': 98, 'tx_index': 8852968409558727, 'script': '5120ed50a03b4d9207f6f92814dfb2689293dd64c2aa44d10a59e6bd59cef101b433', 'addr': 'bc1pa4g2qw6djgrld7fgzn0my6yjj0wkfs42gngs5k0xh4vuaugpksesyvpqv3'}, {'type': 0, 'spent': True, 'value': 706, 'spending_outpoints': [{'tx_index': 7527548231662640, 'n': 0}], 'n': 99, 'tx_index': 8852968409558727, 'script': '5120ed50a03b4d9207f6f92814dfb2689293dd64c2aa44d10a59e6bd59cef101b433', 'addr': 'bc1pa4g2qw6djgrld7fgzn0my6yjj0wkfs42gngs5k0xh4vuaugpksesyvpqv3'}, {'type': 0, 'spent': True, 'value': 708, 'spending_outpoints': [{'tx_index': 1369345929010822, 'n': 0}], 'n': 100, 'tx_index': 8852968409558727, 'script': '5120ed50a03b4d9207f6f92814dfb2689293dd64c2aa44d10a59e6bd59cef101b433', 'addr': 'bc1pa4g2qw6djgrld7fgzn0my6yjj0wkfs42gngs5k0xh4vuaugpksesyvpqv3'}, {'type': 0, 'spent': True, 'value': 705, 'spending_outpoints': [{'tx_index': 3338283102949466, 'n': 0}], 'n': 101, 'tx_index': 8852968409558727, 'script': '5120ed50a03b4d9207f6f92814dfb2689293dd64c2aa44d10a59e6bd59cef101b433', 'addr': 'bc1pa4g2qw6djgrld7fgzn0my6yjj0wkfs42gngs5k0xh4vuaugpksesyvpqv3'}, {'type': 0, 'spent': True, 'value': 718, 'spending_outpoints': [{'tx_index': 743375704361424, 'n': 0}], 'n': 102, 'tx_index': 8852968409558727, 'script': '5120ed50a03b4d9207f6f92814dfb2689293dd64c2aa44d10a59e6bd59cef101b433', 'addr': 'bc1pa4g2qw6djgrld7fgzn0my6yjj0wkfs42gngs5k0xh4vuaugpksesyvpqv3'}, {'type': 0, 'spent': True, 'value': 708, 'spending_outpoints': [{'tx_index': 8919895119231297, 'n': 0}], 'n': 103, 'tx_index': 8852968409558727, 'script': '5120ed50a03b4d9207f6f92814dfb2689293dd64c2aa44d10a59e6bd59cef101b433', 'addr': 'bc1pa4g2qw6djgrld7fgzn0my6yjj0wkfs42gngs5k0xh4vuaugpksesyvpqv3'}, {'type': 0, 'spent': True, 'value': 706, 'spending_outpoints': [{'tx_index': 995108236611009, 'n': 0}], 'n': 104, 'tx_index': 8852968409558727, 'script': '5120ed50a03b4d9207f6f92814dfb2689293dd64c2aa44d10a59e6bd59cef101b433', 'addr': 'bc1pa4g2qw6djgrld7fgzn0my6yjj0wkfs42gngs5k0xh4vuaugpksesyvpqv3'}, {'type': 0, 'spent': True, 'value': 705, 'spending_outpoints': [{'tx_index': 7978798323078392, 'n': 0}], 'n': 105, 'tx_index': 8852968409558727, 'script': '5120ed50a03b4d9207f6f92814dfb2689293dd64c2aa44d10a59e6bd59cef101b433', 'addr': 'bc1pa4g2qw6djgrld7fgzn0my6yjj0wkfs42gngs5k0xh4vuaugpksesyvpqv3'}, {'type': 0, 'spent': True, 'value': 718, 'spending_outpoints': [{'tx_index': 2833703884833983, 'n': 0}], 'n': 106, 'tx_index': 8852968409558727, 'script': '5120ed50a03b4d9207f6f92814dfb2689293dd64c2aa44d10a59e6bd59cef101b433', 'addr': 'bc1pa4g2qw6djgrld7fgzn0my6yjj0wkfs42gngs5k0xh4vuaugpksesyvpqv3'}, {'type': 0, 'spent': True, 'value': 708, 'spending_outpoints': [{'tx_index': 6152849859345913, 'n': 0}], 'n': 107, 'tx_index': 8852968409558727, 'script': '5120ed50a03b4d9207f6f92814dfb2689293dd64c2aa44d10a59e6bd59cef101b433', 'addr': 'bc1pa4g2qw6djgrld7fgzn0my6yjj0wkfs42gngs5k0xh4vuaugpksesyvpqv3'}, {'type': 0, 'spent': True, 'value': 706, 'spending_outpoints': [{'tx_index': 4512841910001147, 'n': 0}], 'n': 108, 'tx_index': 8852968409558727, 'script': '5120ed50a03b4d9207f6f92814dfb2689293dd64c2aa44d10a59e6bd59cef101b433', 'addr': 'bc1pa4g2qw6djgrld7fgzn0my6yjj0wkfs42gngs5k0xh4vuaugpksesyvpqv3'}, {'type': 0, 'spent': True, 'value': 705, 'spending_outpoints': [{'tx_index': 2904167839150805, 'n': 0}], 'n': 109, 'tx_index': 8852968409558727, 'script': '5120ed50a03b4d9207f6f92814dfb2689293dd64c2aa44d10a59e6bd59cef101b433', 'addr': 'bc1pa4g2qw6djgrld7fgzn0my6yjj0wkfs42gngs5k0xh4vuaugpksesyvpqv3'}, {'type': 0, 'spent': True, 'value': 718, 'spending_outpoints': [{'tx_index': 7812011409403853, 'n': 0}], 'n': 110, 'tx_index': 8852968409558727, 'script': '5120ed50a03b4d9207f6f92814dfb2689293dd64c2aa44d10a59e6bd59cef101b433', 'addr': 'bc1pa4g2qw6djgrld7fgzn0my6yjj0wkfs42gngs5k0xh4vuaugpksesyvpqv3'}, {'type': 0, 'spent': True, 'value': 708, 'spending_outpoints': [{'tx_index': 6656867890349854, 'n': 0}], 'n': 111, 'tx_index': 8852968409558727, 'script': '5120ed50a03b4d9207f6f92814dfb2689293dd64c2aa44d10a59e6bd59cef101b433', 'addr': 'bc1pa4g2qw6djgrld7fgzn0my6yjj0wkfs42gngs5k0xh4vuaugpksesyvpqv3'}, {'type': 0, 'spent': True, 'value': 705, 'spending_outpoints': [{'tx_index': 2769261297310072, 'n': 0}], 'n': 112, 'tx_index': 8852968409558727, 'script': '5120ed50a03b4d9207f6f92814dfb2689293dd64c2aa44d10a59e6bd59cef101b433', 'addr': 'bc1pa4g2qw6djgrld7fgzn0my6yjj0wkfs42gngs5k0xh4vuaugpksesyvpqv3'}, {'type': 0, 'spent': True, 'value': 718, 'spending_outpoints': [{'tx_index': 8967914553407810, 'n': 0}], 'n': 113, 'tx_index': 8852968409558727, 'script': '5120ed50a03b4d9207f6f92814dfb2689293dd64c2aa44d10a59e6bd59cef101b433', 'addr': 'bc1pa4g2qw6djgrld7fgzn0my6yjj0wkfs42gngs5k0xh4vuaugpksesyvpqv3'}, {'type': 0, 'spent': True, 'value': 708, 'spending_outpoints': [{'tx_index': 7182278641997565, 'n': 0}], 'n': 114, 'tx_index': 8852968409558727, 'script': '5120ed50a03b4d9207f6f92814dfb2689293dd64c2aa44d10a59e6bd59cef101b433', 'addr': 'bc1pa4g2qw6djgrld7fgzn0my6yjj0wkfs42gngs5k0xh4vuaugpksesyvpqv3'}, {'type': 0, 'spent': True, 'value': 705, 'spending_outpoints': [{'tx_index': 8757925917929490, 'n': 0}], 'n': 115, 'tx_index': 8852968409558727, 'script': '5120ed50a03b4d9207f6f92814dfb2689293dd64c2aa44d10a59e6bd59cef101b433', 'addr': 'bc1pa4g2qw6djgrld7fgzn0my6yjj0wkfs42gngs5k0xh4vuaugpksesyvpqv3'}, {'type': 0, 'spent': True, 'value': 718, 'spending_outpoints': [{'tx_index': 1064386935760802, 'n': 0}], 'n': 116, 'tx_index': 8852968409558727, 'script': '5120ed50a03b4d9207f6f92814dfb2689293dd64c2aa44d10a59e6bd59cef101b433', 'addr': 'bc1pa4g2qw6djgrld7fgzn0my6yjj0wkfs42gngs5k0xh4vuaugpksesyvpqv3'}, {'type': 0, 'spent': True, 'value': 708, 'spending_outpoints': [{'tx_index': 293139775356453, 'n': 0}], 'n': 117, 'tx_index': 8852968409558727, 'script': '5120ed50a03b4d9207f6f92814dfb2689293dd64c2aa44d10a59e6bd59cef101b433', 'addr': 'bc1pa4g2qw6djgrld7fgzn0my6yjj0wkfs42gngs5k0xh4vuaugpksesyvpqv3'}, {'type': 0, 'spent': True, 'value': 706, 'spending_outpoints': [{'tx_index': 3701179783124407, 'n': 0}], 'n': 118, 'tx_index': 8852968409558727, 'script': '5120ed50a03b4d9207f6f92814dfb2689293dd64c2aa44d10a59e6bd59cef101b433', 'addr': 'bc1pa4g2qw6djgrld7fgzn0my6yjj0wkfs42gngs5k0xh4vuaugpksesyvpqv3'}, {'type': 0, 'spent': True, 'value': 705, 'spending_outpoints': [{'tx_index': 5846736077266186, 'n': 0}], 'n': 119, 'tx_index': 8852968409558727, 'script': '5120ed50a03b4d9207f6f92814dfb2689293dd64c2aa44d10a59e6bd59cef101b433', 'addr': 'bc1pa4g2qw6djgrld7fgzn0my6yjj0wkfs42gngs5k0xh4vuaugpksesyvpqv3'}, {'type': 0, 'spent': True, 'value': 718, 'spending_outpoints': [{'tx_index': 172678129672900, 'n': 0}], 'n': 120, 'tx_index': 8852968409558727, 'script': '5120ed50a03b4d9207f6f92814dfb2689293dd64c2aa44d10a59e6bd59cef101b433', 'addr': 'bc1pa4g2qw6djgrld7fgzn0my6yjj0wkfs42gngs5k0xh4vuaugpksesyvpqv3'}, {'type': 0, 'spent': True, 'value': 708, 'spending_outpoints': [{'tx_index': 7614097742458097, 'n': 0}], 'n': 121, 'tx_index': 8852968409558727, 'script': '5120ed50a03b4d9207f6f92814dfb2689293dd64c2aa44d10a59e6bd59cef101b433', 'addr': 'bc1pa4g2qw6djgrld7fgzn0my6yjj0wkfs42gngs5k0xh4vuaugpksesyvpqv3'}, {'type': 0, 'spent': True, 'value': 706, 'spending_outpoints': [{'tx_index': 4980154388748300, 'n': 0}], 'n': 122, 'tx_index': 8852968409558727, 'script': '5120ed50a03b4d9207f6f92814dfb2689293dd64c2aa44d10a59e6bd59cef101b433', 'addr': 'bc1pa4g2qw6djgrld7fgzn0my6yjj0wkfs42gngs5k0xh4vuaugpksesyvpqv3'}, {'type': 0, 'spent': True, 'value': 705, 'spending_outpoints': [{'tx_index': 1098977099438842, 'n': 0}], 'n': 123, 'tx_index': 8852968409558727, 'script': '5120ed50a03b4d9207f6f92814dfb2689293dd64c2aa44d10a59e6bd59cef101b433', 'addr': 'bc1pa4g2qw6djgrld7fgzn0my6yjj0wkfs42gngs5k0xh4vuaugpksesyvpqv3'}, {'type': 0, 'spent': True, 'value': 718, 'spending_outpoints': [{'tx_index': 1265323309043550, 'n': 0}], 'n': 124, 'tx_index': 8852968409558727, 'script': '5120ed50a03b4d9207f6f92814dfb2689293dd64c2aa44d10a59e6bd59cef101b433', 'addr': 'bc1pa4g2qw6djgrld7fgzn0my6yjj0wkfs42gngs5k0xh4vuaugpksesyvpqv3'}, {'type': 0, 'spent': True, 'value': 708, 'spending_outpoints': [{'tx_index': 5607254386416561, 'n': 0}], 'n': 125, 'tx_index': 8852968409558727, 'script': '5120ed50a03b4d9207f6f92814dfb2689293dd64c2aa44d10a59e6bd59cef101b433', 'addr': 'bc1pa4g2qw6djgrld7fgzn0my6yjj0wkfs42gngs5k0xh4vuaugpksesyvpqv3'}, {'type': 0, 'spent': True, 'value': 706, 'spending_outpoints': [{'tx_index': 532529755832169, 'n': 0}], 'n': 126, 'tx_index': 8852968409558727, 'script': '5120ed50a03b4d9207f6f92814dfb2689293dd64c2aa44d10a59e6bd59cef101b433', 'addr': 'bc1pa4g2qw6djgrld7fgzn0my6yjj0wkfs42gngs5k0xh4vuaugpksesyvpqv3'}, {'type': 0, 'spent': True, 'value': 705, 'spending_outpoints': [{'tx_index': 7482526628967771, 'n': 0}], 'n': 127, 'tx_index': 8852968409558727, 'script': '5120ed50a03b4d9207f6f92814dfb2689293dd64c2aa44d10a59e6bd59cef101b433', 'addr': 'bc1pa4g2qw6djgrld7fgzn0my6yjj0wkfs42gngs5k0xh4vuaugpksesyvpqv3'}, {'type': 0, 'spent': True, 'value': 718, 'spending_outpoints': [{'tx_index': 3838016957776017, 'n': 0}], 'n': 128, 'tx_index': 8852968409558727, 'script': '5120ed50a03b4d9207f6f92814dfb2689293dd64c2aa44d10a59e6bd59cef101b433', 'addr': 'bc1pa4g2qw6djgrld7fgzn0my6yjj0wkfs42gngs5k0xh4vuaugpksesyvpqv3'}, {'type': 0, 'spent': True, 'value': 708, 'spending_outpoints': [{'tx_index': 6989086883807425, 'n': 0}], 'n': 129, 'tx_index': 8852968409558727, 'script': '5120ed50a03b4d9207f6f92814dfb2689293dd64c2aa44d10a59e6bd59cef101b433', 'addr': 'bc1pa4g2qw6djgrld7fgzn0my6yjj0wkfs42gngs5k0xh4vuaugpksesyvpqv3'}, {'type': 0, 'spent': True, 'value': 706, 'spending_outpoints': [{'tx_index': 8517012747625599, 'n': 0}], 'n': 130, 'tx_index': 8852968409558727, 'script': '5120ed50a03b4d9207f6f92814dfb2689293dd64c2aa44d10a59e6bd59cef101b433', 'addr': 'bc1pa4g2qw6djgrld7fgzn0my6yjj0wkfs42gngs5k0xh4vuaugpksesyvpqv3'}, {'type': 0, 'spent': True, 'value': 705, 'spending_outpoints': [{'tx_index': 5981009953477814, 'n': 0}], 'n': 131, 'tx_index': 8852968409558727, 'script': '5120ed50a03b4d9207f6f92814dfb2689293dd64c2aa44d10a59e6bd59cef101b433', 'addr': 'bc1pa4g2qw6djgrld7fgzn0my6yjj0wkfs42gngs5k0xh4vuaugpksesyvpqv3'}, {'type': 0, 'spent': True, 'value': 718, 'spending_outpoints': [{'tx_index': 5384940339584202, 'n': 0}], 'n': 132, 'tx_index': 8852968409558727, 'script': '5120ed50a03b4d9207f6f92814dfb2689293dd64c2aa44d10a59e6bd59cef101b433', 'addr': 'bc1pa4g2qw6djgrld7fgzn0my6yjj0wkfs42gngs5k0xh4vuaugpksesyvpqv3'}, {'type': 0, 'spent': True, 'value': 708, 'spending_outpoints': [{'tx_index': 6613140524462543, 'n': 0}], 'n': 133, 'tx_index': 8852968409558727, 'script': '5120ed50a03b4d9207f6f92814dfb2689293dd64c2aa44d10a59e6bd59cef101b433', 'addr': 'bc1pa4g2qw6djgrld7fgzn0my6yjj0wkfs42gngs5k0xh4vuaugpksesyvpqv3'}, {'type': 0, 'spent': True, 'value': 706, 'spending_outpoints': [{'tx_index': 3739691558740725, 'n': 0}], 'n': 134, 'tx_index': 8852968409558727, 'script': '5120ed50a03b4d9207f6f92814dfb2689293dd64c2aa44d10a59e6bd59cef101b433', 'addr': 'bc1pa4g2qw6djgrld7fgzn0my6yjj0wkfs42gngs5k0xh4vuaugpksesyvpqv3'}, {'type': 0, 'spent': True, 'value': 705, 'spending_outpoints': [{'tx_index': 1526191110944826, 'n': 0}], 'n': 135, 'tx_index': 8852968409558727, 'script': '5120ed50a03b4d9207f6f92814dfb2689293dd64c2aa44d10a59e6bd59cef101b433', 'addr': 'bc1pa4g2qw6djgrld7fgzn0my6yjj0wkfs42gngs5k0xh4vuaugpksesyvpqv3'}, {'type': 0, 'spent': True, 'value': 718, 'spending_outpoints': [{'tx_index': 3189663586736691, 'n': 0}], 'n': 136, 'tx_index': 8852968409558727, 'script': '5120ed50a03b4d9207f6f92814dfb2689293dd64c2aa44d10a59e6bd59cef101b433', 'addr': 'bc1pa4g2qw6djgrld7fgzn0my6yjj0wkfs42gngs5k0xh4vuaugpksesyvpqv3'}, {'type': 0, 'spent': True, 'value': 708, 'spending_outpoints': [{'tx_index': 7357403937240074, 'n': 0}], 'n': 137, 'tx_index': 8852968409558727, 'script': '5120ed50a03b4d9207f6f92814dfb2689293dd64c2aa44d10a59e6bd59cef101b433', 'addr': 'bc1pa4g2qw6djgrld7fgzn0my6yjj0wkfs42gngs5k0xh4vuaugpksesyvpqv3'}, {'type': 0, 'spent': True, 'value': 706, 'spending_outpoints': [{'tx_index': 3215224518809585, 'n': 0}], 'n': 138, 'tx_index': 8852968409558727, 'script': '5120ed50a03b4d9207f6f92814dfb2689293dd64c2aa44d10a59e6bd59cef101b433', 'addr': 'bc1pa4g2qw6djgrld7fgzn0my6yjj0wkfs42gngs5k0xh4vuaugpksesyvpqv3'}, {'type': 0, 'spent': True, 'value': 705, 'spending_outpoints': [{'tx_index': 2003083845971288, 'n': 0}], 'n': 139, 'tx_index': 8852968409558727, 'script': '5120ed50a03b4d9207f6f92814dfb2689293dd64c2aa44d10a59e6bd59cef101b433', 'addr': 'bc1pa4g2qw6djgrld7fgzn0my6yjj0wkfs42gngs5k0xh4vuaugpksesyvpqv3'}, {'type': 0, 'spent': True, 'value': 718, 'spending_outpoints': [{'tx_index': 535555123410187, 'n': 0}], 'n': 140, 'tx_index': 8852968409558727, 'script': '5120ed50a03b4d9207f6f92814dfb2689293dd64c2aa44d10a59e6bd59cef101b433', 'addr': 'bc1pa4g2qw6djgrld7fgzn0my6yjj0wkfs42gngs5k0xh4vuaugpksesyvpqv3'}, {'type': 0, 'spent': True, 'value': 708, 'spending_outpoints': [{'tx_index': 183612313734386, 'n': 0}], 'n': 141, 'tx_index': 8852968409558727, 'script': '5120ed50a03b4d9207f6f92814dfb2689293dd64c2aa44d10a59e6bd59cef101b433', 'addr': 'bc1pa4g2qw6djgrld7fgzn0my6yjj0wkfs42gngs5k0xh4vuaugpksesyvpqv3'}, {'type': 0, 'spent': True, 'value': 706, 'spending_outpoints': [{'tx_index': 2097310436491746, 'n': 0}], 'n': 142, 'tx_index': 8852968409558727, 'script': '5120ed50a03b4d9207f6f92814dfb2689293dd64c2aa44d10a59e6bd59cef101b433', 'addr': 'bc1pa4g2qw6djgrld7fgzn0my6yjj0wkfs42gngs5k0xh4vuaugpksesyvpqv3'}, {'type': 0, 'spent': True, 'value': 705, 'spending_outpoints': [{'tx_index': 156803231606834, 'n': 0}], 'n': 143, 'tx_index': 8852968409558727, 'script': '5120ed50a03b4d9207f6f92814dfb2689293dd64c2aa44d10a59e6bd59cef101b433', 'addr': 'bc1pa4g2qw6djgrld7fgzn0my6yjj0wkfs42gngs5k0xh4vuaugpksesyvpqv3'}, {'type': 0, 'spent': True, 'value': 718, 'spending_outpoints': [{'tx_index': 8143665693740223, 'n': 0}], 'n': 144, 'tx_index': 8852968409558727, 'script': '5120ed50a03b4d9207f6f92814dfb2689293dd64c2aa44d10a59e6bd59cef101b433', 'addr': 'bc1pa4g2qw6djgrld7fgzn0my6yjj0wkfs42gngs5k0xh4vuaugpksesyvpqv3'}, {'type': 0, 'spent': True, 'value': 708, 'spending_outpoints': [{'tx_index': 4936174728116925, 'n': 0}], 'n': 145, 'tx_index': 8852968409558727, 'script': '5120ed50a03b4d9207f6f92814dfb2689293dd64c2aa44d10a59e6bd59cef101b433', 'addr': 'bc1pa4g2qw6djgrld7fgzn0my6yjj0wkfs42gngs5k0xh4vuaugpksesyvpqv3'}, {'type': 0, 'spent': True, 'value': 706, 'spending_outpoints': [{'tx_index': 6559030441917597, 'n': 0}], 'n': 146, 'tx_index': 8852968409558727, 'script': '5120ed50a03b4d9207f6f92814dfb2689293dd64c2aa44d10a59e6bd59cef101b433', 'addr': 'bc1pa4g2qw6djgrld7fgzn0my6yjj0wkfs42gngs5k0xh4vuaugpksesyvpqv3'}, {'type': 0, 'spent': True, 'value': 705, 'spending_outpoints': [{'tx_index': 76794607137558, 'n': 0}], 'n': 147, 'tx_index': 8852968409558727, 'script': '5120ed50a03b4d9207f6f92814dfb2689293dd64c2aa44d10a59e6bd59cef101b433', 'addr': 'bc1pa4g2qw6djgrld7fgzn0my6yjj0wkfs42gngs5k0xh4vuaugpksesyvpqv3'}, {'type': 0, 'spent': True, 'value': 718, 'spending_outpoints': [{'tx_index': 8509168944131595, 'n': 0}], 'n': 148, 'tx_index': 8852968409558727, 'script': '5120ed50a03b4d9207f6f92814dfb2689293dd64c2aa44d10a59e6bd59cef101b433', 'addr': 'bc1pa4g2qw6djgrld7fgzn0my6yjj0wkfs42gngs5k0xh4vuaugpksesyvpqv3'}, {'type': 0, 'spent': True, 'value': 708, 'spending_outpoints': [{'tx_index': 5258432371046544, 'n': 0}], 'n': 149, 'tx_index': 8852968409558727, 'script': '5120ed50a03b4d9207f6f92814dfb2689293dd64c2aa44d10a59e6bd59cef101b433', 'addr': 'bc1pa4g2qw6djgrld7fgzn0my6yjj0wkfs42gngs5k0xh4vuaugpksesyvpqv3'}, {'type': 0, 'spent': True, 'value': 706, 'spending_outpoints': [{'tx_index': 7417485022026892, 'n': 0}], 'n': 150, 'tx_index': 8852968409558727, 'script': '5120ed50a03b4d9207f6f92814dfb2689293dd64c2aa44d10a59e6bd59cef101b433', 'addr': 'bc1pa4g2qw6djgrld7fgzn0my6yjj0wkfs42gngs5k0xh4vuaugpksesyvpqv3'}, {'type': 0, 'spent': True, 'value': 705, 'spending_outpoints': [{'tx_index': 1078814618025966, 'n': 0}], 'n': 151, 'tx_index': 8852968409558727, 'script': '5120ed50a03b4d9207f6f92814dfb2689293dd64c2aa44d10a59e6bd59cef101b433', 'addr': 'bc1pa4g2qw6djgrld7fgzn0my6yjj0wkfs42gngs5k0xh4vuaugpksesyvpqv3'}, {'type': 0, 'spent': True, 'value': 718, 'spending_outpoints': [{'tx_index': 6032707537957746, 'n': 0}], 'n': 152, 'tx_index': 8852968409558727, 'script': '5120ed50a03b4d9207f6f92814dfb2689293dd64c2aa44d10a59e6bd59cef101b433', 'addr': 'bc1pa4g2qw6djgrld7fgzn0my6yjj0wkfs42gngs5k0xh4vuaugpksesyvpqv3'}, {'type': 0, 'spent': True, 'value': 708, 'spending_outpoints': [{'tx_index': 5863059820179649, 'n': 0}], 'n': 153, 'tx_index': 8852968409558727, 'script': '5120ed50a03b4d9207f6f92814dfb2689293dd64c2aa44d10a59e6bd59cef101b433', 'addr': 'bc1pa4g2qw6djgrld7fgzn0my6yjj0wkfs42gngs5k0xh4vuaugpksesyvpqv3'}, {'type': 0, 'spent': True, 'value': 706, 'spending_outpoints': [{'tx_index': 5078955248720333, 'n': 0}], 'n': 154, 'tx_index': 8852968409558727, 'script': '5120ed50a03b4d9207f6f92814dfb2689293dd64c2aa44d10a59e6bd59cef101b433', 'addr': 'bc1pa4g2qw6djgrld7fgzn0my6yjj0wkfs42gngs5k0xh4vuaugpksesyvpqv3'}, {'type': 0, 'spent': True, 'value': 705, 'spending_outpoints': [{'tx_index': 5393615716230683, 'n': 0}], 'n': 155, 'tx_index': 8852968409558727, 'script': '5120ed50a03b4d9207f6f92814dfb2689293dd64c2aa44d10a59e6bd59cef101b433', 'addr': 'bc1pa4g2qw6djgrld7fgzn0my6yjj0wkfs42gngs5k0xh4vuaugpksesyvpqv3'}, {'type': 0, 'spent': True, 'value': 718, 'spending_outpoints': [{'tx_index': 2514025893778923, 'n': 0}], 'n': 156, 'tx_index': 8852968409558727, 'script': '5120ed50a03b4d9207f6f92814dfb2689293dd64c2aa44d10a59e6bd59cef101b433', 'addr': 'bc1pa4g2qw6djgrld7fgzn0my6yjj0wkfs42gngs5k0xh4vuaugpksesyvpqv3'}, {'type': 0, 'spent': True, 'value': 708, 'spending_outpoints': [{'tx_index': 4727855194802368, 'n': 0}], 'n': 157, 'tx_index': 8852968409558727, 'script': '5120ed50a03b4d9207f6f92814dfb2689293dd64c2aa44d10a59e6bd59cef101b433', 'addr': 'bc1pa4g2qw6djgrld7fgzn0my6yjj0wkfs42gngs5k0xh4vuaugpksesyvpqv3'}, {'type': 0, 'spent': True, 'value': 706, 'spending_outpoints': [{'tx_index': 775463779970753, 'n': 0}], 'n': 158, 'tx_index': 8852968409558727, 'script': '5120ed50a03b4d9207f6f92814dfb2689293dd64c2aa44d10a59e6bd59cef101b433', 'addr': 'bc1pa4g2qw6djgrld7fgzn0my6yjj0wkfs42gngs5k0xh4vuaugpksesyvpqv3'}, {'type': 0, 'spent': True, 'value': 705, 'spending_outpoints': [{'tx_index': 4772706181685400, 'n': 0}], 'n': 159, 'tx_index': 8852968409558727, 'script': '5120ed50a03b4d9207f6f92814dfb2689293dd64c2aa44d10a59e6bd59cef101b433', 'addr': 'bc1pa4g2qw6djgrld7fgzn0my6yjj0wkfs42gngs5k0xh4vuaugpksesyvpqv3'}, {'type': 0, 'spent': True, 'value': 718, 'spending_outpoints': [{'tx_index': 2779820510058528, 'n': 0}], 'n': 160, 'tx_index': 8852968409558727, 'script': '5120ed50a03b4d9207f6f92814dfb2689293dd64c2aa44d10a59e6bd59cef101b433', 'addr': 'bc1pa4g2qw6djgrld7fgzn0my6yjj0wkfs42gngs5k0xh4vuaugpksesyvpqv3'}, {'type': 0, 'spent': True, 'value': 708, 'spending_outpoints': [{'tx_index': 2657365987863548, 'n': 0}], 'n': 161, 'tx_index': 8852968409558727, 'script': '5120ed50a03b4d9207f6f92814dfb2689293dd64c2aa44d10a59e6bd59cef101b433', 'addr': 'bc1pa4g2qw6djgrld7fgzn0my6yjj0wkfs42gngs5k0xh4vuaugpksesyvpqv3'}, {'type': 0, 'spent': True, 'value': 706, 'spending_outpoints': [{'tx_index': 126919799084443, 'n': 0}], 'n': 162, 'tx_index': 8852968409558727, 'script': '5120ed50a03b4d9207f6f92814dfb2689293dd64c2aa44d10a59e6bd59cef101b433', 'addr': 'bc1pa4g2qw6djgrld7fgzn0my6yjj0wkfs42gngs5k0xh4vuaugpksesyvpqv3'}, {'type': 0, 'spent': True, 'value': 705, 'spending_outpoints': [{'tx_index': 1261413740460716, 'n': 0}], 'n': 163, 'tx_index': 8852968409558727, 'script': '5120ed50a03b4d9207f6f92814dfb2689293dd64c2aa44d10a59e6bd59cef101b433', 'addr': 'bc1pa4g2qw6djgrld7fgzn0my6yjj0wkfs42gngs5k0xh4vuaugpksesyvpqv3'}, {'type': 0, 'spent': True, 'value': 718, 'spending_outpoints': [{'tx_index': 1398030345679100, 'n': 0}], 'n': 164, 'tx_index': 8852968409558727, 'script': '5120ed50a03b4d9207f6f92814dfb2689293dd64c2aa44d10a59e6bd59cef101b433', 'addr': 'bc1pa4g2qw6djgrld7fgzn0my6yjj0wkfs42gngs5k0xh4vuaugpksesyvpqv3'}, {'type': 0, 'spent': True, 'value': 708, 'spending_outpoints': [{'tx_index': 3697620433943964, 'n': 0}], 'n': 165, 'tx_index': 8852968409558727, 'script': '5120ed50a03b4d9207f6f92814dfb2689293dd64c2aa44d10a59e6bd59cef101b433', 'addr': 'bc1pa4g2qw6djgrld7fgzn0my6yjj0wkfs42gngs5k0xh4vuaugpksesyvpqv3'}, {'type': 0, 'spent': True, 'value': 706, 'spending_outpoints': [{'tx_index': 6612727990387031, 'n': 0}], 'n': 166, 'tx_index': 8852968409558727, 'script': '5120ed50a03b4d9207f6f92814dfb2689293dd64c2aa44d10a59e6bd59cef101b433', 'addr': 'bc1pa4g2qw6djgrld7fgzn0my6yjj0wkfs42gngs5k0xh4vuaugpksesyvpqv3'}, {'type': 0, 'spent': True, 'value': 705, 'spending_outpoints': [{'tx_index': 8517030520326448, 'n': 0}], 'n': 167, 'tx_index': 8852968409558727, 'script': '5120ed50a03b4d9207f6f92814dfb2689293dd64c2aa44d10a59e6bd59cef101b433', 'addr': 'bc1pa4g2qw6djgrld7fgzn0my6yjj0wkfs42gngs5k0xh4vuaugpksesyvpqv3'}, {'type': 0, 'spent': True, 'value': 718, 'spending_outpoints': [{'tx_index': 2582867949729399, 'n': 0}], 'n': 168, 'tx_index': 8852968409558727, 'script': '5120ed50a03b4d9207f6f92814dfb2689293dd64c2aa44d10a59e6bd59cef101b433', 'addr': 'bc1pa4g2qw6djgrld7fgzn0my6yjj0wkfs42gngs5k0xh4vuaugpksesyvpqv3'}, {'type': 0, 'spent': True, 'value': 705, 'spending_outpoints': [{'tx_index': 6874809028240707, 'n': 0}], 'n': 169, 'tx_index': 8852968409558727, 'script': '5120ed50a03b4d9207f6f92814dfb2689293dd64c2aa44d10a59e6bd59cef101b433', 'addr': 'bc1pa4g2qw6djgrld7fgzn0my6yjj0wkfs42gngs5k0xh4vuaugpksesyvpqv3'}, {'type': 0, 'spent': True, 'value': 718, 'spending_outpoints': [{'tx_index': 6404614931465614, 'n': 0}], 'n': 170, 'tx_index': 8852968409558727, 'script': '5120ed50a03b4d9207f6f92814dfb2689293dd64c2aa44d10a59e6bd59cef101b433', 'addr': 'bc1pa4g2qw6djgrld7fgzn0my6yjj0wkfs42gngs5k0xh4vuaugpksesyvpqv3'}, {'type': 0, 'spent': True, 'value': 708, 'spending_outpoints': [{'tx_index': 1805481673979439, 'n': 0}], 'n': 171, 'tx_index': 8852968409558727, 'script': '5120ed50a03b4d9207f6f92814dfb2689293dd64c2aa44d10a59e6bd59cef101b433', 'addr': 'bc1pa4g2qw6djgrld7fgzn0my6yjj0wkfs42gngs5k0xh4vuaugpksesyvpqv3'}, {'type': 0, 'spent': True, 'value': 705, 'spending_outpoints': [{'tx_index': 9004447239198417, 'n': 0}], 'n': 172, 'tx_index': 8852968409558727, 'script': '5120ed50a03b4d9207f6f92814dfb2689293dd64c2aa44d10a59e6bd59cef101b433', 'addr': 'bc1pa4g2qw6djgrld7fgzn0my6yjj0wkfs42gngs5k0xh4vuaugpksesyvpqv3'}, {'type': 0, 'spent': True, 'value': 705, 'spending_outpoints': [{'tx_index': 5343102574487763, 'n': 0}], 'n': 173, 'tx_index': 8852968409558727, 'script': '5120ed50a03b4d9207f6f92814dfb2689293dd64c2aa44d10a59e6bd59cef101b433', 'addr': 'bc1pa4g2qw6djgrld7fgzn0my6yjj0wkfs42gngs5k0xh4vuaugpksesyvpqv3'}, {'type': 0, 'spent': True, 'value': 718, 'spending_outpoints': [{'tx_index': 3716896093448478, 'n': 0}], 'n': 174, 'tx_index': 8852968409558727, 'script': '5120ed50a03b4d9207f6f92814dfb2689293dd64c2aa44d10a59e6bd59cef101b433', 'addr': 'bc1pa4g2qw6djgrld7fgzn0my6yjj0wkfs42gngs5k0xh4vuaugpksesyvpqv3'}, {'type': 0, 'spent': True, 'value': 718, 'spending_outpoints': [{'tx_index': 8982486373470211, 'n': 0}], 'n': 175, 'tx_index': 8852968409558727, 'script': '5120ed50a03b4d9207f6f92814dfb2689293dd64c2aa44d10a59e6bd59cef101b433', 'addr': 'bc1pa4g2qw6djgrld7fgzn0my6yjj0wkfs42gngs5k0xh4vuaugpksesyvpqv3'}, {'type': 0, 'spent': True, 'value': 705, 'spending_outpoints': [{'tx_index': 8823328696691841, 'n': 0}], 'n': 176, 'tx_index': 8852968409558727, 'script': '5120ed50a03b4d9207f6f92814dfb2689293dd64c2aa44d10a59e6bd59cef101b433', 'addr': 'bc1pa4g2qw6djgrld7fgzn0my6yjj0wkfs42gngs5k0xh4vuaugpksesyvpqv3'}, {'type': 0, 'spent': True, 'value': 705, 'spending_outpoints': [{'tx_index': 8486060190352880, 'n': 0}], 'n': 177, 'tx_index': 8852968409558727, 'script': '5120ed50a03b4d9207f6f92814dfb2689293dd64c2aa44d10a59e6bd59cef101b433', 'addr': 'bc1pa4g2qw6djgrld7fgzn0my6yjj0wkfs42gngs5k0xh4vuaugpksesyvpqv3'}, {'type': 0, 'spent': True, 'value': 718, 'spending_outpoints': [{'tx_index': 2979217443083746, 'n': 0}], 'n': 178, 'tx_index': 8852968409558727, 'script': '5120ed50a03b4d9207f6f92814dfb2689293dd64c2aa44d10a59e6bd59cef101b433', 'addr': 'bc1pa4g2qw6djgrld7fgzn0my6yjj0wkfs42gngs5k0xh4vuaugpksesyvpqv3'}, {'type': 0, 'spent': True, 'value': 718, 'spending_outpoints': [{'tx_index': 6665468137383404, 'n': 0}], 'n': 179, 'tx_index': 8852968409558727, 'script': '5120ed50a03b4d9207f6f92814dfb2689293dd64c2aa44d10a59e6bd59cef101b433', 'addr': 'bc1pa4g2qw6djgrld7fgzn0my6yjj0wkfs42gngs5k0xh4vuaugpksesyvpqv3'}, {'type': 0, 'spent': False, 'value': 4999, 'spending_outpoints': [], 'n': 180, 'tx_index': 8852968409558727, 'script': '001470e7169bdbe863bbfa3b87fc0943c6059d445e8a', 'addr': 'bc1qwrn3dx7map3mh73msl7qjs7xqkw5gh52k0am7q'}]",546,1000000590583
a4ff68bac5fab55b3ec81a1782634d85ba2d79b1a928196d82393113c473cc51,2,1,76,3529,13423,3714,0.0.0.0,0,2878033837057575,False,1744359039,891894,891894,"[{'sequence': 4294967293, 'witness': '0340da905f710af0239b4430bae563edc9b8fd954bebfbba70470d3b8576d2d59293986b0e9e3621313b167f56ab586f455d09485b775f9f3bd703a9022213ff3a0380203e85717da98e2c3de68f96759a554341de4c82a89f4c5431404cdc13f7a126c2ac0063036f7264010118746578742f706c61696e3b636861727365743d7574662d38003a7b2270223a226272632d3230222c226f70223a226d696e74222c227469636b223a22f09386a1222c22616d74223a22382e38383838383838227d6821c03e85717da98e2c3de68f96759a554341de4c82a89f4c5431404cdc13f7a126c2', 'script': '', 'index': 0, 'prev_out': {'type': 0, 'spent': True, 'value': 61644, 'spending_outpoints': [{'tx_index': 2878033837057575, 'n': 0}], 'n': 0, 'tx_index': 4003717945337684, 'script': '51208035c74a0fd98ece97bf2cb1c19ff4e2419710bef1b5a7e853e41a55fad9c7b0', 'addr': 'bc1psq6uwjs0mx8va9al9jcur8l5ufqewy977x6606znusd9t7kec7cqfalral'}}]","[{'type': 0, 'spent': False, 'value': 546, 'spending_outpoints': [], 'n': 0, 'tx_index': 2878033837057575, 'script': '76a91487ccbdb1aba7e6875f750c0823bd63bf972a2fa988ac', 'addr': '1DP3VYwN6ozHXDDaETbvNFLd86CAXfaewi'}, {'type': 0, 'spent': True, 'value': 707, 'spending_outpoints': [{'tx_index': 1119194732770729, 'n': 0}], 'n': 1, 'tx_index': 2878033837057575, 'script': '51208035c74a0fd98ece97bf2cb1c19ff4e2419710bef1b5a7e853e41a55fad9c7b0', 'addr': 'bc1psq6uwjs0mx8va9al9jcur8l5ufqewy977x6606znusd9t7kec7cqfalral'}, {'type': 0, 'spent': True, 'value': 707, 'spending_outpoints': [{'tx_index': 7225771524856391, 'n': 0}], 'n': 2, 'tx_index': 2878033837057575, 'script': '51208035c74a0fd98ece97bf2cb1c19ff4e2419710bef1b5a7e853e41a55fad9c7b0', 'addr': 'bc1psq6uwjs0mx8va9al9jcur8l5ufqewy977x6606znusd9t7kec7cqfalral'}, {'type': 0, 'spent': True, 'value': 707, 'spending_outpoints': [{'tx_index': 1905078994936370, 'n': 0}], 'n': 3, 'tx_index': 2878033837057575, 'script': '51208035c74a0fd98ece97bf2cb1c19ff4e2419710bef1b5a7e853e41a55fad9c7b0', 'addr': 'bc1psq6uwjs0mx8va9al9jcur8l5ufqewy977x6606znusd9t7kec7cqfalral'}, {'type': 0, 'spent': True, 'value': 707, 'spending_outpoints': [{'tx_index': 6131643699434630, 'n': 0}], 'n': 4, 'tx_index': 2878033837057575, 'script': '51208035c74a0fd98ece97bf2cb1c19ff4e2419710bef1b5a7e853e41a55fad9c7b0', 'addr': 'bc1psq6uwjs0mx8va9al9jcur8l5ufqewy977x6606znusd9t7kec7cqfalral'}, {'type': 0, 'spent': True, 'value': 707, 'spending_outpoints': [{'tx_index': 2925069162655031, 'n': 0}], 'n': 5, 'tx_index': 2878033837057575, 'script': '51208035c74a0fd98ece97bf2cb1c19ff4e2419710bef1b5a7e853e41a55fad9c7b0', 'addr': 'bc1psq6uwjs0mx8va9al9jcur8l5ufqewy977x6606znusd9t7kec7cqfalral'}, {'type': 0, 'spent': True, 'value': 705, 'spending_outpoints': [{'tx_index': 1757758030163886, 'n': 0}], 'n': 6, 'tx_index': 2878033837057575, 'script': '51208035c74a0fd98ece97bf2cb1c19ff4e2419710bef1b5a7e853e41a55fad9c7b0', 'addr': 'bc1psq6uwjs0mx8va9al9jcur8l5ufqewy977x6606znusd9t7kec7cqfalral'}, {'type': 0, 'spent': True, 'value': 705, 'spending_outpoints': [{'tx_index': 158224168129334, 'n': 0}], 'n': 7, 'tx_index': 2878033837057575, 'script': '51208035c74a0fd98ece97bf2cb1c19ff4e2419710bef1b5a7e853e41a55fad9c7b0', 'addr': 'bc1psq6uwjs0mx8va9al9jcur8l5ufqewy977x6606znusd9t7kec7cqfalral'}, {'type': 0, 'spent': True, 'value': 704, 'spending_outpoints': [{'tx_index': 7465178907698542, 'n': 0}], 'n': 8, 'tx_index': 2878033837057575, 'script': '51208035c74a0fd98ece97bf2cb1c19ff4e2419710bef1b5a7e853e41a55fad9c7b0', 'addr': 'bc1psq6uwjs0mx8va9al9jcur8l5ufqewy977x6606znusd9t7kec7cqfalral'}, {'type': 0, 'spent': True, 'value': 704, 'spending_outpoints': [{'tx_index': 4623420944621567, 'n': 0}], 'n': 9, 'tx_index': 2878033837057575, 'script': '51208035c74a0fd98ece97bf2cb1c19ff4e2419710bef1b5a7e853e41a55fad9c7b0', 'addr': 'bc1psq6uwjs0mx8va9al9jcur8l5ufqewy977x6606znusd9t7kec7cqfalral'}, {'type': 0, 'spent': True, 'value': 704, 'spending_outpoints': [{'tx_index': 5501592823575470, 'n': 0}], 'n': 10, 'tx_index': 2878033837057575, 'script': '51208035c74a0fd98ece97bf2cb1c19ff4e2419710bef1b5a7e853e41a55fad9c7b0', 'addr': 'bc1psq6uwjs0mx8va9al9jcur8l5ufqewy977x6606znusd9t7kec7cqfalral'}, {'type': 0, 'spent': True, 'value': 704, 'spending_outpoints': [{'tx_index': 4560961533341505, 'n': 0}], 'n': 11, 'tx_index': 2878033837057575, 'script': '51208035c74a0fd98ece97bf2cb1c19ff4e2419710bef1b5a7e853e41a55fad9c7b0', 'addr': 'bc1psq6uwjs0mx8va9al9jcur8l5ufqewy977x6606znusd9t7kec7cqfalral'}, {'type': 0, 'spent': True, 'value': 717, 'spending_outpoints': [{'tx_index': 1460840930321359, 'n': 0}], 'n': 12, 'tx_index': 2878033837057575, 'script': '51208035c74a0fd98ece97bf2cb1c19ff4e2419710bef1b5a7e853e41a55fad9c7b0', 'addr': 'bc1psq6uwjs0mx8va9al9jcur8l5ufqewy977x6606znusd9t7kec7cqfalral'}, {'type': 0, 'spent': True, 'value': 717, 'spending_outpoints': [{'tx_index': 1050808542974931, 'n': 0}], 'n': 13, 'tx_index': 2878033837057575, 'script': '51208035c74a0fd98ece97bf2cb1c19ff4e2419710bef1b5a7e853e41a55fad9c7b0', 'addr': 'bc1psq6uwjs0mx8va9al9jcur8l5ufqewy977x6606znusd9t7kec7cqfalral'}, {'type': 0, 'spent': True, 'value': 704, 'spending_outpoints': [{'tx_index': 6225349095796063, 'n': 0}], 'n': 14, 'tx_index': 2878033837057575, 'script': '51208035c74a0fd98ece97bf2cb1c19ff4e2419710bef1b5a7e853e41a55fad9c7b0', 'addr': 'bc1psq6uwjs0mx8va9al9jcur8l5ufqewy977x6606znusd9t7kec7cqfalral'}, {'type': 0, 'spent': True, 'value': 717, 'spending_outpoints': [{'tx_index': 6181900271012479, 'n': 0}], 'n': 15, 'tx_index': 2878033837057575, 'script': '51208035c74a0fd98ece97bf2cb1c19ff4e2419710bef1b5a7e853e41a55fad9c7b0', 'addr': 'bc1psq6uwjs0mx8va9al9jcur8l5ufqewy977x6606znusd9t7kec7cqfalral'}, {'type': 0, 'spent': True, 'value': 717, 'spending_outpoints': [{'tx_index': 6758658378741320, 'n': 0}], 'n': 16, 'tx_index': 2878033837057575, 'script': '51208035c74a0fd98ece97bf2cb1c19ff4e2419710bef1b5a7e853e41a55fad9c7b0', 'addr': 'bc1psq6uwjs0mx8va9al9jcur8l5ufqewy977x6606znusd9t7kec7cqfalral'}, {'type': 0, 'spent': True, 'value': 704, 'spending_outpoints': [{'tx_index': 920681527075331, 'n': 0}], 'n': 17, 'tx_index': 2878033837057575, 'script': '51208035c74a0fd98ece97bf2cb1c19ff4e2419710bef1b5a7e853e41a55fad9c7b0', 'addr': 'bc1psq6uwjs0mx8va9al9jcur8l5ufqewy977x6606znusd9t7kec7cqfalral'}, {'type': 0, 'spent': True, 'value': 705, 'spending_outpoints': [{'tx_index': 1848158769016900, 'n': 0}], 'n': 18, 'tx_index': 2878033837057575, 'script': '51208035c74a0fd98ece97bf2cb1c19ff4e2419710bef1b5a7e853e41a55fad9c7b0', 'addr': 'bc1psq6uwjs0mx8va9al9jcur8l5ufqewy977x6606znusd9t7kec7cqfalral'}, {'type': 0, 'spent': True, 'value': 717, 'spending_outpoints': [{'tx_index': 3965572949967476, 'n': 0}], 'n': 19, 'tx_index': 2878033837057575, 'script': '51208035c74a0fd98ece97bf2cb1c19ff4e2419710bef1b5a7e853e41a55fad9c7b0', 'addr': 'bc1psq6uwjs0mx8va9al9jcur8l5ufqewy977x6606znusd9t7kec7cqfalral'}, {'type': 0, 'spent': True, 'value': 704, 'spending_outpoints': [{'tx_index': 6042245098798882, 'n': 0}], 'n': 20, 'tx_index': 2878033837057575, 'script': '51208035c74a0fd98ece97bf2cb1c19ff4e2419710bef1b5a7e853e41a55fad9c7b0', 'addr': 'bc1psq6uwjs0mx8va9al9jcur8l5ufqewy977x6606znusd9t7kec7cqfalral'}, {'type': 0, 'spent': True, 'value': 705, 'spending_outpoints': [{'tx_index': 1160931094824829, 'n': 0}], 'n': 21, 'tx_index': 2878033837057575, 'script': '51208035c74a0fd98ece97bf2cb1c19ff4e2419710bef1b5a7e853e41a55fad9c7b0', 'addr': 'bc1psq6uwjs0mx8va9al9jcur8l5ufqewy977x6606znusd9t7kec7cqfalral'}, {'type': 0, 'spent': True, 'value': 707, 'spending_outpoints': [{'tx_index': 287453645227217, 'n': 0}], 'n': 22, 'tx_index': 2878033837057575, 'script': '51208035c74a0fd98ece97bf2cb1c19ff4e2419710bef1b5a7e853e41a55fad9c7b0', 'addr': 'bc1psq6uwjs0mx8va9al9jcur8l5ufqewy977x6606znusd9t7kec7cqfalral'}, {'type': 0, 'spent': True, 'value': 717, 'spending_outpoints': [{'tx_index': 4014216152657216, 'n': 0}], 'n': 23, 'tx_index': 2878033837057575, 'script': '51208035c74a0fd98ece97bf2cb1c19ff4e2419710bef1b5a7e853e41a55fad9c7b0', 'addr': 'bc1psq6uwjs0mx8va9al9jcur8l5ufqewy977x6606znusd9t7kec7cqfalral'}, {'type': 0, 'spent': True, 'value': 704, 'spending_outpoints': [{'tx_index': 8600881282592727, 'n': 0}], 'n': 24, 'tx_index': 2878033837057575, 'script': '51208035c74a0fd98ece97bf2cb1c19ff4e2419710bef1b5a7e853e41a55fad9c7b0', 'addr': 'bc1psq6uwjs0mx8va9al9jcur8l5ufqewy977x6606znusd9t7kec7cqfalral'}, {'type': 0, 'spent': True, 'value': 705, 'spending_outpoints': [{'tx_index': 6656029542168699, 'n': 0}], 'n': 25, 'tx_index': 2878033837057575, 'script': '51208035c74a0fd98ece97bf2cb1c19ff4e2419710bef1b5a7e853e41a55fad9c7b0', 'addr': 'bc1psq6uwjs0mx8va9al9jcur8l5ufqewy977x6606znusd9t7kec7cqfalral'}, {'type': 0, 'spent': True, 'value': 707, 'spending_outpoints': [{'tx_index': 6123778909973281, 'n': 0}], 'n': 26, 'tx_index': 2878033837057575, 'script': '51208035c74a0fd98ece97bf2cb1c19ff4e2419710bef1b5a7e853e41a55fad9c7b0', 'addr': 'bc1psq6uwjs0mx8va9al9jcur8l5ufqewy977x6606znusd9t7kec7cqfalral'}, {'type': 0, 'spent': True, 'value': 717, 'spending_outpoints': [{'tx_index': 4012425566436685, 'n': 0}], 'n': 27, 'tx_index': 2878033837057575, 'script': '51208035c74a0fd98ece97bf2cb1c19ff4e2419710bef1b5a7e853e41a55fad9c7b0', 'addr': 'bc1psq6uwjs0mx8va9al9jcur8l5ufqewy977x6606znusd9t7kec7cqfalral'}, {'type': 0, 'spent': True, 'value': 704, 'spending_outpoints': [{'tx_index': 2187322186677986, 'n': 0}], 'n': 28, 'tx_index': 2878033837057575, 'script': '51208035c74a0fd98ece97bf2cb1c19ff4e2419710bef1b5a7e853e41a55fad9c7b0', 'addr': 'bc1psq6uwjs0mx8va9al9jcur8l5ufqewy977x6606znusd9t7kec7cqfalral'}, {'type': 0, 'spent': True, 'value': 705, 'spending_outpoints': [{'tx_index': 467408210337002, 'n': 0}], 'n': 29, 'tx_index': 2878033837057575, 'script': '51208035c74a0fd98ece97bf2cb1c19ff4e2419710bef1b5a7e853e41a55fad9c7b0', 'addr': 'bc1psq6uwjs0mx8va9al9jcur8l5ufqewy977x6606znusd9t7kec7cqfalral'}, {'type': 0, 'spent': True, 'value': 717, 'spending_outpoints': [{'tx_index': 3929899908664228, 'n': 0}], 'n': 30, 'tx_index': 2878033837057575, 'script': '51208035c74a0fd98ece97bf2cb1c19ff4e2419710bef1b5a7e853e41a55fad9c7b0', 'addr': 'bc1psq6uwjs0mx8va9al9jcur8l5ufqewy977x6606znusd9t7kec7cqfalral'}, {'type': 0, 'spent': True, 'value': 704, 'spending_outpoints': [{'tx_index': 4731661523215716, 'n': 0}], 'n': 31, 'tx_index': 2878033837057575, 'script': '51208035c74a0fd98ece97bf2cb1c19ff4e2419710bef1b5a7e853e41a55fad9c7b0', 'addr': 'bc1psq6uwjs0mx8va9al9jcur8l5ufqewy977x6606znusd9t7kec7cqfalral'}, {'type': 0, 'spent': True, 'value': 717, 'spending_outpoints': [{'tx_index': 2675007895010079, 'n': 0}], 'n': 32, 'tx_index': 2878033837057575, 'script': '51208035c74a0fd98ece97bf2cb1c19ff4e2419710bef1b5a7e853e41a55fad9c7b0', 'addr': 'bc1psq6uwjs0mx8va9al9jcur8l5ufqewy977x6606znusd9t7kec7cqfalral'}, {'type': 0, 'spent': True, 'value': 704, 'spending_outpoints': [{'tx_index': 856029612518416, 'n': 0}], 'n': 33, 'tx_index': 2878033837057575, 'script': '51208035c74a0fd98ece97bf2cb1c19ff4e2419710bef1b5a7e853e41a55fad9c7b0', 'addr': 'bc1psq6uwjs0mx8va9al9jcur8l5ufqewy977x6606znusd9t7kec7cqfalral'}, {'type': 0, 'spent': True, 'value': 705, 'spending_outpoints': [{'tx_index': 6871197558495811, 'n': 0}], 'n': 34, 'tx_index': 2878033837057575, 'script': '51208035c74a0fd98ece97bf2cb1c19ff4e2419710bef1b5a7e853e41a55fad9c7b0', 'addr': 'bc1psq6uwjs0mx8va9al9jcur8l5ufqewy977x6606znusd9t7kec7cqfalral'}, {'type': 0, 'spent': True, 'value': 707, 'spending_outpoints': [{'tx_index': 446765003678737, 'n': 0}], 'n': 35, 'tx_index': 2878033837057575, 'script': '51208035c74a0fd98ece97bf2cb1c19ff4e2419710bef1b5a7e853e41a55fad9c7b0', 'addr': 'bc1psq6uwjs0mx8va9al9jcur8l5ufqewy977x6606znusd9t7kec7cqfalral'}, {'type': 0, 'spent': True, 'value': 704, 'spending_outpoints': [{'tx_index': 599142838361732, 'n': 0}], 'n': 36, 'tx_index': 2878033837057575, 'script': '51208035c74a0fd98ece97bf2cb1c19ff4e2419710bef1b5a7e853e41a55fad9c7b0', 'addr': 'bc1psq6uwjs0mx8va9al9jcur8l5ufqewy977x6606znusd9t7kec7cqfalral'}, {'type': 0, 'spent': True, 'value': 717, 'spending_outpoints': [{'tx_index': 2408442017050567, 'n': 0}], 'n': 37, 'tx_index': 2878033837057575, 'script': '51208035c74a0fd98ece97bf2cb1c19ff4e2419710bef1b5a7e853e41a55fad9c7b0', 'addr': 'bc1psq6uwjs0mx8va9al9jcur8l5ufqewy977x6606znusd9t7kec7cqfalral'}, {'type': 0, 'spent': True, 'value': 705, 'spending_outpoints': [{'tx_index': 4465274612608363, 'n': 0}], 'n': 38, 'tx_index': 2878033837057575, 'script': '51208035c74a0fd98ece97bf2cb1c19ff4e2419710bef1b5a7e853e41a55fad9c7b0', 'addr': 'bc1psq6uwjs0mx8va9al9jcur8l5ufqewy977x6606znusd9t7kec7cqfalral'}, {'type': 0, 'spent': True, 'value': 704, 'spending_outpoints': [{'tx_index': 4765135029474690, 'n': 0}], 'n': 39, 'tx_index': 2878033837057575, 'script': '51208035c74a0fd98ece97bf2cb1c19ff4e2419710bef1b5a7e853e41a55fad9c7b0', 'addr': 'bc1psq6uwjs0mx8va9al9jcur8l5ufqewy977x6606znusd9t7kec7cqfalral'}, {'type': 0, 'spent': True, 'value': 705, 'spending_outpoints': [{'tx_index': 798633865909236, 'n': 0}], 'n': 40, 'tx_index': 2878033837057575, 'script': '51208035c74a0fd98ece97bf2cb1c19ff4e2419710bef1b5a7e853e41a55fad9c7b0', 'addr': 'bc1psq6uwjs0mx8va9al9jcur8l5ufqewy977x6606znusd9t7kec7cqfalral'}, {'type': 0, 'spent': True, 'value': 705, 'spending_outpoints': [{'tx_index': 8321827162339236, 'n': 0}], 'n': 41, 'tx_index': 2878033837057575, 'script': '51208035c74a0fd98ece97bf2cb1c19ff4e2419710bef1b5a7e853e41a55fad9c7b0', 'addr': 'bc1psq6uwjs0mx8va9al9jcur8l5ufqewy977x6606znusd9t7kec7cqfalral'}, {'type': 0, 'spent': True, 'value': 705, 'spending_outpoints': [{'tx_index': 7117033706222728, 'n': 0}], 'n': 42, 'tx_index': 2878033837057575, 'script': '51208035c74a0fd98ece97bf2cb1c19ff4e2419710bef1b5a7e853e41a55fad9c7b0', 'addr': 'bc1psq6uwjs0mx8va9al9jcur8l5ufqewy977x6606znusd9t7kec7cqfalral'}, {'type': 0, 'spent': True, 'value': 705, 'spending_outpoints': [{'tx_index': 2173397596642923, 'n': 0}], 'n': 43, 'tx_index': 2878033837057575, 'script': '51208035c74a0fd98ece97bf2cb1c19ff4e2419710bef1b5a7e853e41a55fad9c7b0', 'addr': 'bc1psq6uwjs0mx8va9al9jcur8l5ufqewy977x6606znusd9t7kec7cqfalral'}, {'type': 0, 'spent': True, 'value': 704, 'spending_outpoints': [{'tx_index': 2622817992732637, 'n': 0}], 'n': 44, 'tx_index': 2878033837057575, 'script': '51208035c74a0fd98ece97bf2cb1c19ff4e2419710bef1b5a7e853e41a55fad9c7b0', 'addr': 'bc1psq6uwjs0mx8va9al9jcur8l5ufqewy977x6606znusd9t7kec7cqfalral'}, {'type': 0, 'spent': True, 'value': 705, 'spending_outpoints': [{'tx_index': 1929343223322568, 'n': 0}], 'n': 45, 'tx_index': 2878033837057575, 'script': '51208035c74a0fd98ece97bf2cb1c19ff4e2419710bef1b5a7e853e41a55fad9c7b0', 'addr': 'bc1psq6uwjs0mx8va9al9jcur8l5ufqewy977x6606znusd9t7kec7cqfalral'}, {'type': 0, 'spent': True, 'value': 717, 'spending_outpoints': [{'tx_index': 733721267915789, 'n': 0}], 'n': 46, 'tx_index': 2878033837057575, 'script': '51208035c74a0fd98ece97bf2cb1c19ff4e2419710bef1b5a7e853e41a55fad9c7b0', 'addr': 'bc1psq6uwjs0mx8va9al9jcur8l5ufqewy977x6606znusd9t7kec7cqfalral'}, {'type': 0, 'spent': True, 'value': 705, 'spending_outpoints': [{'tx_index': 3551469350672813, 'n': 0}], 'n': 47, 'tx_index': 2878033837057575, 'script': '51208035c74a0fd98ece97bf2cb1c19ff4e2419710bef1b5a7e853e41a55fad9c7b0', 'addr': 'bc1psq6uwjs0mx8va9al9jcur8l5ufqewy977x6606znusd9t7kec7cqfalral'}, {'type': 0, 'spent': True, 'value': 704, 'spending_outpoints': [{'tx_index': 2644710965308731, 'n': 0}], 'n': 48, 'tx_index': 2878033837057575, 'script': '51208035c74a0fd98ece97bf2cb1c19ff4e2419710bef1b5a7e853e41a55fad9c7b0', 'addr': 'bc1psq6uwjs0mx8va9al9jcur8l5ufqewy977x6606znusd9t7kec7cqfalral'}, {'type': 0, 'spent': True, 'value': 717, 'spending_outpoints': [{'tx_index': 3788287973180473, 'n': 0}], 'n': 49, 'tx_index': 2878033837057575, 'script': '51208035c74a0fd98ece97bf2cb1c19ff4e2419710bef1b5a7e853e41a55fad9c7b0', 'addr': 'bc1psq6uwjs0mx8va9al9jcur8l5ufqewy977x6606znusd9t7kec7cqfalral'}, {'type': 0, 'spent': True, 'value': 705, 'spending_outpoints': [{'tx_index': 533919135528765, 'n': 0}], 'n': 50, 'tx_index': 2878033837057575, 'script': '51208035c74a0fd98ece97bf2cb1c19ff4e2419710bef1b5a7e853e41a55fad9c7b0', 'addr': 'bc1psq6uwjs0mx8va9al9jcur8l5ufqewy977x6606znusd9t7kec7cqfalral'}, {'type': 0, 'spent': True, 'value': 717, 'spending_outpoints': [{'tx_index': 2189309469437581, 'n': 0}], 'n': 51, 'tx_index': 2878033837057575, 'script': '51208035c74a0fd98ece97bf2cb1c19ff4e2419710bef1b5a7e853e41a55fad9c7b0', 'addr': 'bc1psq6uwjs0mx8va9al9jcur8l5ufqewy977x6606znusd9t7kec7cqfalral'}, {'type': 0, 'spent': True, 'value': 704, 'spending_outpoints': [{'tx_index': 6352706951610907, 'n': 0}], 'n': 52, 'tx_index': 2878033837057575, 'script': '51208035c74a0fd98ece97bf2cb1c19ff4e2419710bef1b5a7e853e41a55fad9c7b0', 'addr': 'bc1psq6uwjs0mx8va9al9jcur8l5ufqewy977x6606znusd9t7kec7cqfalral'}, {'type': 0, 'spent': True, 'value': 717, 'spending_outpoints': [{'tx_index': 3732143629637471, 'n': 0}], 'n': 53, 'tx_index': 2878033837057575, 'script': '51208035c74a0fd98ece97bf2cb1c19ff4e2419710bef1b5a7e853e41a55fad9c7b0', 'addr': 'bc1psq6uwjs0mx8va9al9jcur8l5ufqewy977x6606znusd9t7kec7cqfalral'}, {'type': 0, 'spent': True, 'value': 704, 'spending_outpoints': [{'tx_index': 3069926865839937, 'n': 0}], 'n': 54, 'tx_index': 2878033837057575, 'script': '51208035c74a0fd98ece97bf2cb1c19ff4e2419710bef1b5a7e853e41a55fad9c7b0', 'addr': 'bc1psq6uwjs0mx8va9al9jcur8l5ufqewy977x6606znusd9t7kec7cqfalral'}, {'type': 0, 'spent': True, 'value': 705, 'spending_outpoints': [{'tx_index': 4691582046545028, 'n': 0}], 'n': 55, 'tx_index': 2878033837057575, 'script': '51208035c74a0fd98ece97bf2cb1c19ff4e2419710bef1b5a7e853e41a55fad9c7b0', 'addr': 'bc1psq6uwjs0mx8va9al9jcur8l5ufqewy977x6606znusd9t7kec7cqfalral'}, {'type': 0, 'spent': True, 'value': 717, 'spending_outpoints': [{'tx_index': 3918730691529272, 'n': 0}], 'n': 56, 'tx_index': 2878033837057575, 'script': '51208035c74a0fd98ece97bf2cb1c19ff4e2419710bef1b5a7e853e41a55fad9c7b0', 'addr': 'bc1psq6uwjs0mx8va9al9jcur8l5ufqewy977x6606znusd9t7kec7cqfalral'}, {'type': 0, 'spent': True, 'value': 705, 'spending_outpoints': [{'tx_index': 5161623210468129, 'n': 0}], 'n': 57, 'tx_index': 2878033837057575, 'script': '51208035c74a0fd98ece97bf2cb1c19ff4e2419710bef1b5a7e853e41a55fad9c7b0', 'addr': 'bc1psq6uwjs0mx8va9al9jcur8l5ufqewy977x6606znusd9t7kec7cqfalral'}, {'type': 0, 'spent': True, 'value': 707, 'spending_outpoints': [{'tx_index': 8924171845380439, 'n': 0}], 'n': 58, 'tx_index': 2878033837057575, 'script': '51208035c74a0fd98ece97bf2cb1c19ff4e2419710bef1b5a7e853e41a55fad9c7b0', 'addr': 'bc1psq6uwjs0mx8va9al9jcur8l5ufqewy977x6606znusd9t7kec7cqfalral'}, {'type': 0, 'spent': True, 'value': 707, 'spending_outpoints': [{'tx_index': 6052295799886457, 'n': 0}], 'n': 59, 'tx_index': 2878033837057575, 'script': '51208035c74a0fd98ece97bf2cb1c19ff4e2419710bef1b5a7e853e41a55fad9c7b0', 'addr': 'bc1psq6uwjs0mx8va9al9jcur8l5ufqewy977x6606znusd9t7kec7cqfalral'}, {'type': 0, 'spent': True, 'value': 707, 'spending_outpoints': [{'tx_index': 7819750659632958, 'n': 0}], 'n': 60, 'tx_index': 2878033837057575, 'script': '51208035c74a0fd98ece97bf2cb1c19ff4e2419710bef1b5a7e853e41a55fad9c7b0', 'addr': 'bc1psq6uwjs0mx8va9al9jcur8l5ufqewy977x6606znusd9t7kec7cqfalral'}, {'type': 0, 'spent': True, 'value': 707, 'spending_outpoints': [{'tx_index': 8046851963773709, 'n': 0}], 'n': 61, 'tx_index': 2878033837057575, 'script': '51208035c74a0fd98ece97bf2cb1c19ff4e2419710bef1b5a7e853e41a55fad9c7b0', 'addr': 'bc1psq6uwjs0mx8va9al9jcur8l5ufqewy977x6606znusd9t7kec7cqfalral'}, {'type': 0, 'spent': True, 'value': 705, 'spending_outpoints': [{'tx_index': 7119598311954167, 'n': 0}], 'n': 62, 'tx_index': 2878033837057575, 'script': '51208035c74a0fd98ece97bf2cb1c19ff4e2419710bef1b5a7e853e41a55fad9c7b0', 'addr': 'bc1psq6uwjs0mx8va9al9jcur8l5ufqewy977x6606znusd9t7kec7cqfalral'}, {'type': 0, 'spent': True, 'value': 705, 'spending_outpoints': [{'tx_index': 2188040963665476, 'n': 0}], 'n': 63, 'tx_index': 2878033837057575, 'script': '51208035c74a0fd98ece97bf2cb1c19ff4e2419710bef1b5a7e853e41a55fad9c7b0', 'addr': 'bc1psq6uwjs0mx8va9al9jcur8l5ufqewy977x6606znusd9t7kec7cqfalral'}, {'type': 0, 'spent': True, 'value': 705, 'spending_outpoints': [{'tx_index': 57609029502738, 'n': 0}], 'n': 64, 'tx_index': 2878033837057575, 'script': '51208035c74a0fd98ece97bf2cb1c19ff4e2419710bef1b5a7e853e41a55fad9c7b0', 'addr': 'bc1psq6uwjs0mx8va9al9jcur8l5ufqewy977x6606znusd9t7kec7cqfalral'}, {'type': 0, 'spent': True, 'value': 717, 'spending_outpoints': [{'tx_index': 2978418227770982, 'n': 0}], 'n': 65, 'tx_index': 2878033837057575, 'script': '51208035c74a0fd98ece97bf2cb1c19ff4e2419710bef1b5a7e853e41a55fad9c7b0', 'addr': 'bc1psq6uwjs0mx8va9al9jcur8l5ufqewy977x6606znusd9t7kec7cqfalral'}, {'type': 0, 'spent': True, 'value': 705, 'spending_outpoints': [{'tx_index': 7596495043337630, 'n': 0}], 'n': 66, 'tx_index': 2878033837057575, 'script': '51208035c74a0fd98ece97bf2cb1c19ff4e2419710bef1b5a7e853e41a55fad9c7b0', 'addr': 'bc1psq6uwjs0mx8va9al9jcur8l5ufqewy977x6606znusd9t7kec7cqfalral'}, {'type': 0, 'spent': True, 'value': 704, 'spending_outpoints': [{'tx_index': 6917078230775363, 'n': 0}], 'n': 67, 'tx_index': 2878033837057575, 'script': '51208035c74a0fd98ece97bf2cb1c19ff4e2419710bef1b5a7e853e41a55fad9c7b0', 'addr': 'bc1psq6uwjs0mx8va9al9jcur8l5ufqewy977x6606znusd9t7kec7cqfalral'}, {'type': 0, 'spent': True, 'value': 705, 'spending_outpoints': [{'tx_index': 3037040163932043, 'n': 0}], 'n': 68, 'tx_index': 2878033837057575, 'script': '51208035c74a0fd98ece97bf2cb1c19ff4e2419710bef1b5a7e853e41a55fad9c7b0', 'addr': 'bc1psq6uwjs0mx8va9al9jcur8l5ufqewy977x6606znusd9t7kec7cqfalral'}, {'type': 0, 'spent': True, 'value': 705, 'spending_outpoints': [{'tx_index': 4246367635082703, 'n': 0}], 'n': 69, 'tx_index': 2878033837057575, 'script': '51208035c74a0fd98ece97bf2cb1c19ff4e2419710bef1b5a7e853e41a55fad9c7b0', 'addr': 'bc1psq6uwjs0mx8va9al9jcur8l5ufqewy977x6606znusd9t7kec7cqfalral'}, {'type': 0, 'spent': True, 'value': 707, 'spending_outpoints': [{'tx_index': 930284590792446, 'n': 0}], 'n': 70, 'tx_index': 2878033837057575, 'script': '51208035c74a0fd98ece97bf2cb1c19ff4e2419710bef1b5a7e853e41a55fad9c7b0', 'addr': 'bc1psq6uwjs0mx8va9al9jcur8l5ufqewy977x6606znusd9t7kec7cqfalral'}, {'type': 0, 'spent': True, 'value': 707, 'spending_outpoints': [{'tx_index': 647878639991676, 'n': 0}], 'n': 71, 'tx_index': 2878033837057575, 'script': '51208035c74a0fd98ece97bf2cb1c19ff4e2419710bef1b5a7e853e41a55fad9c7b0', 'addr': 'bc1psq6uwjs0mx8va9al9jcur8l5ufqewy977x6606znusd9t7kec7cqfalral'}, {'type': 0, 'spent': True, 'value': 707, 'spending_outpoints': [{'tx_index': 1102367807731351, 'n': 0}], 'n': 72, 'tx_index': 2878033837057575, 'script': '51208035c74a0fd98ece97bf2cb1c19ff4e2419710bef1b5a7e853e41a55fad9c7b0', 'addr': 'bc1psq6uwjs0mx8va9al9jcur8l5ufqewy977x6606znusd9t7kec7cqfalral'}, {'type': 0, 'spent': True, 'value': 717, 'spending_outpoints': [{'tx_index': 2474574120844739, 'n': 0}], 'n': 73, 'tx_index': 2878033837057575, 'script': '51208035c74a0fd98ece97bf2cb1c19ff4e2419710bef1b5a7e853e41a55fad9c7b0', 'addr': 'bc1psq6uwjs0mx8va9al9jcur8l5ufqewy977x6606znusd9t7kec7cqfalral'}, {'type': 0, 'spent': True, 'value': 704, 'spending_outpoints': [{'tx_index': 343250890492090, 'n': 0}], 'n': 74, 'tx_index': 2878033837057575, 'script': '51208035c74a0fd98ece97bf2cb1c19ff4e2419710bef1b5a7e853e41a55fad9c7b0', 'addr': 'bc1psq6uwjs0mx8va9al9jcur8l5ufqewy977x6606znusd9t7kec7cqfalral'}, {'type': 0, 'spent': False, 'value': 4999, 'spending_outpoints': [], 'n': 75, 'tx_index': 2878033837057575, 'script': '001499946aafee31cf0906eb55615abf69238466318e', 'addr': 'bc1qnx2x4tlwx88sjpht24s440mfywzxvvvwynl090'}]",546,1000000590037
9c9b7b740a2a143054774d334fd755f2f17f16186ac0fbac46e32028e2d184a1,1,1,1,192,768,194,0.0.0.0,0,5682938528465948,False,1738049202,881170,881170,"[{'sequence': 4294967295, 'witness': '', 'script': '483045022100cf2f825333b3ec947e47bed81f3c628a12b2b7cda8617bdb9722d14adadcda2502200b1a56cd1ce3314956e6301ba911a36bb76694a66a7b1fe35c9cf5b6c8f811730121037dec38605e06ee63a5dbe93eef2a5e859d5a9ebf09a215903cd99a1361bb3d51', 'index': 0, 'prev_out': {'type': 0, 'spent': True, 'value': 794, 'spending_outpoints': [{'tx_index': 5682938528465948, 'n': 0}], 'n': 351, 'tx_index': 8940705351436532, 'script': '76a91487e6d559e91f63fc89a92086f190881c59a48f3188ac', 'addr': '1DPakV2GP7LRMsFw7f4DxqsyqRx1gcaewi'}}]","[{'type': 0, 'spent': False, 'value': 600, 'spending_outpoints': [], 'n': 0, 'tx_index': 5682938528465948, 'script': '76a91487ccbdb1aba7e6875f750c0823bd63bf972a2fa988ac', 'addr': '1DP3VYwN6ozHXDDaETbvNFLd86CAXfaewi'}]",600,1000000589491
6771fbbc401d8a3402a2f095c3d0cd07ef4566000d7058a3b431977bf3048a9a,2,1,1,323,578,290,0.0.0.0,0,5437362535363302,False,1736396020,878427,878427,"[{'sequence': 4294967295, 'witness': '034082acf0bf634d098a231150970b7cd25eb4ee662ef74a55c251dc741275d17cba242548254a331937a3432577ccd75ed5ec459b05b5b006c4e75ea5cc4cba361f87209a48022bbff208a02c1934ea083cf6ac31f02dde49724252e585dac91318c3b7ac0063036f7264010118746578742f706c61696e3b636861727365743d7574662d3800417b2270223a226272632d3230222c226f70223a226d696e74222c227469636b223a22f096b999222c22616d74223a223134393539393635303137302e373639227d6821c19a48022bbff208a02c1934ea083cf6ac31f02dde49724252e585dac91318c3b7', 'script': '', 'index': 0, 'prev_out': {'type': 0, 'spent': True, 'value': 836, 'spending_outpoints': [{'tx_index': 5437362535363302, 'n': 0}], 'n': 200, 'tx_index': 2214167251729481, 'script': '5120d9a4b75a25f90015fbbcfb4d197671c1bb00f11f922279fa098fa0291de3b413', 'addr': 'bc1pmxjtwk39lyqpt7auldx3jan3cxaspugljg38n7sf37szj80rksfs0ctmu3'}}]","[{'type': 0, 'spent': False, 'value': 546, 'spending_outpoints': [], 'n': 0, 'tx_index': 5437362535363302, 'script': '76a91487ccbdb1aba7e6875f750c0823bd63bf972a2fa988ac', 'addr': '1DP3VYwN6ozHXDDaETbvNFLd86CAXfaewi'}]",546,1000000588891
387fab0383afd9a1f8a0116b68259031e453c9c4564944b149d4614948711594,2,1,1,308,563,282,0.0.0.0,0,5210234105179194,False,1735545923,877017,877017,"[{'sequence': 4294967295, 'witness': '03406e3abbcaf30def162863e6551206acf318c1391c12879bf54ef83e0573809b42cca75bf71f9de53f774d5f9701d2b6456f1bd09ec69931cea10b2acffa7e759678208ff1f0ab031026719a012c362970de636ab0efc27790bc4428bc8e52d511f551ac0063036f7264010118746578742f706c61696e3b636861727365743d7574662d3800327b2270223a226272632d3230222c226f70223a226d696e74222c227469636b223a22f096a591222c22616d74223a2231227d6821c18ff1f0ab031026719a012c362970de636ab0efc27790bc4428bc8e52d511f551', 'script': '', 'index': 0, 'prev_out': {'type': 0, 'spent': True, 'value': 828, 'spending_outpoints': [{'tx_index': 5210234105179194, 'n': 0}], 'n': 100, 'tx_index': 5672303711991658, 'script': '51207b4836b2edf3798b391cccd5ec58e832d494fe5445f12bb7ff528e3fbe63496c', 'addr': 'bc1p0dyrdvhd7duckwguen27ck8gxt2fflj5ghcjhdll228rl0nrf9kqlceyqu'}}]","[{'type': 0, 'spent': False, 'value': 546, 'spending_outpoints': [], 'n': 0, 'tx_index': 5210234105179194, 'script': '76a91487ccbdb1aba7e6875f750c0823bd63bf972a2fa988ac', 'addr': '1DP3VYwN6ozHXDDaETbvNFLd86CAXfaewi'}]",546,1000000588345
dfa7685d82530864b6cfd8935786317b97051c5b1955a806765feac1d87c7869,2,1,4,312,918,478,0.0.0.0,0,3710918770310475,False,1735186562,876403,876403,"[{'sequence': 4294967293, 'witness': '0248304502210083cd9d6c698f016396ffd9969887284facb4e0b0b20ec01da61d6180f0601fb7022008a51e6045e94288c6c66ef96481d962e8d0ddd4456488483634211c6a50b8ed012102be559a5a88b3c1c76b9aa691febfd9dde7c3717c42c4111a5c1ff3e18e8f3561', 'script': '', 'index': 0, 'prev_out': {'type': 0, 'spent': True, 'value': 63527, 'spending_outpoints': [{'tx_index': 3710918770310475, 'n': 0}], 'n': 1, 'tx_index': 3956928521257242, 'script': '00140712eae76f786a119e0a3727d39e3f256522ac19', 'addr': 'bc1qqufw4em00p4pr8s2xuna883ly4jj9tqer808c5'}}]","[{'type': 0, 'spent': False, 'value': 547, 'spending_outpoints': [], 'n': 0, 'tx_index': 3710918770310475, 'script': '76a91487ccbdb1aba7e6875f750c0823bd63bf972a2fa988ac', 'addr': '1DP3VYwN6ozHXDDaETbvNFLd86CAXfaewi'}, {'type': 0, 'spent': True, 'value': 61842, 'spending_outpoints': [{'tx_index': 4079309452486238, 'n': 0}], 'n': 1, 'tx_index': 3710918770310475, 'script': '00140712eae76f786a119e0a3727d39e3f256522ac19', 'addr': 'bc1qqufw4em00p4pr8s2xuna883ly4jj9tqer808c5'}, {'type': 0, 'spent': False, 'value': 330, 'spending_outpoints': [], 'n': 2, 'tx_index': 3710918770310475, 'script': '0020003c7374616d703a7b2270223a227372632d3230222c226f70223a227472616e', 'addr': 'bc1qqq78xarpd4cr57ezwq3r5gnnwf3j6v3sygkzymmsygazyarjv9hq0r4hhc'}, {'type': 0, 'spent': False, 'value': 330, 'spending_outpoints': [], 'n': 3, 'tx_index': 3710918770310475, 'script': '002073666572222c227469636b223a227374616d70222c22616d74223a31307d0000', 'addr': 'bc1qwdnx2u3z9s38g6trdv3r5gnnw3sk6upz9s3xzmt5ygarzvraqqqqhx9lkg'}]",547,1000000587799
fe0d9529b2d9a446f5533fb67494c54bba09e9fe663068eea01173e158c40a37,2,1,2,196,580,1022,0.0.0.0,0,1936620267515490,False,1730592877,868621,868621,"[{'sequence': 4294967293, 'witness': '01409de6021051c7e2d74940095f7423d4347e438b4b0c0145e2c37f00d29a94b080047a59ea3de836b1ccbf3d038350e2a21c1c2fdd98b41d6045f29cb8babcb31d', 'script': '', 'index': 0, 'prev_out': {'type': 0, 'spent': True, 'value': 2040904, 'spending_outpoints': [{'tx_index': 1936620267515490, 'n': 0}], 'n': 1, 'tx_index': 3594932044758445, 'script': '5120018741e469129d1d22e434729b170ab7f25c4167e5faed2247d40e7cc6655653', 'addr': 'bc1pqxr5rerfz2w36ghyx3efk9c2kle9cst8uhaw6gj86s88e3n92efsff5ghp'}}]","[{'type': 0, 'spent': False, 'value': 14400, 'spending_outpoints': [], 'n': 0, 'tx_index': 1936620267515490, 'script': '76a91487ccbdb1aba7e6875f750c0823bd63bf972a2fa988ac', 'addr': '1DP3VYwN6ozHXDDaETbvNFLd86CAXfaewi'}, {'type': 0, 'spent': True, 'value': 2025482, 'spending_outpoints': [{'tx_index': 7516202163802437, 'n': 0}], 'n': 1, 'tx_index': 1936620267515490, 'script': '5120018741e469129d1d22e434729b170ab7f25c4167e5faed2247d40e7cc6655653', 'addr': 'bc1pqxr5rerfz2w36ghyx3efk9c2kle9cst8uhaw6gj86s88e3n92efsff5ghp'}]",14400,1000000587252
d6431337a3e07c999492777dc907b08f346c04a7c5917e2fe42706ff9a269df4,2,1,6,393,1572,1379,0.0.0.0,861615,8606585431515332,False,1726531087,861616,861616,"[{'sequence': 4294967293, 'witness': '', 'script': '47304402202b224c0548bc351d90f289f13d25ee86c1fdeb19d525d949349f6630bdbc2bca0220724cb1127c35fda6b8c6bb24ec2093c95cb8a53743a2a985c3efce93dbee0e37014104f50d93ef03bec41d391d66d5831fd2e576e22f1c40415abe95d00c5283979571054dae289e6eba1c3fbf64b2eb2c6541b802346fb84ef8db6d0825ce30084999', 'index': 0, 'prev_out': {'type': 0, 'spent': True, 'value': 13976, 'spending_outpoints': [{'tx_index': 8606585431515332, 'n': 0}], 'n': 10, 'tx_index': 3230836420024661, 'script': '76a914b67272f8a0cce4d91ab2a487b07e7273e25886c188ac', 'addr': '1Hdh5ydmr8j84AxR6w774woezKWx1vWzmN'}}]","[{'type': 0, 'spent': False, 'value': 1216, 'spending_outpoints': [], 'n': 0, 'tx_index': 8606585431515332, 'script': '76a91487ccbdb1aba7e6875f750c0823bd63bf972a2fa988ac', 'addr': '1DP3VYwN6ozHXDDaETbvNFLd86CAXfaewi'}, {'type': 0, 'spent': True, 'value': 1237, 'spending_outpoints': [{'tx_index': 4347379950498580, 'n': 0}], 'n': 1, 'tx_index': 8606585431515332, 'script': '76a91420d45a6a762535700ce9e0b216e31994335db8a588ac', 'addr': '13zb1hQbWVsc2S7ZTZnP2G4undNNpdh5so'}, {'type': 0, 'spent': False, 'value': 1246, 'spending_outpoints': [], 'n': 2, 'tx_index': 8606585431515332, 'script': '76a914a91b3e836ce8da023fb32f6866eb09096a34ac8888ac', 'addr': '1GR9qNz7zgtaW5HwwVpEJWMnGWhsbsieCG'}, {'type': 0, 'spent': False, 'value': 1256, 'spending_outpoints': [], 'n': 3, 'tx_index': 8606585431515332, 'script': '76a91408ce7ebb4a2d701d1e1f06505d5c9c26ccd3c19888ac', 'addr': '1oZn4bJWSPPLTcQYR8xDz7mhpJmyvSk8m'}, {'type': 0, 'spent': False, 'value': 2260, 'spending_outpoints': [], 'n': 4, 'tx_index': 8606585431515332, 'script': '76a91407d1c36d2be12e112e8e3fb7f8d12eee7496ef9d88ac', 'addr': '1iM1xafZpdkUgydYqsh8zrD3tvg1ujb4M'}, {'type': 0, 'spent': True, 'value': 5382, 'spending_outpoints': [{'tx_index': 5529008188139211, 'n': 0}], 'n': 5, 'tx_index': 8606585431515332, 'script': '76a914b67272f8a0cce4d91ab2a487b07e7273e25886c188ac', 'addr': '1Hdh5ydmr8j84AxR6w774woezKWx1vWzmN'}]",1216,1000000572852
473149f56b319d175b20f0986036bc0d6065461fe2ba073989fc830e21069f05,2,1,1,343,598,900,0.0.0.0,0,197777944596607,False,1718642989,850998,850998,"[{'sequence': 4294967295, 'witness': '0340c79d6c429c2ec6815ce5aa61a3f36904c3aa816be0462cadc4bbcfac9252c013903eccaf180f0daaa30f3b2d748b4a15805bfdd98b2e98ef403ff7df75d62f739b202ed0aac521d860ee19195632ebb00999fe101a1734d987676bac0843921d7cdaac0063036f7264010118746578742f706c61696e3b636861727365743d7574662d38004c547b2270223a226272632d3230222c226f70223a226d696e74222c227469636b223a2252455744222c22616d74223a22313030222c2277656273697465223a227777772e62726332307265776172642e636f6d227d6821c02ed0aac521d860ee19195632ebb00999fe101a1734d987676bac0843921d7cda', 'script': '', 'index': 0, 'prev_out': {'type': 0, 'spent': True, 'value': 1446, 'spending_outpoints': [{'tx_index': 197777944596607, 'n': 0}], 'n': 9, 'tx_index': 2703012732731307, 'script': '51209c9dde276c872bebaf558b55d2ff1f48b7d510df44447ee4eeaa462dc03984ae', 'addr': 'bc1pnjwaufmvsu47ht643d2a9lclfzma2yxlg3z8ae8w4frzmspesjhqtradck'}}]","[{'type': 0, 'spent': False, 'value': 546, 'spending_outpoints': [], 'n': 0, 'tx_index': 197777944596607, 'script': '76a91487ccbdb1aba7e6875f750c0823bd63bf972a2fa988ac', 'addr': '1DP3VYwN6ozHXDDaETbvNFLd86CAXfaewi'}]",546,1000000571636
540d06a56e55eb431a457fff5407f21546cd8fc8ada42596a1f5cae0d1da5ca8,2,1,8,429,1389,12047,0.0.0.0,827835,5923736372648286,False,1706469493,827836,827836,"[{'sequence': 4294967293, 'witness': '0247304402204d067d4b2759ac337636b2fafbf0585d36ed09f3cff55f2aa1de752fa4746f60022077d5176896fa075c4fd042351bbc690391518a959567b1e8489753629095a8280121032d564a1548cf7a6f4515fccb21fae11b9320c88e4c2dfd347f985aaff87359f6', 'script': '', 'index': 0, 'prev_out': {'type': 0, 'spent': True, 'value': 107237, 'spending_outpoints': [{'tx_index': 5923736372648286, 'n': 0}], 'n': 3, 'tx_index': 3362426138207596, 'script': '0014410d100eac9cbb49f9fa6629a87e9d65ffd1cf75', 'addr': 'bc1qgyx3qr4vnja5n706vc56sl5avhlarnm4aypka8'}}]","[{'type': 0, 'spent': False, 'value': 800, 'spending_outpoints': [], 'n': 0, 'tx_index': 5923736372648286, 'script': '76a91455ef18af8ee521862d32b826a5e1e0d248eca98088ac', 'addr': '18qNs1yBGGKR8RyErnEF5kegbNUgPfixhS'}, {'type': 0, 'spent': False, 'value': 820, 'spending_outpoints': [], 'n': 1, 'tx_index': 5923736372648286, 'script': '76a9144bbd3511c60a2adc6f6b0aa5ee7fbbdeaf1a9ff888ac', 'addr': '17uULjz9moeLyjXHoKNwDRgKzf8ahY3Jia'}, {'type': 0, 'spent': False, 'value': 830, 'spending_outpoints': [], 'n': 2, 'tx_index': 5923736372648286, 'script': '76a914e28faa70532d9992840075ed898319e3ec572c7588ac', 'addr': '1MewpRkpcbFdqamPPYc1bXa9AJ189Succy'}, {'type': 0, 'spent': False, 'value': 840, 'spending_outpoints': [], 'n': 3, 'tx_index': 5923736372648286, 'script': '76a9140e2525ac9793e73c284f067aecab5f10f5ce6dd688ac', 'addr': '12HnxiXEeKUVjQRbMVTytsGWnzHd5LdGCt'}, {'type': 0, 'spent': False, 'value': 840, 'spending_outpoints': [], 'n': 4, 'tx_index': 5923736372648286, 'script': '76a91487ccbdb1aba7e6875f750c0823bd63bf972a2fa988ac', 'addr': '1DP3VYwN6ozHXDDaETbvNFLd86CAXfaewi'}, {'type': 0, 'spent': False, 'value': 860, 'spending_outpoints': [], 'n': 5, 'tx_index': 5923736372648286, 'script': '76a914e51e900d200db76790d1fecdb7e359344233e12d88ac', 'addr': '1MtUMTqtdrpT6Rar5fgWoyrzAevatssej5'}, {'type': 0, 'spent': False, 'value': 890, 'spending_outpoints': [], 'n': 6, 'tx_index': 5923736372648286, 'script': '76a914edf9b187cd16b0e1de0161e271c2111a7369771b88ac', 'addr': '1NhJGUJu8rrTwPS4vopsdTqqcK4nAwdLwJ'}, {'type': 0, 'spent': True, 'value': 89310, 'spending_outpoints': [{'tx_index': 2844250664782775, 'n': 0}], 'n': 7, 'tx_index': 5923736372648286, 'script': '0014abfaee50563c3dba2d004a60230606e207bbfe59', 'addr': 'bc1q40awu5zk8s7m5tgqffszxpsxugrmhljeldeu5m'}]",840,1000000571090
785c7d809634ee8fe3e4c32790d8c9b90405505b9340409007ea26c8c326cefc,2,2,2,303,810,14140,0.0.0.0,0,8894795002479837,False,1705540188,826198,826198,"[{'sequence': 2147483649, 'witness': '0140807f336d9a429d6e120c01caff22d546ebacb2e85032bd385232bef713edec7745bc43ed762750e2570b5ce0276e9959f1825584872c90a5e823efd62f52751f', 'script': '', 'index': 0, 'prev_out': {'type': 0, 'spent': True, 'value': 546, 'spending_outpoints': [{'tx_index': 8894795002479837, 'n': 0}], 'n': 0, 'tx_index': 8816978635308798, 'script': '5120f6dbf1e886f2f83ddbc4fff6c9d3371864fc9baa5f9c2b6b069348074b4745b3', 'addr': 'bc1p7mdlr6yx7turmk7yllmvn5ehrpj0exa2t7wzk6cxjdyqwj68gkesrjg8zt'}}, {'sequence': 2147483649, 'witness': '014071409773889c2ce64d0c0b8f39f539c32056992227ed64f74a737640935342fffd56160b01acc280131ab58da83b085f38a97de8102e8968685662baaad4610b', 'script': '', 'index': 1, 'prev_out': {'type': 0, 'spent': True, 'value': 372792, 'spending_outpoints': [{'tx_index': 8894795002479837, 'n': 1}], 'n': 1, 'tx_index': 6494297048701283, 'script': '5120f6dbf1e886f2f83ddbc4fff6c9d3371864fc9baa5f9c2b6b069348074b4745b3', 'addr': 'bc1p7mdlr6yx7turmk7yllmvn5ehrpj0exa2t7wzk6cxjdyqwj68gkesrjg8zt'}}]","[{'type': 0, 'spent': False, 'value': 546, 'spending_outpoints': [], 'n': 0, 'tx_index': 8894795002479837, 'script': '76a91487ccbdb1aba7e6875f750c0823bd63bf972a2fa988ac', 'addr': '1DP3VYwN6ozHXDDaETbvNFLd86CAXfaewi'}, {'type': 0, 'spent': True, 'value': 358652, 'spending_outpoints': [{'tx_index': 8243507727767523, 'n': 0}], 'n': 1, 'tx_index': 8894795002479837, 'script': '5120f6dbf1e886f2f83ddbc4fff6c9d3371864fc9baa5f9c2b6b069348074b4745b3', 'addr': 'bc1p7mdlr6yx7turmk7yllmvn5ehrpj0exa2t7wzk6cxjdyqwj68gkesrjg8zt'}]",546,1000000570250
dcf30235a942216f79dae64e51290d7a1b4c4af9de0b6e577efcd669386c0dc6,1,1,2,249,669,3350,0.0.0.0,0,6968350480349919,False,1667572581,761702,761702,"[{'sequence': 0, 'witness': '02473044022052549408913d52fa3c1433ba8405903458811db06d1523a037804161a1c400040220365b35683bc07b19c76ed1414c2faa28ae88990f9c3344870497efa78b763001012102a9476d41ef2293c2071ed3c2944f26c8f8ef72eb98af99fc4dc597a7fb9f1d40', 'script': '1600141194235c123bcef95c49815b838198f86e23b9ea', 'index': 0, 'prev_out': {'type': 0, 'spent': True, 'value': 1954282577997, 'spending_outpoints': [{'tx_index': 6968350480349919, 'n': 0}], 'n': 1, 'tx_index': 6643756647749288, 'script': 'a9148dc43a30122d1e621c7e604dab9b02f2b0d8583987', 'addr': '3EccGhkTmgaoVxBR9ggofDnQpeGZGjky4L'}}]","[{'type': 0, 'spent': False, 'value': 1000000000000, 'spending_outpoints': [], 'n': 0, 'tx_index': 6968350480349919, 'script': '76a91487ccbdb1aba7e6875f750c0823bd63bf972a2fa988ac', 'addr': '1DP3VYwN6ozHXDDaETbvNFLd86CAXfaewi'}, {'type': 0, 'spent': True, 'value': 954282574647, 'spending_outpoints': [{'tx_index': 2247760804412905, 'n': 0}], 'n': 1, 'tx_index': 6968350480349919, 'script': 'a91485c48a7351e2da28444ac316bc649070252e2e5887', 'addr': '3DtKExDtwnD3d5f6vq7ERSzqt1idx54b4V'}]",1000000000000,1000000569704
1953a111774d96bb19e2a115da85839f793ab8f02a992d653fb1536cafd2a7c7,1,1,2,250,670,3350,0.0.0.0,0,7024755461687926,False,1667572258,761701,761701,"[{'sequence': 0, 'witness': '024830450221009c7eb303acad7454536a7b2560c314af8f74c567b0dcbf33eea0bbc26b6e1b0802207d075bfe6b212bed218c7d02fae18093e10cdb1421984710c6ea09c9bfeaa50c012102b1d164b3c291badebb55b7a67a591df6ff0a203b9a05658a5fe23cfa59e902ab', 'script': '16001420e0a14d151146295ba61589ab6cd30502ee43da', 'index': 0, 'prev_out': {'type': 0, 'spent': True, 'value': 150000, 'spending_outpoints': [{'tx_index': 7024755461687926, 'n': 0}], 'n': 0, 'tx_index': 8241555210061950, 'script': 'a914945ddcd6abdf86c557d706655f7b8cb8bd97bf7187', 'addr': '3FDWNdFxrJxXoF4hWXF4dkc1FFxsNyKAHh'}}]","[{'type': 0, 'spent': False, 'value': 100000, 'spending_outpoints': [], 'n': 0, 'tx_index': 7024755461687926, 'script': '76a91487ccbdb1aba7e6875f750c0823bd63bf972a2fa988ac', 'addr': '1DP3VYwN6ozHXDDaETbvNFLd86CAXfaewi'}, {'type': 0, 'spent': True, 'value': 46650, 'spending_outpoints': [{'tx_index': 4597605838665116, 'n': 1}], 'n': 1, 'tx_index': 7024755461687926, 'script': 'a914627ff69fe9f60ea7da4c8927f4e54deec362a1f187', 'addr': '3AfqSPqHa2DkkBidNmypZWocf76o5C1RKK'}]",100000,569704
e277351cc0ec5e7101a2d9f9f3fe276c53db29ccbce32852d8b646558f8470c2,1,1,2,223,892,5296,0.0.0.0,0,6841232515573974,False,1667384359,761392,761392,"[{'sequence': 4294967295, 'witness': '', 'script': '47304402201f3d07089c5d85d71452e76da2076e7c2709596f64d66dfc3ed1c75ec42ca5800220092ab55cc5ae0cf0847ed308f61cd60d5cf68cc570728990727697638752cfce01210252b0c8673488f07dd67a9c5555e78c5e9aca537661438c523bd26ec7ebc1d3c6', 'index': 0, 'prev_out': {'type': 0, 'spent': True, 'value': 500000, 'spending_outpoints': [{'tx_index': 6841232515573974, 'n': 0}], 'n': 0, 'tx_index': 2885622613712651, 'script': '76a91487ccbdb1aba7e6875f750c0823bd63bf972a2fa988ac', 'addr': '1DP3VYwN6ozHXDDaETbvNFLd86CAXfaewi'}}]","[{'type': 0, 'spent': True, 'value': 25000, 'spending_outpoints': [{'tx_index': 92467642376165, 'n': 13}], 'n': 0, 'tx_index': 6841232515573974, 'script': 'a914987d41b49831ebdbdeedcb1fca1cb3f3c50558e487', 'addr': '3FbJggpjbTXEdemtu8gAivZAJ2fWQj75AM'}, {'type': 0, 'spent': False, 'value': 469704, 'spending_outpoints': [], 'n': 1, 'tx_index': 6841232515573974, 'script': '76a91487ccbdb1aba7e6875f750c0823bd63bf972a2fa988ac', 'addr': '1DP3VYwN6ozHXDDaETbvNFLd86CAXfaewi'}]",-30296,469704
8c5141f540224f8a63e3ddb633fc845356fbde7964a4c03fc95bf8c4f6aa0352,1,1,2,249,669,2513,0.0.0.0,0,2885622613712651,False,1667374248,761379,761379,"[{'sequence': 0, 'witness': '0247304402205c479eb83fd3edfa7e6a5f67b8128871b0ec8be4e25a3d54158ef036d86c28cf0220772150b52aa15a8a97003b7af6417f37e32ecfff829daeaf1d867d2dd2f7209201210243ccffc80f8218475aeddaf99e8ccaa31667a546fc12cb1f0bd7bc802d00221c', 'script': '16001458dee3a673fa1874c22f44bc21e1ba2a7199c246', 'index': 0, 'prev_out': {'type': 0, 'spent': True, 'value': 5056235578674, 'spending_outpoints': [{'tx_index': 2885622613712651, 'n': 0}], 'n': 1, 'tx_index': 5270363524973132, 'script': 'a91493225003dfb44ba5874e8e3292b790eeb4b32ff287', 'addr': '3F6zMpas8RxdXYhtTXc836cQfGC5HgXNy8'}}]","[{'type': 0, 'spent': True, 'value': 500000, 'spending_outpoints': [{'tx_index': 6841232515573974, 'n': 0}], 'n': 0, 'tx_index': 2885622613712651, 'script': '76a91487ccbdb1aba7e6875f750c0823bd63bf972a2fa988ac', 'addr': '1DP3VYwN6ozHXDDaETbvNFLd86CAXfaewi'}, {'type': 0, 'spent': True, 'value': 5056235076161, 'spending_outpoints': [{'tx_index': 5737683545502089, 'n': 0}], 'n': 1, 'tx_index': 2885622613712651, 'script': 'a9146af09711cd0e1688ec4931e881795f3d8d56d05c87', 'addr': '3BSTmNXqtKU3Cf47LRoERDpjVjwXJkiD8P'}]",500000,500000
