hash,ver,vin_sz,vout_sz,size,weight,fee,relayed_by,lock_time,tx_index,double_spend,time,block_index,block_height,inputs,out,result,balance
4018ed2ef810e7f1e425dd338f772f22a387933ce863a870d924191ff7fddb29,1,1,1,216,534,138,0.0.0.0,0,1472794733044516,False,1731408544,,,"[{'sequence': 4294967295, 'witness': '02483045022100a777b95a7beccb5e4a854b9399a08fcdf7dc871862b24715d6c900b07238f97a022034bd228cd10380a2a6e2c53a63c38b99b03b7e5e8483badacda91e07dee1a8900121039f5487a721c2049b276d939f9fdf61e97d60a2d1b6730f1e7e9ac468bfd36433', 'script': '1600147192b031f24cb6bdf55fe64571183cf7f073319d', 'index': 0, 'prev_out': {'type': 0, 'spent': True, 'value': 738, 'spending_outpoints': [{'tx_index': 1472794733044516, 'n': 0}], 'n': 24, 'tx_index': 1641130212132113, 'script': 'a91429cd287f0fc62c14f41449975ced36eb885c0a7387', 'addr': '35W3Q3qJuSh5Jdd9RqNQtQDtc7ZAKo41Lo'}}]","[{'type': 0, 'spent': False, 'value': 600, 'spending_outpoints': [], 'n': 0, 'tx_index': 1472794733044516, 'script': 'a91429d930b97d58a3415c4a1e280e0e80f1d3e0a29487', 'addr': '35WHp4Hid61peyH4tuhNunwRj2gtNB41Lo'}]",600,999549839038
fd873d2d3b5f79d7aba0002ad85fb4b863be2db2f92280e952905ae7c22d8d59,2,3,2,645,1233,2199,0.0.0.0,0,3150812576279378,False,1721976398,853989.0,853989.0,"[{'sequence': 4294967293, 'witness': '0340c926edcbe0089a948dfd39d0abece64606da4a537709bb755c3d0cd0935f256d9b5073d25e320bee96f90cfb5c99eb3b405b982325bb0568969532527cba580fac203e409b40917310e2dee2bc700c600721a1a2494afb65d619edc63abaa1b261c3ac0063036f7264010118746578742f706c61696e3b636861727365743d7574662d380103201b1656af26ef46d02cbcde80a993786263770867d7c45519db3b482df429c05100437b2270223a226272632d3230222c226f70223a226d696e74222c227469636b223a227669746173222c22616d74223a223130303030303030303030303030303030227d6821c09f2d3a7fa727bf9ec9d6884f61fc4f1377cae56aa013c99638f032a024037984', 'script': '', 'index': 0, 'prev_out': {'type': 0, 'spent': True, 'value': 546, 'spending_outpoints': [{'tx_index': 3150812576279378, 'n': 0}], 'n': 0, 'tx_index': 2508881675867252, 'script': '512090b43739c4f3b19b7100933712701d08026142bc9cf7811557f677c11964c647', 'addr': 'bc1pjz6rwwwy7wcekugqjvm3yuqapqpxzs4unnmcz92h7emuzxtycersfn7dh7'}}, {'sequence': 4294967293, 'witness': '02483045022100c1c02181bc421e0c09bb7f349649f11787fdf59184a8766a8f99c6746256f02f02203236cffc55cfb46a26cc8abf08330912af9fed1b32d36d40a544214adcc8e08c0121025961c85aced066de3d97d58d3ad45df7a971b7a499a7cd42ff5cc6c64d7b0e9b', 'script': '', 'index': 1, 'prev_out': {'type': 0, 'spent': True, 'value': 546, 'spending_outpoints': [{'tx_index': 3150812576279378, 'n': 1}], 'n': 1, 'tx_index': 5396045619108354, 'script': '0014ffb146410d4864ec4f721e5c1f12028907e47cec', 'addr': 'bc1ql7c5vsgdfpjwcnmjrewp7ysz3yr7gl8vs0murw'}}, {'sequence': 4294967295, 'witness': '0140f93692c48d2cb78aae0ad06344bcb795188e9e25fe9dbc4ee23f8da3d25332926ff4fe865973d576199ff5a5aee7059f55f0fd2708c5587dac4b06854a44032d', 'script': '', 'index': 2, 'prev_out': {'type': 0, 'spent': True, 'value': 2199, 'spending_outpoints': [{'tx_index': 3150812576279378, 'n': 2}], 'n': 1, 'tx_index': 2508881675867252, 'script': '512090b43739c4f3b19b7100933712701d08026142bc9cf7811557f677c11964c647', 'addr': 'bc1pjz6rwwwy7wcekugqjvm3yuqapqpxzs4unnmcz92h7emuzxtycersfn7dh7'}}]","[{'type': 0, 'spent': False, 'value': 546, 'spending_outpoints': [], 'n': 0, 'tx_index': 3150812576279378, 'script': 'a91429d930b97d58a3415c4a1e280e0e80f1d3e0a29487', 'addr': '35WHp4Hid61peyH4tuhNunwRj2gtNB41Lo'}, {'type': 0, 'spent': True, 'value': 546, 'spending_outpoints': [{'tx_index': 6162387982687791, 'n': 1}], 'n': 1, 'tx_index': 3150812576279378, 'script': '0014ffb146410d4864ec4f721e5c1f12028907e47cec', 'addr': 'bc1ql7c5vsgdfpjwcnmjrewp7ysz3yr7gl8vs0murw'}]",546,999549838438
8f20474dbcb03735f4a40c4cbe5b9624625091764cded6cfa2fa21f7ed9c3058,2,1,2,223,565,17980,0.0.0.0,0,3102906064495679,False,1712917491,838860.0,838860.0,"[{'sequence': 4294967293, 'witness': '02473044022050c3c705f1e87318b7d46e08433e11e1d0e28d2c5195f521ba38dfe116bf875102203bc532401f1e87d72a4282549bf511d182788365f9813fa2029663e00bd987020121026e5628506ecd33242e5ceb5fdafe4d3066b5c0f159b3c05a621ef65f177ea286', 'script': '', 'index': 0, 'prev_out': {'type': 0, 'spent': True, 'value': 45731139, 'spending_outpoints': [{'tx_index': 3102906064495679, 'n': 0}], 'n': 1, 'tx_index': 3032762269646499, 'script': '0014f60834ef165253c571b11ce9fa74e46692fc5ec1', 'addr': 'bc1q7cyrfmck2ffu2ud3rn5l5a8yv6f0chkp0zpemf'}}]","[{'type': 0, 'spent': False, 'value': 60000, 'spending_outpoints': [], 'n': 0, 'tx_index': 3102906064495679, 'script': 'a91429d930b97d58a3415c4a1e280e0e80f1d3e0a29487', 'addr': '35WHp4Hid61peyH4tuhNunwRj2gtNB41Lo'}, {'type': 0, 'spent': True, 'value': 45653159, 'spending_outpoints': [{'tx_index': 1258539547052868, 'n': 0}], 'n': 1, 'tx_index': 3102906064495679, 'script': '0014f60834ef165253c571b11ce9fa74e46692fc5ec1', 'addr': 'bc1q7cyrfmck2ffu2ud3rn5l5a8yv6f0chkp0zpemf'}]",60000,999549837892
d2d3939bcc93a6f831d929fd8b706befd3ae4c554003fd4f2a60a2c780e8ee53,2,1,2,512,2048,62970,0.0.0.0,788076,2953138178421836,False,1683286289,788364.0,788364.0,"[{'sequence': 4294967293, 'witness': '', 'script': '0047304402207d76d09a9235e8efc9c40610660218ace988077321d9eefbd250fa8e0c010f35022021b5c28e64564390bcc23b2063c625a772e721a6ae21cb59cb88dac8961a5c2501473044022073961ca19ab82948fb2556f1de3e187e23c2e2faf3cf429e1029b122c6c0d1c802206857b10786d752bf00fafd5d1b6d8da1d2fe7ca56825dc9ab474c091da7a2672014830450221008847882c4117c8915630aceb0dd5d58c98e382e5ae13f12a4984ccf1bfc330a002205cb35f75648caf3accaef29e8efe23fede8dae15c775e46b1e0d0fcfd1f329e0014cad53210286bcb74ee6cc1a0739a3b1488fa396b24d0b274c7545af47bcaf6c47dc0964e82102e0f51c1f1766227fd33d8c6e21d59580762b16b02c69c69a5d101617ddbc96622102f81295d4ee6029654af30c24f0f10822dc74519e364badd52d2cb03005da58c2210328a3e9079e1a7aeee300b52e30a3f75b0f5705c3b8c58165ff8f71233136e49c2103834fdf32859a097301fdb840b246f9ff90c5f7e82105e32f569218b15ffd7b4b55ae', 'index': 0, 'prev_out': {'type': 0, 'spent': True, 'value': 25000000000, 'spending_outpoints': [{'tx_index': 2953138178421836, 'n': 0}], 'n': 0, 'tx_index': 7280621894978713, 'script': 'a91429d930b97d58a3415c4a1e280e0e80f1d3e0a29487', 'addr': '35WHp4Hid61peyH4tuhNunwRj2gtNB41Lo'}}]","[{'type': 0, 'spent': True, 'value': 451892920, 'spending_outpoints': [{'tx_index': 8649275101530001, 'n': 0}], 'n': 0, 'tx_index': 2953138178421836, 'script': '76a914240e0c673eb6a0b194f9725beb93d58c2683996a88ac', 'addr': '14HeA1YRUiJGb95HVpVTBuavMUBYGk6y7R'}, {'type': 0, 'spent': False, 'value': 24548044110, 'spending_outpoints': [], 'n': 1, 'tx_index': 2953138178421836, 'script': 'a91429d930b97d58a3415c4a1e280e0e80f1d3e0a29487', 'addr': '35WHp4Hid61peyH4tuhNunwRj2gtNB41Lo'}]",-451955890,999549777892
a4effa7bee89b5d52d9e4f8d48e96b3960cf2bc9af46c31a3a176f66a3b7aba7,1,1,2,256,1024,645,0.0.0.0,0,5899390789930466,False,1655427532,741111.0,741111.0,"[{'sequence': 4294967295, 'witness': '', 'script': '4830450221009d07c1687ebf7724dcedae97d43f0fd2b831e87ce225b0bc3eef45d1d01abe240220283f21108ba3408e70d1cdfaf2123c1e44332a55add13f8fe7838cff49371bec014104354b84ddb18f59c46c10a20e32e1e5c41bd38fa24ad2cea1ca54703f43272d8174296b1058b200820b8bfe8ec4376b72ba1aeb1f6d320083a7e4f2067b73a798', 'index': 0, 'prev_out': {'type': 0, 'spent': True, 'value': 36800, 'spending_outpoints': [{'tx_index': 5899390789930466, 'n': 0}], 'n': 0, 'tx_index': 4868974619174078, 'script': '76a914d939982a722de1b3807d5527c430f15455bc22c788ac', 'addr': '1LoadMewf3YfGDQwwvNqsqiL3irVLYXVAh'}}]","[{'type': 0, 'spent': False, 'value': 600, 'spending_outpoints': [], 'n': 0, 'tx_index': 5899390789930466, 'script': 'a91429d930b97d58a3415c4a1e280e0e80f1d3e0a29487', 'addr': '35WHp4Hid61peyH4tuhNunwRj2gtNB41Lo'}, {'type': 0, 'spent': True, 'value': 35555, 'spending_outpoints': [{'tx_index': 8103163456434161, 'n': 0}], 'n': 1, 'tx_index': 5899390789930466, 'script': '76a914d939982a722de1b3807d5527c430f15455bc22c788ac', 'addr': '1LoadMewf3YfGDQwwvNqsqiL3irVLYXVAh'}]",600,1000001733782
54ee50e28ca5734baec038de2f53697b375643c3d8ec9801f33874df18d2b3c5,1,4,2,669,1698,8369,0.0.0.0,0,6956035669225095,False,1654250578,739112.0,739112.0,"[{'sequence': 4294967295, 'witness': '', 'script': '473044022004793367f3778613affcc4789f9f6544f5809b2f5b7a2558c6d355a0215a9335022066b761e1fc43cb429255fb1480cd51bcc59ef64d357c886d12e12a46d290eb3c012102eba303b19783d159b5661770cf7f987f4e53f3f916f65d9bc1b40a7f3e0e9a5b', 'index': 0, 'prev_out': {'type': 0, 'spent': True, 'value': 5435768570, 'spending_outpoints': [{'tx_index': 6956035669225095, 'n': 0}], 'n': 0, 'tx_index': 744835466251371, 'script': '76a914240e0c673eb6a0b194f9725beb93d58c2683996a88ac', 'addr': '14HeA1YRUiJGb95HVpVTBuavMUBYGk6y7R'}}, {'sequence': 4294967295, 'witness': '0247304402202ef9fc9581af4fe3ca893c7e0953e7a4fb792043bf89ad0aa7158d8e4f4e540d02204d222380b2ac1f501c6dcd24f7c7b670c90ad05391c73343f39e4e225cc1131e0121024c242aa0ac1c76b48d7dd8dfbe038d9f7a88e2c09136ff4396f67946c7dca841', 'script': '', 'index': 1, 'prev_out': {'type': 0, 'spent': True, 'value': 21115717615, 'spending_outpoints': [{'tx_index': 6956035669225095, 'n': 1}], 'n': 1, 'tx_index': 5630973964983542, 'script': '0014582824ffee2a60576a0b9a51dfa4aca15281e0c6', 'addr': 'bc1qtq5zfllw9fs9w6stnfgalf9v59fgrcxxyawuvm'}}, {'sequence': 4294967295, 'witness': '02483045022100c52635a2655fe8bc99525133e1e66abb2eb87dc2d48ad88cb841fad2ef68f9a4022043f067aa04cba5b1b235013d3781c00964fbe7e64f11c521180a177555bbc0230121024c242aa0ac1c76b48d7dd8dfbe038d9f7a88e2c09136ff4396f67946c7dca841', 'script': '', 'index': 2, 'prev_out': {'type': 0, 'spent': True, 'value': 54051650015, 'spending_outpoints': [{'tx_index': 6956035669225095, 'n': 2}], 'n': 1, 'tx_index': 2125158427186849, 'script': '0014582824ffee2a60576a0b9a51dfa4aca15281e0c6', 'addr': 'bc1qtq5zfllw9fs9w6stnfgalf9v59fgrcxxyawuvm'}}, {'sequence': 4294967295, 'witness': '02483045022100c6bca03319783285f001649450814dcbddf2fd1e562662581d012923bcfe9dce02202c9c18b9ae912d8abc1fe3a9cbdffefc8e0b0aff8b0e5128f9975417fbd3cda60121024c242aa0ac1c76b48d7dd8dfbe038d9f7a88e2c09136ff4396f67946c7dca841', 'script': '', 'index': 3, 'prev_out': {'type': 0, 'spent': True, 'value': 57072646017, 'spending_outpoints': [{'tx_index': 6956035669225095, 'n': 3}], 'n': 1, 'tx_index': 1417480015821474, 'script': '0014582824ffee2a60576a0b9a51dfa4aca15281e0c6', 'addr': 'bc1qtq5zfllw9fs9w6stnfgalf9v59fgrcxxyawuvm'}}]","[{'type': 0, 'spent': False, 'value': 100000000000, 'spending_outpoints': [], 'n': 0, 'tx_index': 6956035669225095, 'script': 'a91429d930b97d58a3415c4a1e280e0e80f1d3e0a29487', 'addr': '35WHp4Hid61peyH4tuhNunwRj2gtNB41Lo'}, {'type': 0, 'spent': True, 'value': 37675773848, 'spending_outpoints': [{'tx_index': 1219820821862945, 'n': 0}], 'n': 1, 'tx_index': 6956035669225095, 'script': '0014582824ffee2a60576a0b9a51dfa4aca15281e0c6', 'addr': 'bc1qtq5zfllw9fs9w6stnfgalf9v59fgrcxxyawuvm'}]",100000000000,1000001733182
1be57ed7818acb7ceb5a0555ac0ab5c5b1fa9478f7412b9cf0b934e487631572,1,3,2,520,1108,6068,0.0.0.0,0,4013958071355031,False,1654189525,739012.0,739012.0,"[{'sequence': 4294967295, 'witness': '02483045022100e00cf6934725d8a94e4575d22c8ba8a5f7f790af09b9a8eb2d748f22f863070d022007549a47fddcc0b3199771c9680de1c51638c816f0f842b3e523dc7a2e75fa190121024c242aa0ac1c76b48d7dd8dfbe038d9f7a88e2c09136ff4396f67946c7dca841', 'script': '', 'index': 0, 'prev_out': {'type': 0, 'spent': True, 'value': 21373212723, 'spending_outpoints': [{'tx_index': 4013958071355031, 'n': 0}], 'n': 1, 'tx_index': 3868231142653812, 'script': '0014582824ffee2a60576a0b9a51dfa4aca15281e0c6', 'addr': 'bc1qtq5zfllw9fs9w6stnfgalf9v59fgrcxxyawuvm'}}, {'sequence': 4294967295, 'witness': '0247304402201feab37cc920b413b8818c1bd6f06ac5a9afdb505f3fe93f0aea60e7792a0a08022017874570e03106e33328acc4cb1ae45f6d4e5803e0d84f4df9b878fbb910bcb70121024c242aa0ac1c76b48d7dd8dfbe038d9f7a88e2c09136ff4396f67946c7dca841', 'script': '', 'index': 1, 'prev_out': {'type': 0, 'spent': True, 'value': 49238072975, 'spending_outpoints': [{'tx_index': 4013958071355031, 'n': 1}], 'n': 1, 'tx_index': 1779716152165659, 'script': '0014582824ffee2a60576a0b9a51dfa4aca15281e0c6', 'addr': 'bc1qtq5zfllw9fs9w6stnfgalf9v59fgrcxxyawuvm'}}, {'sequence': 4294967295, 'witness': '02473044022046faa56bca12077b8420c4d145b6e929b9fd5762a234c6fa9cf6122db187f384022072ba484e8c00af95513fe795270df117b7425039c0582fd0c61a8e0f4f34624d0121024c242aa0ac1c76b48d7dd8dfbe038d9f7a88e2c09136ff4396f67946c7dca841', 'script': '', 'index': 2, 'prev_out': {'type': 0, 'spent': True, 'value': 51204440853, 'spending_outpoints': [{'tx_index': 4013958071355031, 'n': 2}], 'n': 1, 'tx_index': 5600605826542977, 'script': '0014582824ffee2a60576a0b9a51dfa4aca15281e0c6', 'addr': 'bc1qtq5zfllw9fs9w6stnfgalf9v59fgrcxxyawuvm'}}]","[{'type': 0, 'spent': False, 'value': 100000000000, 'spending_outpoints': [], 'n': 0, 'tx_index': 4013958071355031, 'script': 'a91429d930b97d58a3415c4a1e280e0e80f1d3e0a29487', 'addr': '35WHp4Hid61peyH4tuhNunwRj2gtNB41Lo'}, {'type': 0, 'spent': True, 'value': 21815720483, 'spending_outpoints': [{'tx_index': 5630973964983542, 'n': 0}], 'n': 1, 'tx_index': 4013958071355031, 'script': '0014582824ffee2a60576a0b9a51dfa4aca15281e0c6', 'addr': 'bc1qtq5zfllw9fs9w6stnfgalf9v59fgrcxxyawuvm'}]",100000000000,900001733182
1b77bec91945448d69848fed186ad922d0d8f7a3dc42c2ad86a1fb55f915f16d,1,5,2,818,2294,12856,0.0.0.0,0,3868231142653812,False,1654186498,739008.0,739008.0,"[{'sequence': 4294967295, 'witness': '', 'script': '48304502210086115a97d239a49c22e304f44a5e8953b9d6aa6a76ab26a9f84fd3a5a7eebc53022063a0d50b192621cebb108afef84a1cd1ad57e548055cd238e19f95732eb6a62a012102eba303b19783d159b5661770cf7f987f4e53f3f916f65d9bc1b40a7f3e0e9a5b', 'index': 0, 'prev_out': {'type': 0, 'spent': True, 'value': 6743801473, 'spending_outpoints': [{'tx_index': 3868231142653812, 'n': 0}], 'n': 1, 'tx_index': 569501361880145, 'script': '76a914240e0c673eb6a0b194f9725beb93d58c2683996a88ac', 'addr': '14HeA1YRUiJGb95HVpVTBuavMUBYGk6y7R'}}, {'sequence': 4294967295, 'witness': '', 'script': '483045022100cdcb1a2444a3d44ab125347d124b98f0734512100452e857d3caecb409cf4f03022020ce277ad50632c7c380e88162843735496a261bf3143acceec460af31e16639012102eba303b19783d159b5661770cf7f987f4e53f3f916f65d9bc1b40a7f3e0e9a5b', 'index': 1, 'prev_out': {'type': 0, 'spent': True, 'value': 11323375386, 'spending_outpoints': [{'tx_index': 3868231142653812, 'n': 1}], 'n': 0, 'tx_index': 5397084052107107, 'script': '76a914240e0c673eb6a0b194f9725beb93d58c2683996a88ac', 'addr': '14HeA1YRUiJGb95HVpVTBuavMUBYGk6y7R'}}, {'sequence': 4294967295, 'witness': '0247304402200de56672ba95900983de039afab57d0c3822ef7ade8bebdff38535ba1e69601e02201f8665b3801290ad5a7d6dda32fc40d2c738f01f9abecc66868f09f706b43bc60121024c242aa0ac1c76b48d7dd8dfbe038d9f7a88e2c09136ff4396f67946c7dca841', 'script': '', 'index': 2, 'prev_out': {'type': 0, 'spent': True, 'value': 24368794003, 'spending_outpoints': [{'tx_index': 3868231142653812, 'n': 2}], 'n': 1, 'tx_index': 763988164278003, 'script': '0014582824ffee2a60576a0b9a51dfa4aca15281e0c6', 'addr': 'bc1qtq5zfllw9fs9w6stnfgalf9v59fgrcxxyawuvm'}}, {'sequence': 4294967295, 'witness': '0247304402207840c24261736f8e1043a3d0494ea8af20fdcc4d5b287a9ba067e4d5025f25e302201774f78efe803ef03453f4ac0a9731d5e5a4c62c8fcdb1cb11a6ce6831ea97ac0121024c242aa0ac1c76b48d7dd8dfbe038d9f7a88e2c09136ff4396f67946c7dca841', 'script': '', 'index': 3, 'prev_out': {'type': 0, 'spent': True, 'value': 39402553766, 'spending_outpoints': [{'tx_index': 3868231142653812, 'n': 3}], 'n': 1, 'tx_index': 635847126907888, 'script': '0014582824ffee2a60576a0b9a51dfa4aca15281e0c6', 'addr': 'bc1qtq5zfllw9fs9w6stnfgalf9v59fgrcxxyawuvm'}}, {'sequence': 4294967295, 'witness': '02483045022100c6fdf67da2390391ff6e7bf7737e8e61449d55db2d447b7c22859115fee2a73a02205e7f8ee331ac3b0a309b7271a425ca403d312748891f49a06704155de5df149f0121024c242aa0ac1c76b48d7dd8dfbe038d9f7a88e2c09136ff4396f67946c7dca841', 'script': '', 'index': 4, 'prev_out': {'type': 0, 'spent': True, 'value': 39534700951, 'spending_outpoints': [{'tx_index': 3868231142653812, 'n': 4}], 'n': 1, 'tx_index': 5604400366002405, 'script': '0014582824ffee2a60576a0b9a51dfa4aca15281e0c6', 'addr': 'bc1qtq5zfllw9fs9w6stnfgalf9v59fgrcxxyawuvm'}}]","[{'type': 0, 'spent': False, 'value': 100000000000, 'spending_outpoints': [], 'n': 0, 'tx_index': 3868231142653812, 'script': 'a91429d930b97d58a3415c4a1e280e0e80f1d3e0a29487', 'addr': '35WHp4Hid61peyH4tuhNunwRj2gtNB41Lo'}, {'type': 0, 'spent': True, 'value': 21373212723, 'spending_outpoints': [{'tx_index': 4013958071355031, 'n': 0}], 'n': 1, 'tx_index': 3868231142653812, 'script': '0014582824ffee2a60576a0b9a51dfa4aca15281e0c6', 'addr': 'bc1qtq5zfllw9fs9w6stnfgalf9v59fgrcxxyawuvm'}]",100000000000,800001733182
bd1b93a2b23597b9f9ede7f98ea09d135bc6655aaa6fb9118e296d491e45da5f,1,6,2,965,1922,7196,0.0.0.0,0,3372514147904933,False,1654021348,738755.0,738755.0,"[{'sequence': 4294967295, 'witness': '024730440220390669e14c9392adad4868640daae0a01b55862c621833e4a5b05b048799546e0220629fed36562faf8be22316629f524bbd1d7e9b95a14906bdd4ce89a09bf858bb0121024c242aa0ac1c76b48d7dd8dfbe038d9f7a88e2c09136ff4396f67946c7dca841', 'script': '', 'index': 0, 'prev_out': {'type': 0, 'spent': True, 'value': 3643044991, 'spending_outpoints': [{'tx_index': 3372514147904933, 'n': 0}], 'n': 1, 'tx_index': 3026987984650610, 'script': '0014582824ffee2a60576a0b9a51dfa4aca15281e0c6', 'addr': 'bc1qtq5zfllw9fs9w6stnfgalf9v59fgrcxxyawuvm'}}, {'sequence': 4294967295, 'witness': '0247304402205fffb9eb2442b83301891094a6628c2358a5b141780abaa0905ba11cac056e2e022029b41bad18f8b2cb127914aed3654efb960459e54a2e3818328522516a054bea0121024c242aa0ac1c76b48d7dd8dfbe038d9f7a88e2c09136ff4396f67946c7dca841', 'script': '', 'index': 1, 'prev_out': {'type': 0, 'spent': True, 'value': 11354681031, 'spending_outpoints': [{'tx_index': 3372514147904933, 'n': 1}], 'n': 1, 'tx_index': 2635653761932702, 'script': '0014582824ffee2a60576a0b9a51dfa4aca15281e0c6', 'addr': 'bc1qtq5zfllw9fs9w6stnfgalf9v59fgrcxxyawuvm'}}, {'sequence': 4294967295, 'witness': '02483045022100cf3a707bc90630b45d271ff8594a7cbb8917c94b71e50987c64793608fd16fc102205f946c788afebd1c1f179235eddc025f8e366c4ce4ae157bb08ec947614ac71c0121024c242aa0ac1c76b48d7dd8dfbe038d9f7a88e2c09136ff4396f67946c7dca841', 'script': '', 'index': 2, 'prev_out': {'type': 0, 'spent': True, 'value': 34986337668, 'spending_outpoints': [{'tx_index': 3372514147904933, 'n': 2}], 'n': 1, 'tx_index': 4582808025627106, 'script': '0014582824ffee2a60576a0b9a51dfa4aca15281e0c6', 'addr': 'bc1qtq5zfllw9fs9w6stnfgalf9v59fgrcxxyawuvm'}}, {'sequence': 4294967295, 'witness': '02473044022059ff2f4cae68e5bf48e823ec9a416d21b5c504e140198bfd25b0c2141f5edc080220748f6e8fdcd87ff05717d4e38554f8c88f872f39ea5c14ee086517c1d0ad06df0121024c242aa0ac1c76b48d7dd8dfbe038d9f7a88e2c09136ff4396f67946c7dca841', 'script': '', 'index': 3, 'prev_out': {'type': 0, 'spent': True, 'value': 35483140601, 'spending_outpoints': [{'tx_index': 3372514147904933, 'n': 3}], 'n': 1, 'tx_index': 8166355674656137, 'script': '0014582824ffee2a60576a0b9a51dfa4aca15281e0c6', 'addr': 'bc1qtq5zfllw9fs9w6stnfgalf9v59fgrcxxyawuvm'}}, {'sequence': 4294967295, 'witness': '02483045022100bb38fa607ac3a7a5fb7ff67a7f38ced7b47e9c136f055fee18aaa6620391071c02202077877c5fed8e1118648af139ffbe97956bca1d70c169772adfe9d2461e59ca0121024c242aa0ac1c76b48d7dd8dfbe038d9f7a88e2c09136ff4396f67946c7dca841', 'script': '', 'index': 4, 'prev_out': {'type': 0, 'spent': True, 'value': 37799835779, 'spending_outpoints': [{'tx_index': 3372514147904933, 'n': 4}], 'n': 1, 'tx_index': 8802809942220105, 'script': '0014582824ffee2a60576a0b9a51dfa4aca15281e0c6', 'addr': 'bc1qtq5zfllw9fs9w6stnfgalf9v59fgrcxxyawuvm'}}, {'sequence': 4294967295, 'witness': '024730440220739fa07e273a85021d050bc299431175700bca9f4e7c09a5e0d4a5074eb63b0202200c627ae08c6f4e3502163c759adabb60916e0daaf7de20202f7695966270f11d0121024c242aa0ac1c76b48d7dd8dfbe038d9f7a88e2c09136ff4396f67946c7dca841', 'script': '', 'index': 5, 'prev_out': {'type': 0, 'spent': True, 'value': 38398856392, 'spending_outpoints': [{'tx_index': 3372514147904933, 'n': 5}], 'n': 1, 'tx_index': 1832148996009452, 'script': '0014582824ffee2a60576a0b9a51dfa4aca15281e0c6', 'addr': 'bc1qtq5zfllw9fs9w6stnfgalf9v59fgrcxxyawuvm'}}]","[{'type': 0, 'spent': False, 'value': 150000000000, 'spending_outpoints': [], 'n': 0, 'tx_index': 3372514147904933, 'script': 'a91429d930b97d58a3415c4a1e280e0e80f1d3e0a29487', 'addr': '35WHp4Hid61peyH4tuhNunwRj2gtNB41Lo'}, {'type': 0, 'spent': True, 'value': 11665889266, 'spending_outpoints': [{'tx_index': 5056598803628347, 'n': 0}], 'n': 1, 'tx_index': 3372514147904933, 'script': '0014582824ffee2a60576a0b9a51dfa4aca15281e0c6', 'addr': 'bc1qtq5zfllw9fs9w6stnfgalf9v59fgrcxxyawuvm'}]",150000000000,700001733182
af08a76d7b7e51f7478e89c956cbe5478f83775c5b0ee61a4b8251dba4da2b97,1,3,2,519,1107,2974,0.0.0.0,0,5318867444001328,False,1653955203,738644.0,738644.0,"[{'sequence': 4294967295, 'witness': '02473044022060fb93e00e719c08589fd0a0e5abb854145d4717df54847cceee0c016ef9ed9c02207c0a7dfaefee438057ed28d90d7fe06832b1cc20fb0dbe637293a27dc2579d040121024c242aa0ac1c76b48d7dd8dfbe038d9f7a88e2c09136ff4396f67946c7dca841', 'script': '', 'index': 0, 'prev_out': {'type': 0, 'spent': True, 'value': 8983994899, 'spending_outpoints': [{'tx_index': 5318867444001328, 'n': 0}], 'n': 1, 'tx_index': 2895440254903186, 'script': '0014582824ffee2a60576a0b9a51dfa4aca15281e0c6', 'addr': 'bc1qtq5zfllw9fs9w6stnfgalf9v59fgrcxxyawuvm'}}, {'sequence': 4294967295, 'witness': '02473044022009d88d8ab533b22fb006153ac5390a643942ef1b28cb1e37d69ca2f510d7dc2f0220620177a18b22adb2ecffb9bb873ba44297980c14535d83e77bf5a6c1d36336110121024c242aa0ac1c76b48d7dd8dfbe038d9f7a88e2c09136ff4396f67946c7dca841', 'script': '', 'index': 1, 'prev_out': {'type': 0, 'spent': True, 'value': 27977280615, 'spending_outpoints': [{'tx_index': 5318867444001328, 'n': 1}], 'n': 1, 'tx_index': 7340020928822232, 'script': '0014582824ffee2a60576a0b9a51dfa4aca15281e0c6', 'addr': 'bc1qtq5zfllw9fs9w6stnfgalf9v59fgrcxxyawuvm'}}, {'sequence': 4294967295, 'witness': '0247304402206673a622f0b18d0488aeb4dfcd7ca29570ccfc9048b06574b0a61a386ee71c78022068eec2ea22775cb9d7fbf3f0de5f3b8aa2dde67f4a76825dd01f430d4f8de7550121024c242aa0ac1c76b48d7dd8dfbe038d9f7a88e2c09136ff4396f67946c7dca841', 'script': '', 'index': 2, 'prev_out': {'type': 0, 'spent': True, 'value': 28939754129, 'spending_outpoints': [{'tx_index': 5318867444001328, 'n': 2}], 'n': 1, 'tx_index': 6609837787621154, 'script': '0014582824ffee2a60576a0b9a51dfa4aca15281e0c6', 'addr': 'bc1qtq5zfllw9fs9w6stnfgalf9v59fgrcxxyawuvm'}}]","[{'type': 0, 'spent': False, 'value': 50000000000, 'spending_outpoints': [], 'n': 0, 'tx_index': 5318867444001328, 'script': 'a91429d930b97d58a3415c4a1e280e0e80f1d3e0a29487', 'addr': '35WHp4Hid61peyH4tuhNunwRj2gtNB41Lo'}, {'type': 0, 'spent': True, 'value': 15901026669, 'spending_outpoints': [{'tx_index': 3026987984650610, 'n': 2}], 'n': 1, 'tx_index': 5318867444001328, 'script': '0014582824ffee2a60576a0b9a51dfa4aca15281e0c6', 'addr': 'bc1qtq5zfllw9fs9w6stnfgalf9v59fgrcxxyawuvm'}]",50000000000,550001733182
da286bf20e516b8d59ea389e32d776d2cd142e0240242213cb804c42f995d395,1,3,2,521,1109,3888,0.0.0.0,0,5271551576918416,False,1653924082,738593.0,738593.0,"[{'sequence': 4294967295, 'witness': '024830450221008d88efd8694befb946af249f748446538f05fd63609d418f11cd7b34480f351502206f41218dfb584f35ebb19787f1491776f1f96eb65923092c4d01811bff4618c70121024c242aa0ac1c76b48d7dd8dfbe038d9f7a88e2c09136ff4396f67946c7dca841', 'script': '', 'index': 0, 'prev_out': {'type': 0, 'spent': True, 'value': 7742505576, 'spending_outpoints': [{'tx_index': 5271551576918416, 'n': 0}], 'n': 1, 'tx_index': 7280621894978713, 'script': '0014582824ffee2a60576a0b9a51dfa4aca15281e0c6', 'addr': 'bc1qtq5zfllw9fs9w6stnfgalf9v59fgrcxxyawuvm'}}, {'sequence': 4294967295, 'witness': '0248304502210088965076eee2275fd86999ad9996ac459732eec74fd07fff9308c5c22bf89a8c022001c866d4b2a9429ee713daa5f53a8cd6121aa1fe9adf646cced36c096352f6fa0121024c242aa0ac1c76b48d7dd8dfbe038d9f7a88e2c09136ff4396f67946c7dca841', 'script': '', 'index': 1, 'prev_out': {'type': 0, 'spent': True, 'value': 9187319123, 'spending_outpoints': [{'tx_index': 5271551576918416, 'n': 1}], 'n': 1, 'tx_index': 5120112959946257, 'script': '0014582824ffee2a60576a0b9a51dfa4aca15281e0c6', 'addr': 'bc1qtq5zfllw9fs9w6stnfgalf9v59fgrcxxyawuvm'}}, {'sequence': 4294967295, 'witness': '0247304402204664f9cb7d7dfba8005df52e44ee6738b4773d28f1bfd122559f49efa94b6c8402204ac1fb89856235d6c3d009304c2e7bb8c727d93aa850e7cc459322cce1cd87510121024c242aa0ac1c76b48d7dd8dfbe038d9f7a88e2c09136ff4396f67946c7dca841', 'script': '', 'index': 2, 'prev_out': {'type': 0, 'spent': True, 'value': 22754175839, 'spending_outpoints': [{'tx_index': 5271551576918416, 'n': 2}], 'n': 1, 'tx_index': 4803869759476853, 'script': '0014582824ffee2a60576a0b9a51dfa4aca15281e0c6', 'addr': 'bc1qtq5zfllw9fs9w6stnfgalf9v59fgrcxxyawuvm'}}]","[{'type': 0, 'spent': False, 'value': 30000000000, 'spending_outpoints': [], 'n': 0, 'tx_index': 5271551576918416, 'script': 'a91429d930b97d58a3415c4a1e280e0e80f1d3e0a29487', 'addr': '35WHp4Hid61peyH4tuhNunwRj2gtNB41Lo'}, {'type': 0, 'spent': True, 'value': 9683996650, 'spending_outpoints': [{'tx_index': 2895440254903186, 'n': 0}], 'n': 1, 'tx_index': 5271551576918416, 'script': '0014582824ffee2a60576a0b9a51dfa4aca15281e0c6', 'addr': 'bc1qtq5zfllw9fs9w6stnfgalf9v59fgrcxxyawuvm'}]",30000000000,500001733182
d93e697a34bf4c2dff85422444d38450c801d2ffbd85c2d64caba37cb4c08888,1,14,2,2153,4094,12877,0.0.0.0,0,4803869759476853,False,1653917033,738579.0,738579.0,"[{'sequence': 4294967295, 'witness': '024730440220113b647ca27da213ca626b85ad122e64cc69792fe05cb019f93a9c0d63eb7ebf022061a46a6efa7af065f952ba9a2d8b5130e17bd5f27b2e0475dcc133a72f51f1870121024c242aa0ac1c76b48d7dd8dfbe038d9f7a88e2c09136ff4396f67946c7dca841', 'script': '', 'index': 0, 'prev_out': {'type': 0, 'spent': True, 'value': 11196576354, 'spending_outpoints': [{'tx_index': 4803869759476853, 'n': 0}], 'n': 1, 'tx_index': 7453295014002596, 'script': '0014582824ffee2a60576a0b9a51dfa4aca15281e0c6', 'addr': 'bc1qtq5zfllw9fs9w6stnfgalf9v59fgrcxxyawuvm'}}, {'sequence': 4294967295, 'witness': '02483045022100fd21a66c13984c9009cca5bd2efb8383c3bba365f68fa27c2d7da9ebefa6f35102200f56dfb300decf7a1bf97bb3eaedc0ab916f9a7fb02bd5ff35c5f3a3d0f2cb110121024c242aa0ac1c76b48d7dd8dfbe038d9f7a88e2c09136ff4396f67946c7dca841', 'script': '', 'index': 1, 'prev_out': {'type': 0, 'spent': True, 'value': 11211901707, 'spending_outpoints': [{'tx_index': 4803869759476853, 'n': 1}], 'n': 1, 'tx_index': 7955647433420433, 'script': '0014582824ffee2a60576a0b9a51dfa4aca15281e0c6', 'addr': 'bc1qtq5zfllw9fs9w6stnfgalf9v59fgrcxxyawuvm'}}, {'sequence': 4294967295, 'witness': '02473044022038390a76c99c8fb90d5dcdf318ca915d0a097ea89e6387f67a5f6539518a11b6022044cd8b2621352e90c21962c1e1b71fd893e94db5d744512f37d3fa185c58d3ed0121024c242aa0ac1c76b48d7dd8dfbe038d9f7a88e2c09136ff4396f67946c7dca841', 'script': '', 'index': 2, 'prev_out': {'type': 0, 'spent': True, 'value': 11292609401, 'spending_outpoints': [{'tx_index': 4803869759476853, 'n': 2}], 'n': 1, 'tx_index': 4964396067181777, 'script': '0014582824ffee2a60576a0b9a51dfa4aca15281e0c6', 'addr': 'bc1qtq5zfllw9fs9w6stnfgalf9v59fgrcxxyawuvm'}}, {'sequence': 4294967295, 'witness': '0247304402206b53b8411dd47e23c863c6a606d78fe2baa8805f9b0a365411dc17a76e2069c7022050bbf6999205a78c750b3eb28e25a9f7c2cc7826d3ce3ba34481369e1e440ae10121024c242aa0ac1c76b48d7dd8dfbe038d9f7a88e2c09136ff4396f67946c7dca841', 'script': '', 'index': 3, 'prev_out': {'type': 0, 'spent': True, 'value': 11344920860, 'spending_outpoints': [{'tx_index': 4803869759476853, 'n': 3}], 'n': 1, 'tx_index': 4510642433880866, 'script': '0014582824ffee2a60576a0b9a51dfa4aca15281e0c6', 'addr': 'bc1qtq5zfllw9fs9w6stnfgalf9v59fgrcxxyawuvm'}}, {'sequence': 4294967295, 'witness': '02483045022100b9b09c321d4cb6be637c94ae07714c946031f79c86543abb64c7790a77a5c53002202b62c21b1ee8ea6dc4490aa237f0d8338f4c97bdb33d5f9ad7de32e52e6384ce0121024c242aa0ac1c76b48d7dd8dfbe038d9f7a88e2c09136ff4396f67946c7dca841', 'script': '', 'index': 4, 'prev_out': {'type': 0, 'spent': True, 'value': 12758909864, 'spending_outpoints': [{'tx_index': 4803869759476853, 'n': 4}], 'n': 1, 'tx_index': 6207623999930534, 'script': '0014582824ffee2a60576a0b9a51dfa4aca15281e0c6', 'addr': 'bc1qtq5zfllw9fs9w6stnfgalf9v59fgrcxxyawuvm'}}, {'sequence': 4294967295, 'witness': '024730440220743ca9a8b1ba043b11e1f6dec428dee0b973103dd1b591fc5387406394eb23a402204b255fec55fed2118c2078e4fc7c5b056dc70dfc0e7fec954a0707bba61537d50121024c242aa0ac1c76b48d7dd8dfbe038d9f7a88e2c09136ff4396f67946c7dca841', 'script': '', 'index': 5, 'prev_out': {'type': 0, 'spent': True, 'value': 13674777802, 'spending_outpoints': [{'tx_index': 4803869759476853, 'n': 5}], 'n': 1, 'tx_index': 6576588594214752, 'script': '0014582824ffee2a60576a0b9a51dfa4aca15281e0c6', 'addr': 'bc1qtq5zfllw9fs9w6stnfgalf9v59fgrcxxyawuvm'}}, {'sequence': 4294967295, 'witness': '0247304402202c6fe08a8744ec988f147d3dcf2b814f09bbbdca6b6e74cb9052f88cb28ad07f02207d9f32117917114dcab2aeb9106b22037ef63994b8ce7b849b7b2460a684505b0121024c242aa0ac1c76b48d7dd8dfbe038d9f7a88e2c09136ff4396f67946c7dca841', 'script': '', 'index': 6, 'prev_out': {'type': 0, 'spent': True, 'value': 14744197794, 'spending_outpoints': [{'tx_index': 4803869759476853, 'n': 6}], 'n': 1, 'tx_index': 414405373571381, 'script': '0014582824ffee2a60576a0b9a51dfa4aca15281e0c6', 'addr': 'bc1qtq5zfllw9fs9w6stnfgalf9v59fgrcxxyawuvm'}}, {'sequence': 4294967295, 'witness': '0247304402205fb231803bbbaee4a7b5520e375969a4ddf2d2d952c9c63c0e95a6e19f195c0e02202056a2536d0db7aa11c416c05355029e509fa3acf9ae8194a92da7229e507c670121024c242aa0ac1c76b48d7dd8dfbe038d9f7a88e2c09136ff4396f67946c7dca841', 'script': '', 'index': 7, 'prev_out': {'type': 0, 'spent': True, 'value': 15668773029, 'spending_outpoints': [{'tx_index': 4803869759476853, 'n': 7}], 'n': 1, 'tx_index': 8394692571612158, 'script': '0014582824ffee2a60576a0b9a51dfa4aca15281e0c6', 'addr': 'bc1qtq5zfllw9fs9w6stnfgalf9v59fgrcxxyawuvm'}}, {'sequence': 4294967295, 'witness': '0248304502210098205f673cca697a1894a94414f3d768df195117f5ba6b6d873b5a9ee3c2cdee02204c7058138aaf99e6e681425d5bb44021120a515067bc9470b90ab184c47c52d70121024c242aa0ac1c76b48d7dd8dfbe038d9f7a88e2c09136ff4396f67946c7dca841', 'script': '', 'index': 8, 'prev_out': {'type': 0, 'spent': True, 'value': 16314454640, 'spending_outpoints': [{'tx_index': 4803869759476853, 'n': 8}], 'n': 1, 'tx_index': 6495062656366684, 'script': '0014582824ffee2a60576a0b9a51dfa4aca15281e0c6', 'addr': 'bc1qtq5zfllw9fs9w6stnfgalf9v59fgrcxxyawuvm'}}, {'sequence': 4294967295, 'witness': '02483045022100e3904a44b574558f5a83d1d838b0a1551885bfaa983f654a2953a932069a9b7e022048591998a4652755c7424c53d771bbd1c88239fb03bd6dd423a4d76775f813950121024c242aa0ac1c76b48d7dd8dfbe038d9f7a88e2c09136ff4396f67946c7dca841', 'script': '', 'index': 9, 'prev_out': {'type': 0, 'spent': True, 'value': 16768620753, 'spending_outpoints': [{'tx_index': 4803869759476853, 'n': 9}], 'n': 1, 'tx_index': 359605735302382, 'script': '0014582824ffee2a60576a0b9a51dfa4aca15281e0c6', 'addr': 'bc1qtq5zfllw9fs9w6stnfgalf9v59fgrcxxyawuvm'}}, {'sequence': 4294967295, 'witness': '02483045022100c17fd0c46ca8e10204331f9015c93ddafea9a8da31ec324b05fb29c3f0048edb02206e29d7873c7e15ad7e13beac2c9a3eca617ff32574bea789f54a464745fb87ab0121024c242aa0ac1c76b48d7dd8dfbe038d9f7a88e2c09136ff4396f67946c7dca841', 'script': '', 'index': 10, 'prev_out': {'type': 0, 'spent': True, 'value': 18630079750, 'spending_outpoints': [{'tx_index': 4803869759476853, 'n': 10}], 'n': 1, 'tx_index': 6765436981108547, 'script': '0014582824ffee2a60576a0b9a51dfa4aca15281e0c6', 'addr': 'bc1qtq5zfllw9fs9w6stnfgalf9v59fgrcxxyawuvm'}}, {'sequence': 4294967295, 'witness': '02483045022100f24b4a070a974da1b88f78a2891a4b99c8f929699ab9c9c0ce7d9676657e6162022029fa4349dd55cc60c2f41dd966674aee386ff2e2f0f8e1050d405801aaa3c01f0121024c242aa0ac1c76b48d7dd8dfbe038d9f7a88e2c09136ff4396f67946c7dca841', 'script': '', 'index': 11, 'prev_out': {'type': 0, 'spent': True, 'value': 21096209149, 'spending_outpoints': [{'tx_index': 4803869759476853, 'n': 11}], 'n': 1, 'tx_index': 3512205130367442, 'script': '0014582824ffee2a60576a0b9a51dfa4aca15281e0c6', 'addr': 'bc1qtq5zfllw9fs9w6stnfgalf9v59fgrcxxyawuvm'}}, {'sequence': 4294967295, 'witness': '0247304402202be8512959942a019b537113a1f1eefe1131f1243a5c75565b7d1db0950fda78022046d20f74f4c0956ef1d291b1d79dc6f2db1e52834936e5be500a36b485892a0f0121024c242aa0ac1c76b48d7dd8dfbe038d9f7a88e2c09136ff4396f67946c7dca841', 'script': '', 'index': 12, 'prev_out': {'type': 0, 'spent': True, 'value': 22835522579, 'spending_outpoints': [{'tx_index': 4803869759476853, 'n': 12}], 'n': 1, 'tx_index': 6081889110099095, 'script': '0014582824ffee2a60576a0b9a51dfa4aca15281e0c6', 'addr': 'bc1qtq5zfllw9fs9w6stnfgalf9v59fgrcxxyawuvm'}}, {'sequence': 4294967295, 'witness': '0247304402202e138a800db1d0e4414901a575c126e53949788e02edfb78d5e79ac04cae74d70220729bac1c884d5f4c71315b1e373671ac774ebe9664d8838758bb7dcf07798d300121024c242aa0ac1c76b48d7dd8dfbe038d9f7a88e2c09136ff4396f67946c7dca841', 'script': '', 'index': 13, 'prev_out': {'type': 0, 'spent': True, 'value': 25216635034, 'spending_outpoints': [{'tx_index': 4803869759476853, 'n': 13}], 'n': 1, 'tx_index': 1421041770450743, 'script': '0014582824ffee2a60576a0b9a51dfa4aca15281e0c6', 'addr': 'bc1qtq5zfllw9fs9w6stnfgalf9v59fgrcxxyawuvm'}}]","[{'type': 0, 'spent': False, 'value': 200000000000, 'spending_outpoints': [], 'n': 0, 'tx_index': 4803869759476853, 'script': 'a91429d930b97d58a3415c4a1e280e0e80f1d3e0a29487', 'addr': '35WHp4Hid61peyH4tuhNunwRj2gtNB41Lo'}, {'type': 0, 'spent': True, 'value': 22754175839, 'spending_outpoints': [{'tx_index': 5271551576918416, 'n': 2}], 'n': 1, 'tx_index': 4803869759476853, 'script': '0014582824ffee2a60576a0b9a51dfa4aca15281e0c6', 'addr': 'bc1qtq5zfllw9fs9w6stnfgalf9v59fgrcxxyawuvm'}]",200000000000,470001733182
bc197f53ba0d926a64f9d9223da23b9797641095d702a2c713cb645a0e7fedce,1,3,2,521,1109,3497,0.0.0.0,0,7280621894978713,False,1653916853,738579.0,738579.0,"[{'sequence': 4294967295, 'witness': '02473044022001d37f5c8e91d51145999cfe7a38a277e341e1fa097e03207214851795db1c8202202f9f66a322275117756bd3afdd7ac4ad6ab28e96b5b7ce0a488f51c6ee0aec2e0121024c242aa0ac1c76b48d7dd8dfbe038d9f7a88e2c09136ff4396f67946c7dca841', 'script': '', 'index': 0, 'prev_out': {'type': 0, 'spent': True, 'value': 10724424792, 'spending_outpoints': [{'tx_index': 7280621894978713, 'n': 0}], 'n': 1, 'tx_index': 5458398922212998, 'script': '0014582824ffee2a60576a0b9a51dfa4aca15281e0c6', 'addr': 'bc1qtq5zfllw9fs9w6stnfgalf9v59fgrcxxyawuvm'}}, {'sequence': 4294967295, 'witness': '02483045022100f7798852cfee90b0976f756deec6d9578d2207838dd979fa652520d172e6b4ba022042f0baee0edebf6b835db890168c1705e139682ef91c7390bf67f1b93993ddbd0121024c242aa0ac1c76b48d7dd8dfbe038d9f7a88e2c09136ff4396f67946c7dca841', 'script': '', 'index': 1, 'prev_out': {'type': 0, 'spent': True, 'value': 10906925344, 'spending_outpoints': [{'tx_index': 7280621894978713, 'n': 1}], 'n': 1, 'tx_index': 7644623070145069, 'script': '0014582824ffee2a60576a0b9a51dfa4aca15281e0c6', 'addr': 'bc1qtq5zfllw9fs9w6stnfgalf9v59fgrcxxyawuvm'}}, {'sequence': 4294967295, 'witness': '024830450221009f24ab1354cb30ca6b1006731905d08945897d60583273d8876de7a5da5b08ac02200f2683ddad5ecc87e9302eb4011ed5e950e2a0a22528898998fe5b8eeae0a5560121024c242aa0ac1c76b48d7dd8dfbe038d9f7a88e2c09136ff4396f67946c7dca841', 'script': '', 'index': 2, 'prev_out': {'type': 0, 'spent': True, 'value': 11111158937, 'spending_outpoints': [{'tx_index': 7280621894978713, 'n': 2}], 'n': 1, 'tx_index': 6382465049105480, 'script': '0014582824ffee2a60576a0b9a51dfa4aca15281e0c6', 'addr': 'bc1qtq5zfllw9fs9w6stnfgalf9v59fgrcxxyawuvm'}}]","[{'type': 0, 'spent': True, 'value': 25000000000, 'spending_outpoints': [{'tx_index': 2953138178421836, 'n': 0}], 'n': 0, 'tx_index': 7280621894978713, 'script': 'a91429d930b97d58a3415c4a1e280e0e80f1d3e0a29487', 'addr': '35WHp4Hid61peyH4tuhNunwRj2gtNB41Lo'}, {'type': 0, 'spent': True, 'value': 7742505576, 'spending_outpoints': [{'tx_index': 5271551576918416, 'n': 0}], 'n': 1, 'tx_index': 7280621894978713, 'script': '0014582824ffee2a60576a0b9a51dfa4aca15281e0c6', 'addr': 'bc1qtq5zfllw9fs9w6stnfgalf9v59fgrcxxyawuvm'}]",25000000000,270001733182
8b5187912292975dc74f2a4d4e2bfd1ea28823947415f4c89c8bf07f91b98591,1,8,2,1265,2786,9567,0.0.0.0,0,5120112959946257,False,1653916665,738579.0,738579.0,"[{'sequence': 4294967295, 'witness': '', 'script': '47304402206fbeb9c57989031f386df87d66f0cc8a3bf9632995d634e94fdc470c6cee83d502202c3bd2d4fb99347877d4adba76cb227e98151854a65032db512122456d24a999012102eba303b19783d159b5661770cf7f987f4e53f3f916f65d9bc1b40a7f3e0e9a5b', 'index': 0, 'prev_out': {'type': 0, 'spent': True, 'value': 5752843873, 'spending_outpoints': [{'tx_index': 5120112959946257, 'n': 0}], 'n': 0, 'tx_index': 8784528789241708, 'script': '76a914240e0c673eb6a0b194f9725beb93d58c2683996a88ac', 'addr': '14HeA1YRUiJGb95HVpVTBuavMUBYGk6y7R'}}, {'sequence': 4294967295, 'witness': '02483045022100ecaceee826fea6f295bf92b7e03a15c89978e4dd2aa01873549c2c188ce769670220689af6ce23da0e24bfadb8dd37c33f5232cffe01b5a9dcc31ebf423c965334090121024c242aa0ac1c76b48d7dd8dfbe038d9f7a88e2c09136ff4396f67946c7dca841', 'script': '', 'index': 1, 'prev_out': {'type': 0, 'spent': True, 'value': 5239974059, 'spending_outpoints': [{'tx_index': 5120112959946257, 'n': 1}], 'n': 1, 'tx_index': 2360767005342287, 'script': '0014582824ffee2a60576a0b9a51dfa4aca15281e0c6', 'addr': 'bc1qtq5zfllw9fs9w6stnfgalf9v59fgrcxxyawuvm'}}, {'sequence': 4294967295, 'witness': '02483045022100973136d8bde6f1ee3d99b6a7ca643b32338badb426d2a431572a905f37bad751022062ea9045b681fc729229acaf0fee98da3b8998c0089bf622b9ed4ea69a9dbb9e0121024c242aa0ac1c76b48d7dd8dfbe038d9f7a88e2c09136ff4396f67946c7dca841', 'script': '', 'index': 2, 'prev_out': {'type': 0, 'spent': True, 'value': 5494146965, 'spending_outpoints': [{'tx_index': 5120112959946257, 'n': 2}], 'n': 1, 'tx_index': 1627358882080898, 'script': '0014582824ffee2a60576a0b9a51dfa4aca15281e0c6', 'addr': 'bc1qtq5zfllw9fs9w6stnfgalf9v59fgrcxxyawuvm'}}, {'sequence': 4294967295, 'witness': '02483045022100c4562f04b93533558081042c89208617f52ca4facb234bb5298079ede87398ee02207ade2fde01da458d872a4e8b169d5a5409ac03937a8fb3e2796ef1d25e9161120121024c242aa0ac1c76b48d7dd8dfbe038d9f7a88e2c09136ff4396f67946c7dca841', 'script': '', 'index': 3, 'prev_out': {'type': 0, 'spent': True, 'value': 5834900906, 'spending_outpoints': [{'tx_index': 5120112959946257, 'n': 3}], 'n': 1, 'tx_index': 116999565699565, 'script': '0014582824ffee2a60576a0b9a51dfa4aca15281e0c6', 'addr': 'bc1qtq5zfllw9fs9w6stnfgalf9v59fgrcxxyawuvm'}}, {'sequence': 4294967295, 'witness': '02483045022100fffe967265dd6b6a39781f3f79e1d3ee7086d7acbe6b422266f3eff1117ecf7702203235bc27b2703a6893810afa330846e0001526ffbb4f394913768fec678c28880121024c242aa0ac1c76b48d7dd8dfbe038d9f7a88e2c09136ff4396f67946c7dca841', 'script': '', 'index': 4, 'prev_out': {'type': 0, 'spent': True, 'value': 6321068858, 'spending_outpoints': [{'tx_index': 5120112959946257, 'n': 4}], 'n': 1, 'tx_index': 7226086555752464, 'script': '0014582824ffee2a60576a0b9a51dfa4aca15281e0c6', 'addr': 'bc1qtq5zfllw9fs9w6stnfgalf9v59fgrcxxyawuvm'}}, {'sequence': 4294967295, 'witness': '02483045022100f35a83ba05715014b7361ba5d195f57de756b6d3611cdddde35b8b364bb63dcb022005406b177d7b84ca909aa8e76429c51fd604fd2d5213f076ad6718bf21bcb0980121024c242aa0ac1c76b48d7dd8dfbe038d9f7a88e2c09136ff4396f67946c7dca841', 'script': '', 'index': 5, 'prev_out': {'type': 0, 'spent': True, 'value': 9824188425, 'spending_outpoints': [{'tx_index': 5120112959946257, 'n': 5}], 'n': 1, 'tx_index': 8797859323194478, 'script': '0014582824ffee2a60576a0b9a51dfa4aca15281e0c6', 'addr': 'bc1qtq5zfllw9fs9w6stnfgalf9v59fgrcxxyawuvm'}}, {'sequence': 4294967295, 'witness': '02483045022100c3ec77943626a9df3cb5d561d2cfc48c4d5d5062ff88f88faf9bceade452340a02206b7ece9263c8377cff585be58e88a964c521485d38a3324f13b77816a2d46fd60121024c242aa0ac1c76b48d7dd8dfbe038d9f7a88e2c09136ff4396f67946c7dca841', 'script': '', 'index': 6, 'prev_out': {'type': 0, 'spent': True, 'value': 10018362295, 'spending_outpoints': [{'tx_index': 5120112959946257, 'n': 6}], 'n': 1, 'tx_index': 5846984995509052, 'script': '0014582824ffee2a60576a0b9a51dfa4aca15281e0c6', 'addr': 'bc1qtq5zfllw9fs9w6stnfgalf9v59fgrcxxyawuvm'}}, {'sequence': 4294967295, 'witness': '0247304402200effb7299cedf1a7b3f42182f0c2bf1d94cf6a3f825e2c8002589d8c692196d902200904b15da9d7d113f9630abad7b594584fdbf4fc30219c7c61d6f17a4b2f74150121024c242aa0ac1c76b48d7dd8dfbe038d9f7a88e2c09136ff4396f67946c7dca841', 'script': '', 'index': 7, 'prev_out': {'type': 0, 'spent': True, 'value': 10701843309, 'spending_outpoints': [{'tx_index': 5120112959946257, 'n': 7}], 'n': 1, 'tx_index': 7693814504679841, 'script': '0014582824ffee2a60576a0b9a51dfa4aca15281e0c6', 'addr': 'bc1qtq5zfllw9fs9w6stnfgalf9v59fgrcxxyawuvm'}}]","[{'type': 0, 'spent': False, 'value': 50000000000, 'spending_outpoints': [], 'n': 0, 'tx_index': 5120112959946257, 'script': 'a91429d930b97d58a3415c4a1e280e0e80f1d3e0a29487', 'addr': '35WHp4Hid61peyH4tuhNunwRj2gtNB41Lo'}, {'type': 0, 'spent': True, 'value': 9187319123, 'spending_outpoints': [{'tx_index': 5271551576918416, 'n': 1}], 'n': 1, 'tx_index': 5120112959946257, 'script': '0014582824ffee2a60576a0b9a51dfa4aca15281e0c6', 'addr': 'bc1qtq5zfllw9fs9w6stnfgalf9v59fgrcxxyawuvm'}]",50000000000,245001733182
226030edafa314b9d41c99cc8e6d5f98711ebce5e425f0b6778ca6de40bc188d,1,3,2,516,2064,6878,0.0.0.0,0,4964396067181777,False,1653865336,738486.0,738486.0,"[{'sequence': 4294967295, 'witness': '', 'script': '4830450221008157b719faaa8aa87863d10c2595f7b57cf7319ab73b8520147d9c7a4c31712502200f28f719d748302e5aff21337a57e69f20ade48b9411316184001a58ac679fb3012102eba303b19783d159b5661770cf7f987f4e53f3f916f65d9bc1b40a7f3e0e9a5b', 'index': 0, 'prev_out': {'type': 0, 'spent': True, 'value': 7477433460, 'spending_outpoints': [{'tx_index': 4964396067181777, 'n': 0}], 'n': 2, 'tx_index': 4262400864916101, 'script': '76a914240e0c673eb6a0b194f9725beb93d58c2683996a88ac', 'addr': '14HeA1YRUiJGb95HVpVTBuavMUBYGk6y7R'}}, {'sequence': 4294967295, 'witness': '', 'script': '47304402203def9eb383af8a32b00c5c6205c11d7adc3deb276c8b5c5669c2918410ae6bc2022064f1745bb73fe3a92e04e02263f679ffe79c8b6b4a3a327adbb6871ed6bcaa22012102eba303b19783d159b5661770cf7f987f4e53f3f916f65d9bc1b40a7f3e0e9a5b', 'index': 1, 'prev_out': {'type': 0, 'spent': True, 'value': 7943396479, 'spending_outpoints': [{'tx_index': 4964396067181777, 'n': 1}], 'n': 0, 'tx_index': 4906133625388705, 'script': '76a914240e0c673eb6a0b194f9725beb93d58c2683996a88ac', 'addr': '14HeA1YRUiJGb95HVpVTBuavMUBYGk6y7R'}}, {'sequence': 4294967295, 'witness': '', 'script': '483045022100f9f3a378659cf2f171087e8d457f8fc30bf54e1cb516d6990d7f205f836f047b02204d6a282870e1ffb0a7766a65b9c44e2b845ce43501e63a7dbd0f6acc1dd2073e012102eba303b19783d159b5661770cf7f987f4e53f3f916f65d9bc1b40a7f3e0e9a5b', 'index': 2, 'prev_out': {'type': 0, 'spent': True, 'value': 20871786340, 'spending_outpoints': [{'tx_index': 4964396067181777, 'n': 2}], 'n': 0, 'tx_index': 1309505165228186, 'script': '76a914240e0c673eb6a0b194f9725beb93d58c2683996a88ac', 'addr': '14HeA1YRUiJGb95HVpVTBuavMUBYGk6y7R'}}]","[{'type': 0, 'spent': False, 'value': 25000000000, 'spending_outpoints': [], 'n': 0, 'tx_index': 4964396067181777, 'script': 'a91429d930b97d58a3415c4a1e280e0e80f1d3e0a29487', 'addr': '35WHp4Hid61peyH4tuhNunwRj2gtNB41Lo'}, {'type': 0, 'spent': True, 'value': 11292609401, 'spending_outpoints': [{'tx_index': 4803869759476853, 'n': 2}], 'n': 1, 'tx_index': 4964396067181777, 'script': '0014582824ffee2a60576a0b9a51dfa4aca15281e0c6', 'addr': 'bc1qtq5zfllw9fs9w6stnfgalf9v59fgrcxxyawuvm'}]",25000000000,195001733182
da3de81c01479fbbeb6bee7f8bd32ed4eb55d953b7cce952002266fdbd637962,2,7,1,1853,7412,29606,0.0.0.0,735067,3464752126733508,False,1652090011,735597.0,735597.0,"[{'sequence': 4294967293, 'witness': '', 'script': '00483045022100ef6bcc29110f9c2f6da433e98606bca2d416f717ab5154e26643206af2552b4e02205babe60237a7a758f141459a7760e712fec7b7ffffc8abe491d1b534dda3a6df014830450221009eedce8c8ff33f58d7b8372facd931bce64f6c12fa49ed40770163677e6465e50220548f3b2d811bc59de8ca48a6bfe2d6164f0e5d7004cd78ee9b1ce06112c451d5014752210303446aca70735cf2bc1b2d50da9345b30089ae86d7dcc353bf378d5415fcfda42103586082d6f037282e5beecd4f52693ffad2c92d46662fff0739896d9f49cf48de52ae', 'index': 0, 'prev_out': {'type': 0, 'spent': True, 'value': 64999740600, 'spending_outpoints': [{'tx_index': 3464752126733508, 'n': 0}], 'n': 1, 'tx_index': 7691795671633285, 'script': 'a9144788f225b8ec7a59432b4f28b61ccd3c67ea446b87', 'addr': '38DFxL9AhRfWe4xrVrjMTMVp5YQkQ6Gx4F'}}, {'sequence': 4294967293, 'witness': '', 'script': '0047304402203aa4f14f1148f74fd033f5424f22d2ef9f8c213d381db051a64cc2d5c9b229ab022057b67f470a63667932e1a7b648cca5f29738ced00b1c4bc7f22c35f76b7f85dd014830450221009ddd4868f4b68180c5cfc8e660a0b236056244613ac2dd5b6b0fded6b45dc39b02201e198462a083335f0d6b5d1ab18bf462dfa89eb7b7e717fb7e785d6c7256d50c014752210303446aca70735cf2bc1b2d50da9345b30089ae86d7dcc353bf378d5415fcfda42103586082d6f037282e5beecd4f52693ffad2c92d46662fff0739896d9f49cf48de52ae', 'index': 1, 'prev_out': {'type': 0, 'spent': True, 'value': 547, 'spending_outpoints': [{'tx_index': 3464752126733508, 'n': 1}], 'n': 159, 'tx_index': 8341612247994237, 'script': 'a9144788f225b8ec7a59432b4f28b61ccd3c67ea446b87', 'addr': '38DFxL9AhRfWe4xrVrjMTMVp5YQkQ6Gx4F'}}, {'sequence': 4294967293, 'witness': '', 'script': '00473044022027a8f1681caf872bd79ffc8b60331d58fdead3397c6ccbc6396b05d960f4353c022048e9e3c0510fdec592c3d0d2bb4a25e81e8833f132f06ab9e03a3f19c8af8bb401483045022100c29186e101911a0a6d7258829a721aec0251a2a029d66376eb2627c361c4bab402200ce0110ca6cca5d3c3c6dccf7bcdc4d311ae2b7f161530125def48f512e6fbe601475221030f248f6a42b5d75c6f5f6bd2e9a5964882701aad6f39f0f431dd06e1c2872eb0210372e63d7573943fce0fdfac8ffc3c34f13562a5a6c86b75567b198de8b5a11ae752ae', 'index': 2, 'prev_out': {'type': 0, 'spent': True, 'value': 104899313400, 'spending_outpoints': [{'tx_index': 3464752126733508, 'n': 2}], 'n': 0, 'tx_index': 7966047112174366, 'script': 'a914804929555229ec14228fa98cc3d1fa8786a8d70387', 'addr': '3DPL4SnASNPuvWTNdSY7S2v9rWGDiW9QPQ'}}, {'sequence': 4294967293, 'witness': '', 'script': '0047304402205e258580b1b8e1d2244af8e04245d6e169385682b3395da7b58dbb82fa584291022014e28f92a102d05be8bfb166c2a68fe2e18fa72e92bbc5a1e262e139f18a49080147304402203091d51c8cc1e3ecc9f694b78df47b9d767a059759231aa5debeb32c9252a91c0220649fc882a5fefe1fcb583b6e8bb667f58db4b5d395e05dac5b7d3c6638a7d18a014752210303446aca70735cf2bc1b2d50da9345b30089ae86d7dcc353bf378d5415fcfda42103586082d6f037282e5beecd4f52693ffad2c92d46662fff0739896d9f49cf48de52ae', 'index': 3, 'prev_out': {'type': 0, 'spent': True, 'value': 547, 'spending_outpoints': [{'tx_index': 3464752126733508, 'n': 3}], 'n': 448, 'tx_index': 1804625333179383, 'script': 'a9144788f225b8ec7a59432b4f28b61ccd3c67ea446b87', 'addr': '38DFxL9AhRfWe4xrVrjMTMVp5YQkQ6Gx4F'}}, {'sequence': 4294967293, 'witness': '', 'script': '0047304402200e8e6ee41eb03d46cdabc7714e639c6ad89aeffbe5186e71d4387924c66f2438022065ec085639dfe6c879e26e9f9e9c0fcebe81f9d2bafa50b4719d023b691bfd9901483045022100df0ae92ffa368807b7c3cfea47a3ef12e5da275afce9ee9f3d5531afc34b2d3902206e91f380523af628442c0132e575c1cc471a48f609076eebc7b2f15c0bc8c7920147522102115c0be7b89cdc56e337154d76381321a553958d4f7ffc712013991347a38fd2210304026f3bdaf4920573fa168db4847c80398f069c48eecf7a9be00b4b1fb2127c52ae', 'index': 4, 'prev_out': {'type': 0, 'spent': True, 'value': 102706600, 'spending_outpoints': [{'tx_index': 3464752126733508, 'n': 4}], 'n': 0, 'tx_index': 5024138211179313, 'script': 'a914fa468d20f5daf2ef6f3c761ad1f4144c0ed5888787', 'addr': '3QWMNVQNJNNjA8Rx5aSPT4Yd5uwNpYrPFe'}}, {'sequence': 4294967293, 'witness': '', 'script': '0047304402206f84a0b41e9e5128d5d36d0c5e05b5dcadfb26aa9509b1ef0fcf17e1ae791d9a0220751f2ee566b304051f87d9ee6b4400b6343a2b1761cf97424ed08e5bde61669a0147304402200783b121a996cf9adc0d9fb6860bbf4003656a9cbbe50fbd7fc9306fd86cb95902203a0dbc06f02b9601e8e3ccdd8b599447dcf5ec5de9eb24476d31f06fd0391a9d014752210303446aca70735cf2bc1b2d50da9345b30089ae86d7dcc353bf378d5415fcfda42103586082d6f037282e5beecd4f52693ffad2c92d46662fff0739896d9f49cf48de52ae', 'index': 5, 'prev_out': {'type': 0, 'spent': True, 'value': 547, 'spending_outpoints': [{'tx_index': 3464752126733508, 'n': 5}], 'n': 167, 'tx_index': 7003826151280488, 'script': 'a9144788f225b8ec7a59432b4f28b61ccd3c67ea446b87', 'addr': '38DFxL9AhRfWe4xrVrjMTMVp5YQkQ6Gx4F'}}, {'sequence': 4294967293, 'witness': '', 'script': '00473044022045b5254ef057468ce214814966928bf2b0ceabb93a05850e951c125b2e7fa52302204a6d8329c496793198a5f0e3abf7db6547d0e41031e283e398e681e77f4edd46014730440220145c73b23a6d1b01486039186d23a829c6fa3363367eb7e2a13878ec0e7a16200220630df6b594de8df2b90abaafd879e647896ad2847f7bbeaecb15bfcc4193b95301475221030f248f6a42b5d75c6f5f6bd2e9a5964882701aad6f39f0f431dd06e1c2872eb0210372e63d7573943fce0fdfac8ffc3c34f13562a5a6c86b75567b198de8b5a11ae752ae', 'index': 6, 'prev_out': {'type': 0, 'spent': True, 'value': 547, 'spending_outpoints': [{'tx_index': 3464752126733508, 'n': 6}], 'n': 433, 'tx_index': 4361574662021994, 'script': 'a914804929555229ec14228fa98cc3d1fa8786a8d70387', 'addr': '3DPL4SnASNPuvWTNdSY7S2v9rWGDiW9QPQ'}}]","[{'type': 0, 'spent': False, 'value': 170001733182, 'spending_outpoints': [], 'n': 0, 'tx_index': 3464752126733508, 'script': 'a91429d930b97d58a3415c4a1e280e0e80f1d3e0a29487', 'addr': '35WHp4Hid61peyH4tuhNunwRj2gtNB41Lo'}]",170001733182,170001733182
