hash,ver,vin_sz,vout_sz,size,weight,fee,relayed_by,lock_time,tx_index,double_spend,time,block_index,block_height,inputs,out,result,balance
edd0efafc5103f09fad24b1af3179e51c2cf7137b3fb18d142c31e4f731cf9f9,2,2,2,373,838,627,0.0.0.0,0,8795146223739864,False,1731221358,869673,869673,"[{'sequence': 2147483649, 'witness': '02483045022100da8dd36800487877384d77f2fb9e49e983443bcf2a1a2f9c739cfa726f9548e202204e040e56321999400294fee895948fbda1d1051f5bbefe6719761bc68085540f012102dc771f5ea6797389374d0f5a4c498bc4fd16d86783f6ff0fde1b70a8dbcb558b', 'script': '', 'index': 0, 'prev_out': {'type': 0, 'spent': True, 'value': 330, 'spending_outpoints': [{'tx_index': 8795146223739864, 'n': 0}], 'n': 0, 'tx_index': 5075477767198941, 'script': '0014f881d18dfae68fe5daa64f26898e4a0c199becb0', 'addr': 'bc1qlzqarr06u687tk4xfungnrj2psvehm9ske2pyg'}}, {'sequence': 2147483649, 'witness': '02483045022100f14a369070f67435745675ec8b35c8af854ea2127e680c0158a52f8d970062c3022075d9dfebed4faeed728feb6216b63b8832db997a348b04929905bf05ceaa17a3012102dc771f5ea6797389374d0f5a4c498bc4fd16d86783f6ff0fde1b70a8dbcb558b', 'script': '', 'index': 1, 'prev_out': {'type': 0, 'spent': True, 'value': 40805, 'spending_outpoints': [{'tx_index': 8795146223739864, 'n': 1}], 'n': 1, 'tx_index': 6859757469447069, 'script': '0014f881d18dfae68fe5daa64f26898e4a0c199becb0', 'addr': 'bc1qlzqarr06u687tk4xfungnrj2psvehm9ske2pyg'}}]","[{'type': 0, 'spent': False, 'value': 546, 'spending_outpoints': [], 'n': 0, 'tx_index': 8795146223739864, 'script': 'a9145749951378aa74b802465243051f2b870ff0a5a187', 'addr': '39eYrpgAgDhp4tTjrSb1ppZ5kdAc1ikBYw'}, {'type': 0, 'spent': True, 'value': 39962, 'spending_outpoints': [{'tx_index': 1839597715608260, 'n': 1}], 'n': 1, 'tx_index': 8795146223739864, 'script': '0014f881d18dfae68fe5daa64f26898e4a0c199becb0', 'addr': 'bc1qlzqarr06u687tk4xfungnrj2psvehm9ske2pyg'}]",546,2613938445193
718da3b5493d319c62eef24ae8baa666395643a8d6e969bb058398329fcee479,1,1,11,523,1765,6630,0.0.0.0,0,4288756033409808,False,1725097506,859209,859209,"[{'sequence': 4294967295, 'witness': '02473044022058df5fd9e072c7754a28abfc21d65c19b209a0975c7254715813a7385b56de2e02203351257b7f5e6bdde311daba326bc2b7e1fce57bbd53af278265f498e35a7a94012102174ee672429ff94304321cdae1fc1e487edf658b34bd1d36da03761658a2bb09', 'script': '', 'index': 0, 'prev_out': {'type': 0, 'spent': True, 'value': 6994797, 'spending_outpoints': [{'tx_index': 4288756033409808, 'n': 0}], 'n': 1, 'tx_index': 3743886575891339, 'script': '0014dc6bf86354105de2fcd9868a2b0376d6731cb92f', 'addr': 'bc1qm34lsc65zpw79lxes69zkqmk6ee3ewf0j77s3h'}}]","[{'type': 0, 'spent': False, 'value': 511906, 'spending_outpoints': [], 'n': 0, 'tx_index': 4288756033409808, 'script': '001482cd822a2e6f1c93cf8a894ece0dd656a0004467', 'addr': 'bc1qstxcy23wduwf8nu2398vurwk26sqq3r8zxlru8'}, {'type': 0, 'spent': True, 'value': 2646521, 'spending_outpoints': [{'tx_index': 579266575808355, 'n': 72}], 'n': 1, 'tx_index': 4288756033409808, 'script': '0014dc6bf86354105de2fcd9868a2b0376d6731cb92f', 'addr': 'bc1qm34lsc65zpw79lxes69zkqmk6ee3ewf0j77s3h'}, {'type': 0, 'spent': False, 'value': 836153, 'spending_outpoints': [], 'n': 2, 'tx_index': 4288756033409808, 'script': '0014d3cfa01fccfa609a1b9d382a778ba23f4d4cf905', 'addr': 'bc1q6086q87vlfsf5xua8q480zaz8ax5e7g9khmfek'}, {'type': 0, 'spent': False, 'value': 34000, 'spending_outpoints': [], 'n': 3, 'tx_index': 4288756033409808, 'script': 'a9145749951378aa74b802465243051f2b870ff0a5a187', 'addr': '39eYrpgAgDhp4tTjrSb1ppZ5kdAc1ikBYw'}, {'type': 0, 'spent': False, 'value': 113876, 'spending_outpoints': [], 'n': 4, 'tx_index': 4288756033409808, 'script': '76a914393d98945ed602f1fc416b2528bd9ca7caab0f0888ac', 'addr': '16DfJhdBw1xMfSgzn6v63ttqTZQy6LC1gb'}, {'type': 0, 'spent': True, 'value': 229760, 'spending_outpoints': [{'tx_index': 3172726627752173, 'n': 0}], 'n': 5, 'tx_index': 4288756033409808, 'script': '512042eb3f50b1404b8df2658d4fcde782755e03967ae7f399255d2aaaf01f7c4499', 'addr': 'bc1pgt4n7593gp9cmun9348umeuzw40q89n6uleejf2a9240q8mugjvs49at7p'}, {'type': 0, 'spent': True, 'value': 1260878, 'spending_outpoints': [{'tx_index': 691147129551068, 'n': 88}], 'n': 6, 'tx_index': 4288756033409808, 'script': '76a91467a0436787b0ee94d2295c7e276f6d41704cae9c88ac', 'addr': '1ASvb3mZAJGkcu7tUqTDPa6zmMwFW4yzdz'}, {'type': 0, 'spent': True, 'value': 158936, 'spending_outpoints': [{'tx_index': 1310407950399266, 'n': 231}], 'n': 7, 'tx_index': 4288756033409808, 'script': '00148961b7eaa51e407041c4db1aa91e1930b0d73cd2', 'addr': 'bc1q39sm0649req8qswymvd2j8sexzcdw0xjepkjjt'}, {'type': 0, 'spent': True, 'value': 57790, 'spending_outpoints': [{'tx_index': 2169081339942645, 'n': 0}], 'n': 8, 'tx_index': 4288756033409808, 'script': '0014e7ea5e02755cd7db16ea0c6d1a689b5cd0c87087', 'addr': 'bc1qul49uqn4tntak9h2p3k356ymtngvsuy820hl87'}, {'type': 0, 'spent': False, 'value': 990000, 'spending_outpoints': [], 'n': 9, 'tx_index': 4288756033409808, 'script': '0014f8c73f447755b035374c9f0382cb9f7e02effd05', 'addr': 'bc1qlrrn73rh2kcr2d6vnupc9jul0cpwllg9em3msp'}, {'type': 0, 'spent': False, 'value': 148347, 'spending_outpoints': [], 'n': 10, 'tx_index': 4288756033409808, 'script': '76a914d771e88246e908c41b126f596d1d07e490117c8f88ac', 'addr': '1LeAjj9Ucbv7szC36u4YVLeaKd8u6HGRAP'}]",34000,2613938444647
b2bedbaf4f0e0c5354c266a47a1199d768fbe93715dd8030c06b12b180493059,2,2,4,367,1066,1602,0.0.0.0,0,3138045647135309,False,1725011866,859067,859067,"[{'sequence': 4294967295, 'witness': '014039def99569eb8a04dbbdffc802b5dc893675875a8347d6bea4ada7a2187f3f67abafb7ebbc0e2dd3b68d2262a42d47e04efd15e062d8fc442bbb79546d9dd351', 'script': '', 'index': 0, 'prev_out': {'type': 0, 'spent': True, 'value': 546, 'spending_outpoints': [{'tx_index': 3138045647135309, 'n': 0}], 'n': 0, 'tx_index': 6331976935874264, 'script': '51207866ad37336ac7811f2eaf77e28255276f2e4ce7973205f0a2a513ef501af6bb', 'addr': 'bc1p0pn26dendtrcz8ew4am79qj4yahjun88jueqtu9z55f775q676as4amnq8'}}, {'sequence': 4294967295, 'witness': '01400f2a7f7d2e139d5d9f9e77bcfeff6d18bc99bb5ca7ff5d71f5991e7e6c1955523c8f65588870b37e3f6fc56d4b0f3cd576fc123be35625d256f5a40abdefcea4', 'script': '', 'index': 1, 'prev_out': {'type': 0, 'spent': True, 'value': 104937, 'spending_outpoints': [{'tx_index': 3138045647135309, 'n': 1}], 'n': 3, 'tx_index': 6331976935874264, 'script': '51207866ad37336ac7811f2eaf77e28255276f2e4ce7973205f0a2a513ef501af6bb', 'addr': 'bc1p0pn26dendtrcz8ew4am79qj4yahjun88jueqtu9z55f775q676as4amnq8'}}]","[{'type': 0, 'spent': True, 'value': 546, 'spending_outpoints': [{'tx_index': 1469060006994538, 'n': 0}], 'n': 0, 'tx_index': 3138045647135309, 'script': '51207866ad37336ac7811f2eaf77e28255276f2e4ce7973205f0a2a513ef501af6bb', 'addr': 'bc1p0pn26dendtrcz8ew4am79qj4yahjun88jueqtu9z55f775q676as4amnq8'}, {'type': 0, 'spent': False, 'value': 546, 'spending_outpoints': [], 'n': 1, 'tx_index': 3138045647135309, 'script': 'a9145749951378aa74b802465243051f2b870ff0a5a187', 'addr': '39eYrpgAgDhp4tTjrSb1ppZ5kdAc1ikBYw'}, {'type': 0, 'spent': False, 'value': 0, 'spending_outpoints': [], 'n': 2, 'tx_index': 3138045647135309, 'script': '6a5d0b0090c533028094ebdc0301'}, {'type': 0, 'spent': True, 'value': 102789, 'spending_outpoints': [{'tx_index': 1469060006994538, 'n': 1}], 'n': 3, 'tx_index': 3138045647135309, 'script': '51207866ad37336ac7811f2eaf77e28255276f2e4ce7973205f0a2a513ef501af6bb', 'addr': 'bc1p0pn26dendtrcz8ew4am79qj4yahjun88jueqtu9z55f775q676as4amnq8'}]",546,2613938410647
acd5591ae652c59caafcc90f1b5d69ac0a17a500956b7511ea2682cfc7d36ba9,2,1,1,341,590,888,0.0.0.0,0,5960978549829700,False,1718642985,851012,851012,"[{'sequence': 4294967295, 'witness': '034059aba0ea73e09cb07d8f4c793e1daa67072da9bd6b7e70772df05a7215f5f86132aaabfc32899e0a5418dcc87777f92fb2a105b15b03a5abc5270246feb278b39b202ed0aac521d860ee19195632ebb00999fe101a1734d987676bac0843921d7cdaac0063036f7264010118746578742f706c61696e3b636861727365743d7574662d38004c547b2270223a226272632d3230222c226f70223a226d696e74222c227469636b223a2252455744222c22616d74223a22313030222c2277656273697465223a227777772e62726332307265776172642e636f6d227d6821c02ed0aac521d860ee19195632ebb00999fe101a1734d987676bac0843921d7cda', 'script': '', 'index': 0, 'prev_out': {'type': 0, 'spent': True, 'value': 1434, 'spending_outpoints': [{'tx_index': 5960978549829700, 'n': 0}], 'n': 5, 'tx_index': 2703012732731307, 'script': '51209c9dde276c872bebaf558b55d2ff1f48b7d510df44447ee4eeaa462dc03984ae', 'addr': 'bc1pnjwaufmvsu47ht643d2a9lclfzma2yxlg3z8ae8w4frzmspesjhqtradck'}}]","[{'type': 0, 'spent': False, 'value': 546, 'spending_outpoints': [], 'n': 0, 'tx_index': 5960978549829700, 'script': 'a9145749951378aa74b802465243051f2b870ff0a5a187', 'addr': '39eYrpgAgDhp4tTjrSb1ppZ5kdAc1ikBYw'}]",546,2613938410101
b6b1b766dd96189fab8ee3dd8f9534fc8943f31627fe8463ef4c58f000cf5f7a,2,2,2,419,1025,3072,0.0.0.0,0,4305661229665033,False,1715822322,843644,843644,"[{'sequence': 2147483649, 'witness': '0247304402205322b0cdf4e82ed62c743b2272f86357450bd034b6bf389f7943d09dbe08f4de0220545c9a0b7b3e881f1ddcc49362f6b110945c1324487c690fd76320a147b6a7d6012102676672ca68de6daf7f36ab116f5479adaad2659d87b78a99a998aefb4cf7e803', 'script': '16001439b0fb9b1be102b369b000eed7f268fc0bc3da40', 'index': 0, 'prev_out': {'type': 0, 'spent': True, 'value': 546, 'spending_outpoints': [{'tx_index': 4305661229665033, 'n': 0}], 'n': 0, 'tx_index': 7343083295421994, 'script': 'a91401a9d1996c9d3f91601d99564117daf4c90c3b3b87', 'addr': '31qp2wzhLpdU73EMmmUfywkLvcFfxcQ8yu'}}, {'sequence': 2147483649, 'witness': '024830450221008747e966271b90d773b839c7f08877fd8d540b5685cdaea5da67260a18a0d8ba022041fa0a1230ffb122374b48dd6091fe7b208e14591ae63a3d5748537e5c3c4e5d012102676672ca68de6daf7f36ab116f5479adaad2659d87b78a99a998aefb4cf7e803', 'script': '16001439b0fb9b1be102b369b000eed7f268fc0bc3da40', 'index': 1, 'prev_out': {'type': 0, 'spent': True, 'value': 24904, 'spending_outpoints': [{'tx_index': 4305661229665033, 'n': 1}], 'n': 1, 'tx_index': 3341140754065397, 'script': 'a91401a9d1996c9d3f91601d99564117daf4c90c3b3b87', 'addr': '31qp2wzhLpdU73EMmmUfywkLvcFfxcQ8yu'}}]","[{'type': 0, 'spent': False, 'value': 546, 'spending_outpoints': [], 'n': 0, 'tx_index': 4305661229665033, 'script': 'a9145749951378aa74b802465243051f2b870ff0a5a187', 'addr': '39eYrpgAgDhp4tTjrSb1ppZ5kdAc1ikBYw'}, {'type': 0, 'spent': True, 'value': 21832, 'spending_outpoints': [{'tx_index': 1918551825009289, 'n': 0}], 'n': 1, 'tx_index': 4305661229665033, 'script': 'a91401a9d1996c9d3f91601d99564117daf4c90c3b3b87', 'addr': '31qp2wzhLpdU73EMmmUfywkLvcFfxcQ8yu'}]",546,2613938409555
0eb28f58d241f8dc3d8b7f3502be3aa718f8e81c3b250c3211bc3e114f126f86,1,1,2,247,661,3154,0.0.0.0,0,4729971413231575,False,1710422756,834668,834668,"[{'sequence': 4294967295, 'witness': '02473044022020ff6b7bf974ed19aaf02a08be813c79c5794444987877a75c3755e988c960ea02201c72240fe7ae9067e063af2dcf68177cb9fb57b32416edf193695b5f307ab48601210327630b04a4e615627e44d00f2d8b14c636a82d1821b8ff73af827f594a5d9d6a', 'script': '1600143b8499c8c6933933d9659c38dbc2141076b3b90e', 'index': 0, 'prev_out': {'type': 0, 'spent': True, 'value': 2613938869971, 'spending_outpoints': [{'tx_index': 4729971413231575, 'n': 0}], 'n': 1, 'tx_index': 8650013508861510, 'script': 'a9145749951378aa74b802465243051f2b870ff0a5a187', 'addr': '39eYrpgAgDhp4tTjrSb1ppZ5kdAc1ikBYw'}}]","[{'type': 0, 'spent': False, 'value': 1310000, 'spending_outpoints': [], 'n': 0, 'tx_index': 4729971413231575, 'script': 'a914739fe896ad67294898d1215eab6a18661eeb61dd87', 'addr': '3CEPCFAXw1ny5o8uRTWdvpekcJU1tYo6t2'}, {'type': 0, 'spent': False, 'value': 2613937556817, 'spending_outpoints': [], 'n': 1, 'tx_index': 4729971413231575, 'script': 'a9145749951378aa74b802465243051f2b870ff0a5a187', 'addr': '39eYrpgAgDhp4tTjrSb1ppZ5kdAc1ikBYw'}]",-1313154,2613938409009
88ebf4c7dcfe35114bc0908691a5c990623bd77dc5eed8927636f2fbb321d9f5,1,1,2,248,662,4316,0.0.0.0,0,8650013508861510,False,1710244905,834353,834353,"[{'sequence': 4294967295, 'witness': '02483045022100d6ee8d4ed6e05fbda270a1de9b57019cd129989469f879b8dfde430cb144fc9002204bb8352ab06df0afe5e7c351ce01f1d32b4dba561df89fc847dfe512b42d4249012102cb5fe0001a7f11e1f740770f36ada44b0f11c4eb99876e405605685d09eaef02', 'script': '160014dfb63299fb704c76b9f55d49754c6ac0576c3021', 'index': 0, 'prev_out': {'type': 0, 'spent': True, 'value': 2613938974287, 'spending_outpoints': [{'tx_index': 8650013508861510, 'n': 0}], 'n': 0, 'tx_index': 6795313158487590, 'script': 'a914d4dcac3b837b5c81b5016a688293cc6a4f40e2fe87', 'addr': '3M6XXpqUc8G8GuHYKQhjAWobo5aGpkdV7u'}}]","[{'type': 0, 'spent': False, 'value': 100000, 'spending_outpoints': [], 'n': 0, 'tx_index': 8650013508861510, 'script': 'a914739fe896ad67294898d1215eab6a18661eeb61dd87', 'addr': '3CEPCFAXw1ny5o8uRTWdvpekcJU1tYo6t2'}, {'type': 0, 'spent': True, 'value': 2613938869971, 'spending_outpoints': [{'tx_index': 4729971413231575, 'n': 0}], 'n': 1, 'tx_index': 8650013508861510, 'script': 'a9145749951378aa74b802465243051f2b870ff0a5a187', 'addr': '39eYrpgAgDhp4tTjrSb1ppZ5kdAc1ikBYw'}]",2613938869971,2613939722163
c26f0123b863bf6d42013c300c52aa579fc991c632d4cd1b9e7e74dda78596f1,1,1,2,248,662,47808,0.0.0.0,0,8500121272299151,False,1701951589,820136,820136,"[{'sequence': 4294967295, 'witness': '02483045022100fb2614c899b19bd5b91f2c438a945d7d5dcbc2b6fe78923c492adc769aa9dbca02202c0df1a76e03ed873d0a4488bdb9e45adfc6591068b75827da4d429752a975a8012102cb5fe0001a7f11e1f740770f36ada44b0f11c4eb99876e405605685d09eaef02', 'script': '160014dfb63299fb704c76b9f55d49754c6ac0576c3021', 'index': 0, 'prev_out': {'type': 0, 'spent': True, 'value': 1000000, 'spending_outpoints': [{'tx_index': 8500121272299151, 'n': 0}], 'n': 0, 'tx_index': 7319936647526064, 'script': 'a914d4dcac3b837b5c81b5016a688293cc6a4f40e2fe87', 'addr': '3M6XXpqUc8G8GuHYKQhjAWobo5aGpkdV7u'}}]","[{'type': 0, 'spent': False, 'value': 100000, 'spending_outpoints': [], 'n': 0, 'tx_index': 8500121272299151, 'script': 'a914739fe896ad67294898d1215eab6a18661eeb61dd87', 'addr': '3CEPCFAXw1ny5o8uRTWdvpekcJU1tYo6t2'}, {'type': 0, 'spent': False, 'value': 852192, 'spending_outpoints': [], 'n': 1, 'tx_index': 8500121272299151, 'script': 'a9145749951378aa74b802465243051f2b870ff0a5a187', 'addr': '39eYrpgAgDhp4tTjrSb1ppZ5kdAc1ikBYw'}]",852192,852192
