hash,ver,vin_sz,vout_sz,size,weight,fee,relayed_by,lock_time,tx_index,double_spend,time,block_index,block_height,inputs,out,result,balance
ceb9036430bcc17a92c72590dd2ae9761d81e983250200c5daebaa37c40aa31d,2,2,2,382,880,440,0.0.0.0,0,1042755120199005,False,1730902799,869132,869132,"[{'sequence': 2147483649, 'witness': '0247304402206d330e2a3f16943df1e2648d6553e3584e050ea24ee711585e8aae226e6586e802201f4345f4605e06ac5aa3ebc18d6694b4de98ffa3683936f79b8240af060a88d0012102dc771f5ea6797389374d0f5a4c498bc4fd16d86783f6ff0fde1b70a8dbcb558b', 'script': '', 'index': 0, 'prev_out': {'type': 0, 'spent': True, 'value': 330, 'spending_outpoints': [{'tx_index': 1042755120199005, 'n': 0}], 'n': 0, 'tx_index': 1498597563995068, 'script': '0014f881d18dfae68fe5daa64f26898e4a0c199becb0', 'addr': 'bc1qlzqarr06u687tk4xfungnrj2psvehm9ske2pyg'}}, {'sequence': 2147483649, 'witness': '02473044022061bba9f6d9bbc90316fdb88b141272e31b25ea39f48329842df747a8ce980cff02202dfcb2d88473da286b6d0147cabab750f9b1d1e297c18b6909909b7e94b697fb012102dc771f5ea6797389374d0f5a4c498bc4fd16d86783f6ff0fde1b70a8dbcb558b', 'script': '', 'index': 1, 'prev_out': {'type': 0, 'spent': True, 'value': 121145, 'spending_outpoints': [{'tx_index': 1042755120199005, 'n': 1}], 'n': 1, 'tx_index': 3834568530683162, 'script': '0014f881d18dfae68fe5daa64f26898e4a0c199becb0', 'addr': 'bc1qlzqarr06u687tk4xfungnrj2psvehm9ske2pyg'}}]","[{'type': 0, 'spent': False, 'value': 546, 'spending_outpoints': [], 'n': 0, 'tx_index': 1042755120199005, 'script': '0020eab3cd0683f9554a66261793846f509ceaefd2cd4dfc20adf400689eb4addc09', 'addr': 'bc1qa2eu6p5rl9255e3xz7fcgm6snn4wl5kdfh7zpt05qp5fad9dmsys0qjg0e'}, {'type': 0, 'spent': True, 'value': 120489, 'spending_outpoints': [{'tx_index': 4626898501484674, 'n': 1}], 'n': 1, 'tx_index': 1042755120199005, 'script': '0014f881d18dfae68fe5daa64f26898e4a0c199becb0', 'addr': 'bc1qlzqarr06u687tk4xfungnrj2psvehm9ske2pyg'}]",546,5171031881858
fe6085f91c0604c6f223cbe00f00a052604ca082a39a700c3ee89436704ada2e,2,82,2,12185,48740,305350,0.0.0.0,0,1648482771718813,False,1730705543,868798,868798,"[{'sequence': 4294967295, 'witness': '', 'script': '47304402203840e4c9188ada2205dc0f6c58cb9a259642cdc09308517a8d029d15aaed80890220575d3c9c939e3b4b17f8191cd1b115bc9fe24c621aacd42b03491fd5827cd4b901210201973a41bb610e199a1fbb208398fbacc732c3658d132dbf9f3a394bedc9a7b5', 'index': 0, 'prev_out': {'type': 0, 'spent': True, 'value': 4478491007, 'spending_outpoints': [{'tx_index': 1648482771718813, 'n': 0}], 'n': 2, 'tx_index': 3571000288738965, 'script': '76a914adfb8786f19039b78a78a999e04d68348d0571be88ac', 'addr': '1GrwDkr33gT6LuumniYjKEGjTLhsL5kmqC'}}, {'sequence': 4294967295, 'witness': '', 'script': '483045022100df862eae8e530694b3fe1ee2af8c368cb652a78406759d62f076583d156e5ec90220581aba793c53f264f6b4cfe5b110fe5dbffc9b4439872ee5bbc3b731652bf02d01210201973a41bb610e199a1fbb208398fbacc732c3658d132dbf9f3a394bedc9a7b5', 'index': 1, 'prev_out': {'type': 0, 'spent': True, 'value': 4445844823, 'spending_outpoints': [{'tx_index': 1648482771718813, 'n': 1}], 'n': 6, 'tx_index': 4457594317723175, 'script': '76a914adfb8786f19039b78a78a999e04d68348d0571be88ac', 'addr': '1GrwDkr33gT6LuumniYjKEGjTLhsL5kmqC'}}, {'sequence': 4294967295, 'witness': '', 'script': '473044022024c3886703f6361edbeef13b7fc2ae7db7294390b1162d288d2647b0c79e0448022022b91319e70a6b8e23132f19f1a0bab497b587c0b8c5d4a2c715f0f044942bfe01210201973a41bb610e199a1fbb208398fbacc732c3658d132dbf9f3a394bedc9a7b5', 'index': 2, 'prev_out': {'type': 0, 'spent': True, 'value': 4425756297, 'spending_outpoints': [{'tx_index': 1648482771718813, 'n': 2}], 'n': 0, 'tx_index': 8854850722008722, 'script': '76a914adfb8786f19039b78a78a999e04d68348d0571be88ac', 'addr': '1GrwDkr33gT6LuumniYjKEGjTLhsL5kmqC'}}, {'sequence': 4294967295, 'witness': '', 'script': '473044022077b071f36cec5ae5a6d4567baa7c52ef735257117fc5a60624fbe9fe6b961bd802205f0223f755a58499c9e14283e5ac501ab8b76eba8660d624ca0a2219ef12d27d01210201973a41bb610e199a1fbb208398fbacc732c3658d132dbf9f3a394bedc9a7b5', 'index': 3, 'prev_out': {'type': 0, 'spent': True, 'value': 4371413862, 'spending_outpoints': [{'tx_index': 1648482771718813, 'n': 3}], 'n': 5, 'tx_index': 7169792577643865, 'script': '76a914adfb8786f19039b78a78a999e04d68348d0571be88ac', 'addr': '1GrwDkr33gT6LuumniYjKEGjTLhsL5kmqC'}}, {'sequence': 4294967295, 'witness': '', 'script': '47304402202a34920b317b2906dc4de75b4e8205f111d423fc6c9859fcad353439a8f9417402200969158395d35af3c19eef4d86063ca712e48454acd3a0cc13cad3adfcbed0a101210201973a41bb610e199a1fbb208398fbacc732c3658d132dbf9f3a394bedc9a7b5', 'index': 4, 'prev_out': {'type': 0, 'spent': True, 'value': 4270562409, 'spending_outpoints': [{'tx_index': 1648482771718813, 'n': 4}], 'n': 3, 'tx_index': 4633796580089265, 'script': '76a914adfb8786f19039b78a78a999e04d68348d0571be88ac', 'addr': '1GrwDkr33gT6LuumniYjKEGjTLhsL5kmqC'}}, {'sequence': 4294967295, 'witness': '', 'script': '483045022100dd33a19533dc9d3cd684124154fdd485fa23a254596dc34ef9cf69b61a94346a02203c61cacbb9b011c112ce926840b9902de3cba65780c468c7d33ffd934e21c8da01210201973a41bb610e199a1fbb208398fbacc732c3658d132dbf9f3a394bedc9a7b5', 'index': 5, 'prev_out': {'type': 0, 'spent': True, 'value': 4255433606, 'spending_outpoints': [{'tx_index': 1648482771718813, 'n': 5}], 'n': 10, 'tx_index': 7736324601207325, 'script': '76a914adfb8786f19039b78a78a999e04d68348d0571be88ac', 'addr': '1GrwDkr33gT6LuumniYjKEGjTLhsL5kmqC'}}, {'sequence': 4294967295, 'witness': '', 'script': '483045022100d091c02ab2aa99baa583e7a2abaa644fb2ef0e8173c6c76901cb8fca57a734e7022065552261fd47c8b67815048703faad0ca98e64e98b35b94475d03b4addc6b3fd01210201973a41bb610e199a1fbb208398fbacc732c3658d132dbf9f3a394bedc9a7b5', 'index': 6, 'prev_out': {'type': 0, 'spent': True, 'value': 4227478709, 'spending_outpoints': [{'tx_index': 1648482771718813, 'n': 6}], 'n': 4, 'tx_index': 8732692464495049, 'script': '76a914adfb8786f19039b78a78a999e04d68348d0571be88ac', 'addr': '1GrwDkr33gT6LuumniYjKEGjTLhsL5kmqC'}}, {'sequence': 4294967295, 'witness': '', 'script': '483045022100a685f59b1b7c9e5197c5b05c7ce613c280cdb1e62b59fae5622039f1054c2ab902202ca31ad73bdc9dce3bf370a222fbcea236c4c19774f3bf248a183758146dac5601210201973a41bb610e199a1fbb208398fbacc732c3658d132dbf9f3a394bedc9a7b5', 'index': 7, 'prev_out': {'type': 0, 'spent': True, 'value': 4168546791, 'spending_outpoints': [{'tx_index': 1648482771718813, 'n': 7}], 'n': 0, 'tx_index': 6617676695868256, 'script': '76a914adfb8786f19039b78a78a999e04d68348d0571be88ac', 'addr': '1GrwDkr33gT6LuumniYjKEGjTLhsL5kmqC'}}, {'sequence': 4294967295, 'witness': '', 'script': '473044022008f6ea20c3529af45aa14ae4316b7d2ac84022cb89458361325ad3b0292449c702207092f6b6f345a99901004a58599c272b092315558752f6e9ec1858edd71ff3d501210201973a41bb610e199a1fbb208398fbacc732c3658d132dbf9f3a394bedc9a7b5', 'index': 8, 'prev_out': {'type': 0, 'spent': True, 'value': 4160602700, 'spending_outpoints': [{'tx_index': 1648482771718813, 'n': 8}], 'n': 0, 'tx_index': 5239846994542898, 'script': '76a914adfb8786f19039b78a78a999e04d68348d0571be88ac', 'addr': '1GrwDkr33gT6LuumniYjKEGjTLhsL5kmqC'}}, {'sequence': 4294967295, 'witness': '', 'script': '47304402207f1d600858b76965b8bd996d4505b8993f3edb9a8b3cc34474ab70bf7197c9eb0220748e786ec0600c8ae15374ab4dabb86181c58d9f7eaf1091a902cc17e589201201210201973a41bb610e199a1fbb208398fbacc732c3658d132dbf9f3a394bedc9a7b5', 'index': 9, 'prev_out': {'type': 0, 'spent': True, 'value': 4041387007, 'spending_outpoints': [{'tx_index': 1648482771718813, 'n': 9}], 'n': 4, 'tx_index': 5779078274442570, 'script': '76a914adfb8786f19039b78a78a999e04d68348d0571be88ac', 'addr': '1GrwDkr33gT6LuumniYjKEGjTLhsL5kmqC'}}, {'sequence': 4294967295, 'witness': '', 'script': '483045022100b74c3dc15b38efd202d6b6f65c3c4aa3870a72a3cf6cfff793cba75f83cf7f86022008db104c3985046abe5e7b30d730c161521628d8d6e6f5ef807fe41f3f8db28901210201973a41bb610e199a1fbb208398fbacc732c3658d132dbf9f3a394bedc9a7b5', 'index': 10, 'prev_out': {'type': 0, 'spent': True, 'value': 3952119683, 'spending_outpoints': [{'tx_index': 1648482771718813, 'n': 10}], 'n': 0, 'tx_index': 4088177452987925, 'script': '76a914adfb8786f19039b78a78a999e04d68348d0571be88ac', 'addr': '1GrwDkr33gT6LuumniYjKEGjTLhsL5kmqC'}}, {'sequence': 4294967295, 'witness': '', 'script': '4830450221008d804234ede2aa1b1d913a02868139b805027ed2a28f5a1dfae98643fd915f95022039402b8afc14ff11ecec9b6c85769411f3bcccbf2f31cd02b9eb0d61f64cb85b01210201973a41bb610e199a1fbb208398fbacc732c3658d132dbf9f3a394bedc9a7b5', 'index': 11, 'prev_out': {'type': 0, 'spent': True, 'value': 3912852890, 'spending_outpoints': [{'tx_index': 1648482771718813, 'n': 11}], 'n': 10, 'tx_index': 6191598328474111, 'script': '76a914adfb8786f19039b78a78a999e04d68348d0571be88ac', 'addr': '1GrwDkr33gT6LuumniYjKEGjTLhsL5kmqC'}}, {'sequence': 4294967295, 'witness': '', 'script': '483045022100b331e10f15b1ba53301f12dcfbd3594404e383757e9970056467c21cd26d33290220102da9d7fa63a1683d904eb3f1d0eb8124552946dc0a8a6e4dfdb020e43b6efd01210201973a41bb610e199a1fbb208398fbacc732c3658d132dbf9f3a394bedc9a7b5', 'index': 12, 'prev_out': {'type': 0, 'spent': True, 'value': 3903867305, 'spending_outpoints': [{'tx_index': 1648482771718813, 'n': 12}], 'n': 6, 'tx_index': 1815186294023815, 'script': '76a914adfb8786f19039b78a78a999e04d68348d0571be88ac', 'addr': '1GrwDkr33gT6LuumniYjKEGjTLhsL5kmqC'}}, {'sequence': 4294967295, 'witness': '', 'script': '47304402202a7e6980f710fb1602af64b04be70090861b04a9c131b260e122d97b2153aa630220753a1150ca3046c90293f51be8932df074f8759ba1de040940bf897bcd855bfe01210201973a41bb610e199a1fbb208398fbacc732c3658d132dbf9f3a394bedc9a7b5', 'index': 13, 'prev_out': {'type': 0, 'spent': True, 'value': 3881611791, 'spending_outpoints': [{'tx_index': 1648482771718813, 'n': 13}], 'n': 0, 'tx_index': 6402640642780676, 'script': '76a914adfb8786f19039b78a78a999e04d68348d0571be88ac', 'addr': '1GrwDkr33gT6LuumniYjKEGjTLhsL5kmqC'}}, {'sequence': 4294967295, 'witness': '', 'script': '4730440220498a193ea81ea4e58f75ad5dce6a043ec2b5cbc149660958af44d558b6545970022051257868f3d3a03e5466117632bf0a1ff260762186f083f82d53bfb523fa005401210201973a41bb610e199a1fbb208398fbacc732c3658d132dbf9f3a394bedc9a7b5', 'index': 14, 'prev_out': {'type': 0, 'spent': True, 'value': 3643821955, 'spending_outpoints': [{'tx_index': 1648482771718813, 'n': 14}], 'n': 0, 'tx_index': 2108043127485808, 'script': '76a914adfb8786f19039b78a78a999e04d68348d0571be88ac', 'addr': '1GrwDkr33gT6LuumniYjKEGjTLhsL5kmqC'}}, {'sequence': 4294967295, 'witness': '', 'script': '483045022100e144c2eee773160dc9cf9cd6c1a7f2f1a98ed451aff03de8b6112e112845452102203c2353907fd35dc5ea17ff079285e9e14d0a6dd9b48f5c8e6841495787d67caa01210201973a41bb610e199a1fbb208398fbacc732c3658d132dbf9f3a394bedc9a7b5', 'index': 15, 'prev_out': {'type': 0, 'spent': True, 'value': 3515595356, 'spending_outpoints': [{'tx_index': 1648482771718813, 'n': 15}], 'n': 0, 'tx_index': 7735806882820778, 'script': '76a914adfb8786f19039b78a78a999e04d68348d0571be88ac', 'addr': '1GrwDkr33gT6LuumniYjKEGjTLhsL5kmqC'}}, {'sequence': 4294967295, 'witness': '', 'script': '47304402207a0ea509e955bf9acb7787f280273a2e20c77377f3393c153619f5ca9cb6b4ac02206aeb0835d1a661cfe25f6bbb5f4b70a94d3f345ecd08b2fdd1a84a32d2ba9ff901210201973a41bb610e199a1fbb208398fbacc732c3658d132dbf9f3a394bedc9a7b5', 'index': 16, 'prev_out': {'type': 0, 'spent': True, 'value': 3467541917, 'spending_outpoints': [{'tx_index': 1648482771718813, 'n': 16}], 'n': 0, 'tx_index': 5912670811217502, 'script': '76a914adfb8786f19039b78a78a999e04d68348d0571be88ac', 'addr': '1GrwDkr33gT6LuumniYjKEGjTLhsL5kmqC'}}, {'sequence': 4294967295, 'witness': '', 'script': '47304402200a1c26064e91bb8c16ead3e97ee8f61c7132a4a084608c9247b8c41e70a18725022024dcd7c7dac76d9144ca02cecde8cc4fa15c6e5dafa926e4740f1a8b95626b7b01210201973a41bb610e199a1fbb208398fbacc732c3658d132dbf9f3a394bedc9a7b5', 'index': 17, 'prev_out': {'type': 0, 'spent': True, 'value': 3388925894, 'spending_outpoints': [{'tx_index': 1648482771718813, 'n': 17}], 'n': 7, 'tx_index': 4992715875843595, 'script': '76a914adfb8786f19039b78a78a999e04d68348d0571be88ac', 'addr': '1GrwDkr33gT6LuumniYjKEGjTLhsL5kmqC'}}, {'sequence': 4294967295, 'witness': '', 'script': '483045022100dbc8a57bf4c4cb32f8141f7358456d639edc500c03e09d45d52592b28fdb2757022056ee36e467f8183249882211ad84a8af07800d6fe4356eb65b8b3f2ba679ee2201210201973a41bb610e199a1fbb208398fbacc732c3658d132dbf9f3a394bedc9a7b5', 'index': 18, 'prev_out': {'type': 0, 'spent': True, 'value': 3365841865, 'spending_outpoints': [{'tx_index': 1648482771718813, 'n': 18}], 'n': 0, 'tx_index': 4031864443806825, 'script': '76a914adfb8786f19039b78a78a999e04d68348d0571be88ac', 'addr': '1GrwDkr33gT6LuumniYjKEGjTLhsL5kmqC'}}, {'sequence': 4294967295, 'witness': '', 'script': '47304402204cadd156075a73212a406abaa1b5b874db2f48cca2414602a5d5b40a307fc72b022067513660c08f5a78f17d00d339e0fb71cbccdd08ccb122c72eba89ea9870e86201210201973a41bb610e199a1fbb208398fbacc732c3658d132dbf9f3a394bedc9a7b5', 'index': 19, 'prev_out': {'type': 0, 'spent': True, 'value': 3254855082, 'spending_outpoints': [{'tx_index': 1648482771718813, 'n': 19}], 'n': 0, 'tx_index': 651564509475440, 'script': '76a914adfb8786f19039b78a78a999e04d68348d0571be88ac', 'addr': '1GrwDkr33gT6LuumniYjKEGjTLhsL5kmqC'}}, {'sequence': 4294967295, 'witness': '', 'script': '483045022100acf8ae2df4aec8ebe21568e5df7d71dcc3825a01a5faf05d80774dac968dc39002204d2bb6b671759480b9942d0c8ded6c5e1c9f93b5ffc896d7037ecf810bf3edee01210201973a41bb610e199a1fbb208398fbacc732c3658d132dbf9f3a394bedc9a7b5', 'index': 20, 'prev_out': {'type': 0, 'spent': True, 'value': 3236438853, 'spending_outpoints': [{'tx_index': 1648482771718813, 'n': 20}], 'n': 0, 'tx_index': 4629683202066193, 'script': '76a914adfb8786f19039b78a78a999e04d68348d0571be88ac', 'addr': '1GrwDkr33gT6LuumniYjKEGjTLhsL5kmqC'}}, {'sequence': 4294967295, 'witness': '', 'script': '47304402204a667d1414c0c49701f878b48479b859c9d95a13082333d9d586f68bbe41168c0220087090a9f393753edb4a086885158811421d6316c0608541314e7410369a36a901210201973a41bb610e199a1fbb208398fbacc732c3658d132dbf9f3a394bedc9a7b5', 'index': 21, 'prev_out': {'type': 0, 'spent': True, 'value': 3193173024, 'spending_outpoints': [{'tx_index': 1648482771718813, 'n': 21}], 'n': 6, 'tx_index': 5265747992389143, 'script': '76a914adfb8786f19039b78a78a999e04d68348d0571be88ac', 'addr': '1GrwDkr33gT6LuumniYjKEGjTLhsL5kmqC'}}, {'sequence': 4294967295, 'witness': '', 'script': '483045022100cbdae059dd206ced4ccd563666870fadd199016682d7413c5b1d63c391b843c402201dda15ab2e2840647228acf3df6596f2b9667454498e405e68b7cc89501740b401210201973a41bb610e199a1fbb208398fbacc732c3658d132dbf9f3a394bedc9a7b5', 'index': 22, 'prev_out': {'type': 0, 'spent': True, 'value': 3189728895, 'spending_outpoints': [{'tx_index': 1648482771718813, 'n': 22}], 'n': 0, 'tx_index': 8616501623175097, 'script': '76a914adfb8786f19039b78a78a999e04d68348d0571be88ac', 'addr': '1GrwDkr33gT6LuumniYjKEGjTLhsL5kmqC'}}, {'sequence': 4294967295, 'witness': '', 'script': '4830450221009f7c9962c7787b21e86e3a17f99a84a09b5a4a699012ac09a6c83398afb5136902201f135a73ad057f1ef11fc92495e0c489a8d3b48bbdd0dde76008ebe4c27ad96801210201973a41bb610e199a1fbb208398fbacc732c3658d132dbf9f3a394bedc9a7b5', 'index': 23, 'prev_out': {'type': 0, 'spent': True, 'value': 3179315162, 'spending_outpoints': [{'tx_index': 1648482771718813, 'n': 23}], 'n': 5, 'tx_index': 7266841069593484, 'script': '76a914adfb8786f19039b78a78a999e04d68348d0571be88ac', 'addr': '1GrwDkr33gT6LuumniYjKEGjTLhsL5kmqC'}}, {'sequence': 4294967295, 'witness': '', 'script': '483045022100f7ae4c7f80ba121939889b9d402650cde2e4ee78540cc788f02f8c218e1288b4022029f7e4125e1b53531ec435808a7971f1b8a73cfb831b8b538d7bcf1859439f4001210201973a41bb610e199a1fbb208398fbacc732c3658d132dbf9f3a394bedc9a7b5', 'index': 24, 'prev_out': {'type': 0, 'spent': True, 'value': 3145239774, 'spending_outpoints': [{'tx_index': 1648482771718813, 'n': 24}], 'n': 17, 'tx_index': 880310334441218, 'script': '76a914adfb8786f19039b78a78a999e04d68348d0571be88ac', 'addr': '1GrwDkr33gT6LuumniYjKEGjTLhsL5kmqC'}}, {'sequence': 4294967295, 'witness': '', 'script': '483045022100e5db3a81275653b223c5ece8d19796533da97b85f7301fb89f67c527804adc6c022068345dce18b66db6b1ff9554e57cf3dd710d0446be40f983157a3a265ec85c1b01210201973a41bb610e199a1fbb208398fbacc732c3658d132dbf9f3a394bedc9a7b5', 'index': 25, 'prev_out': {'type': 0, 'spent': True, 'value': 3049546393, 'spending_outpoints': [{'tx_index': 1648482771718813, 'n': 25}], 'n': 0, 'tx_index': 4204945092287032, 'script': '76a914adfb8786f19039b78a78a999e04d68348d0571be88ac', 'addr': '1GrwDkr33gT6LuumniYjKEGjTLhsL5kmqC'}}, {'sequence': 4294967295, 'witness': '', 'script': '483045022100a9046138dc1f82d10c9d128029b9d37eb7252ea01ed9907d10eaf1d08afdb32702201cc86ab9f3e40c147acc14a3ce5beaee7aa771097d162604792708d89132ec7d01210201973a41bb610e199a1fbb208398fbacc732c3658d132dbf9f3a394bedc9a7b5', 'index': 26, 'prev_out': {'type': 0, 'spent': True, 'value': 3018127779, 'spending_outpoints': [{'tx_index': 1648482771718813, 'n': 26}], 'n': 0, 'tx_index': 2710913858197733, 'script': '76a914adfb8786f19039b78a78a999e04d68348d0571be88ac', 'addr': '1GrwDkr33gT6LuumniYjKEGjTLhsL5kmqC'}}, {'sequence': 4294967295, 'witness': '', 'script': '47304402205b566b154a5b566c0d3cd8fa9415a777f4abd3ecd5d9987cb990f01e6f931860022077b0b0016a68157cf355ff13b6357e456b5e9fbb6563bf9d5af8147a1062be1001210201973a41bb610e199a1fbb208398fbacc732c3658d132dbf9f3a394bedc9a7b5', 'index': 27, 'prev_out': {'type': 0, 'spent': True, 'value': 2997245622, 'spending_outpoints': [{'tx_index': 1648482771718813, 'n': 27}], 'n': 11, 'tx_index': 7376453839725361, 'script': '76a914adfb8786f19039b78a78a999e04d68348d0571be88ac', 'addr': '1GrwDkr33gT6LuumniYjKEGjTLhsL5kmqC'}}, {'sequence': 4294967295, 'witness': '', 'script': '483045022100dfe575c1c8f22cd0e6b82ca4665c5baf391c8aef229f377aedcdc17549c3467102201e7b91d8bfdb39faea7be163fe3f1d814ee754d859395c5b486a730a3f1c4d7d01210201973a41bb610e199a1fbb208398fbacc732c3658d132dbf9f3a394bedc9a7b5', 'index': 28, 'prev_out': {'type': 0, 'spent': True, 'value': 2915445617, 'spending_outpoints': [{'tx_index': 1648482771718813, 'n': 28}], 'n': 6, 'tx_index': 6736583551707057, 'script': '76a914adfb8786f19039b78a78a999e04d68348d0571be88ac', 'addr': '1GrwDkr33gT6LuumniYjKEGjTLhsL5kmqC'}}, {'sequence': 4294967295, 'witness': '', 'script': '47304402200b198414a4ba4d44414df400b25d30b85383903060e0bd35e482f7c4d90ad8cd02205f4d1d2a3c441f175152727d5f1045bcdd6b80c701e581ce27458cadbf15c2f301210201973a41bb610e199a1fbb208398fbacc732c3658d132dbf9f3a394bedc9a7b5', 'index': 29, 'prev_out': {'type': 0, 'spent': True, 'value': 2910954581, 'spending_outpoints': [{'tx_index': 1648482771718813, 'n': 29}], 'n': 0, 'tx_index': 1014161815155678, 'script': '76a914adfb8786f19039b78a78a999e04d68348d0571be88ac', 'addr': '1GrwDkr33gT6LuumniYjKEGjTLhsL5kmqC'}}, {'sequence': 4294967295, 'witness': '', 'script': '483045022100b7708d8b375d869f048d87b39d0bb9ef84f561769ea93560db848b84d92fc21102207379deca19a463e6eead3436fb913193cb7552248a22de1acd33a868069da24801210201973a41bb610e199a1fbb208398fbacc732c3658d132dbf9f3a394bedc9a7b5', 'index': 30, 'prev_out': {'type': 0, 'spent': True, 'value': 2741435028, 'spending_outpoints': [{'tx_index': 1648482771718813, 'n': 30}], 'n': 0, 'tx_index': 5496050531331828, 'script': '76a914adfb8786f19039b78a78a999e04d68348d0571be88ac', 'addr': '1GrwDkr33gT6LuumniYjKEGjTLhsL5kmqC'}}, {'sequence': 4294967295, 'witness': '', 'script': '473044022017655c1206e097de1476231c5b00bcfad524b3d39d57cc58b72069081b0b1f6002201cd5980335dcf7291aa514026057faf6fa3f9e12a1c3bc58c2112105b5d425b601210201973a41bb610e199a1fbb208398fbacc732c3658d132dbf9f3a394bedc9a7b5', 'index': 31, 'prev_out': {'type': 0, 'spent': True, 'value': 2670845486, 'spending_outpoints': [{'tx_index': 1648482771718813, 'n': 31}], 'n': 0, 'tx_index': 2242218579576048, 'script': '76a914adfb8786f19039b78a78a999e04d68348d0571be88ac', 'addr': '1GrwDkr33gT6LuumniYjKEGjTLhsL5kmqC'}}, {'sequence': 4294967295, 'witness': '', 'script': '47304402205259d7f1908d3c6a180f09acdbf04292b0296a08479245bf65074a06185f7496022043759b1ebbb3171e4176a9a6ab18fc028828dafec0af1cdd2955de9fb9a58ed401210201973a41bb610e199a1fbb208398fbacc732c3658d132dbf9f3a394bedc9a7b5', 'index': 32, 'prev_out': {'type': 0, 'spent': True, 'value': 2658331797, 'spending_outpoints': [{'tx_index': 1648482771718813, 'n': 32}], 'n': 0, 'tx_index': 1392704840367000, 'script': '76a914adfb8786f19039b78a78a999e04d68348d0571be88ac', 'addr': '1GrwDkr33gT6LuumniYjKEGjTLhsL5kmqC'}}, {'sequence': 4294967295, 'witness': '', 'script': '473044022034723bffb0df083ad26d233924b1dd118138be905345d5936c3ebeb24b8507d702202b40e18eb3deb744b294f7f7079c4e1396de63941131b4375b8078386353b42401210201973a41bb610e199a1fbb208398fbacc732c3658d132dbf9f3a394bedc9a7b5', 'index': 33, 'prev_out': {'type': 0, 'spent': True, 'value': 2566441440, 'spending_outpoints': [{'tx_index': 1648482771718813, 'n': 33}], 'n': 0, 'tx_index': 4312417756891045, 'script': '76a914adfb8786f19039b78a78a999e04d68348d0571be88ac', 'addr': '1GrwDkr33gT6LuumniYjKEGjTLhsL5kmqC'}}, {'sequence': 4294967295, 'witness': '', 'script': '473044022051de63cce2c42fe656898762da7fade15af66c6b1920e2528b5d059469fae66b022017f36dc26d4ae4642dd540bec147cbcea33a5ac11b65f7bfcb74483a2ce2cc7b0121022b859cee4694f2f8f763482ed42511353bcefb84ea5ff4021d09d183870f1cd9', 'index': 34, 'prev_out': {'type': 0, 'spent': True, 'value': 2500000000, 'spending_outpoints': [{'tx_index': 1648482771718813, 'n': 34}], 'n': 0, 'tx_index': 7260497570385539, 'script': '76a914e9fc279d9e7eebd94b23f3bf3da2be298bdde1b988ac', 'addr': '1NLCWiWDoLyB1tSH1rm5Pm7AzKJEikjVfc'}}, {'sequence': 4294967295, 'witness': '', 'script': '47304402205b13063a71fa23e3a0c8bc4deb07d9267dae93001d8e92d57f9a31d4399b7e4402202a63b365ceaa3323560dac403cfc8d2e686f583237340b5694f5339ffb3e236101210201973a41bb610e199a1fbb208398fbacc732c3658d132dbf9f3a394bedc9a7b5', 'index': 35, 'prev_out': {'type': 0, 'spent': True, 'value': 2421981512, 'spending_outpoints': [{'tx_index': 1648482771718813, 'n': 35}], 'n': 0, 'tx_index': 8530862670450686, 'script': '76a914adfb8786f19039b78a78a999e04d68348d0571be88ac', 'addr': '1GrwDkr33gT6LuumniYjKEGjTLhsL5kmqC'}}, {'sequence': 4294967295, 'witness': '', 'script': '483045022100c1ab8bd1d7d56298355098897e85a65aff6275283b91ca80b69d1bd7730746e102203adb65ddcc7b429aede4d9f3d5cd9ff04379e88d211e789cec8cd9d53e2f9c4d012103f250289afc1604963ad079a60a9654bd83f405fb0293258f405248eb53b4afdb', 'index': 36, 'prev_out': {'type': 0, 'spent': True, 'value': 2420000000, 'spending_outpoints': [{'tx_index': 1648482771718813, 'n': 36}], 'n': 0, 'tx_index': 1647846841439627, 'script': '76a914d27e576bc95c7c72078390a6bc3703ebfa9f23ce88ac', 'addr': '1LBzFeQSkU3gju2zQGU9D3mmpixTkFA9gr'}}, {'sequence': 4294967295, 'witness': '', 'script': '483045022100ff1e71263f5fea79e899317b1a8fee9a191fbc944e98757f87d2e40ade9178bb022040ff8995e62343f76e3998474131e882117ee8560efc769d6d13391520ad90e801210201973a41bb610e199a1fbb208398fbacc732c3658d132dbf9f3a394bedc9a7b5', 'index': 37, 'prev_out': {'type': 0, 'spent': True, 'value': 2405681450, 'spending_outpoints': [{'tx_index': 1648482771718813, 'n': 37}], 'n': 3, 'tx_index': 1145148689291956, 'script': '76a914adfb8786f19039b78a78a999e04d68348d0571be88ac', 'addr': '1GrwDkr33gT6LuumniYjKEGjTLhsL5kmqC'}}, {'sequence': 4294967295, 'witness': '', 'script': '47304402202a2878cc8ce71fa20342abbcd4d3780667b2a182a65b69257a8ae8c7220f82e302206ccdece9401ae0bec68d5ea8eb6a650d91930df6a804285973c583ddcf103f4b01210201973a41bb610e199a1fbb208398fbacc732c3658d132dbf9f3a394bedc9a7b5', 'index': 38, 'prev_out': {'type': 0, 'spent': True, 'value': 2380678831, 'spending_outpoints': [{'tx_index': 1648482771718813, 'n': 38}], 'n': 0, 'tx_index': 2143271997216908, 'script': '76a914adfb8786f19039b78a78a999e04d68348d0571be88ac', 'addr': '1GrwDkr33gT6LuumniYjKEGjTLhsL5kmqC'}}, {'sequence': 4294967295, 'witness': '', 'script': '47304402202f49be1077f1049a6230d8ee857adf19f7608f8ac1515bd721f062f7fb0ef707022030fcdef2261703b1de0a78dbe63457e8792664b6fbf11b567a4e81529202127201210201973a41bb610e199a1fbb208398fbacc732c3658d132dbf9f3a394bedc9a7b5', 'index': 39, 'prev_out': {'type': 0, 'spent': True, 'value': 2370725071, 'spending_outpoints': [{'tx_index': 1648482771718813, 'n': 39}], 'n': 7, 'tx_index': 3681680407766402, 'script': '76a914adfb8786f19039b78a78a999e04d68348d0571be88ac', 'addr': '1GrwDkr33gT6LuumniYjKEGjTLhsL5kmqC'}}, {'sequence': 4294967295, 'witness': '', 'script': '47304402201d484e5438537e7e18ba9679300870b70fa11b53c166497bb5140dab31867ae4022056f681d061dc868e1623a5bf9c49491eeec182b8be009bcfcc9ef592fee4f75d01210201973a41bb610e199a1fbb208398fbacc732c3658d132dbf9f3a394bedc9a7b5', 'index': 40, 'prev_out': {'type': 0, 'spent': True, 'value': 2222597677, 'spending_outpoints': [{'tx_index': 1648482771718813, 'n': 40}], 'n': 0, 'tx_index': 7838485462053440, 'script': '76a914adfb8786f19039b78a78a999e04d68348d0571be88ac', 'addr': '1GrwDkr33gT6LuumniYjKEGjTLhsL5kmqC'}}, {'sequence': 4294967295, 'witness': '', 'script': '4830450221009ef201df1b9db3fad328088ea20a3d1695b7f71bf6ca6d7605599f6bf7f5ab9a02204e86bcbf3e5f17e714179a37bf2c4196ff5ca636b10807fe3b16941c8283f3c901210201973a41bb610e199a1fbb208398fbacc732c3658d132dbf9f3a394bedc9a7b5', 'index': 41, 'prev_out': {'type': 0, 'spent': True, 'value': 2063644064, 'spending_outpoints': [{'tx_index': 1648482771718813, 'n': 41}], 'n': 9, 'tx_index': 8753058747332317, 'script': '76a914adfb8786f19039b78a78a999e04d68348d0571be88ac', 'addr': '1GrwDkr33gT6LuumniYjKEGjTLhsL5kmqC'}}, {'sequence': 4294967295, 'witness': '', 'script': '483045022100a6994bd1bbadf65d2797e32ed0518754d1131f5487894baf27f90ef2a968a2f702201a6ffd873047e74a5920f762b7e9b14aa4987aa5d186335a27ab691ea073c94201210201973a41bb610e199a1fbb208398fbacc732c3658d132dbf9f3a394bedc9a7b5', 'index': 42, 'prev_out': {'type': 0, 'spent': True, 'value': 1999423414, 'spending_outpoints': [{'tx_index': 1648482771718813, 'n': 42}], 'n': 8, 'tx_index': 8544947366191548, 'script': '76a914adfb8786f19039b78a78a999e04d68348d0571be88ac', 'addr': '1GrwDkr33gT6LuumniYjKEGjTLhsL5kmqC'}}, {'sequence': 4294967295, 'witness': '', 'script': '483045022100fd41d62e3dbc21d63427e6b5b64c9ff12bb0ce1a13a1cdd577d7bfd64b35e3da022038060f2250746e99d01d86f5d4cbb6bbfb8d642eaebb7d63bba1bef48e81d3a201210201973a41bb610e199a1fbb208398fbacc732c3658d132dbf9f3a394bedc9a7b5', 'index': 43, 'prev_out': {'type': 0, 'spent': True, 'value': 1916152219, 'spending_outpoints': [{'tx_index': 1648482771718813, 'n': 43}], 'n': 0, 'tx_index': 2218296313784117, 'script': '76a914adfb8786f19039b78a78a999e04d68348d0571be88ac', 'addr': '1GrwDkr33gT6LuumniYjKEGjTLhsL5kmqC'}}, {'sequence': 4294967295, 'witness': '', 'script': '4830450221009310e71d1e9c2d189f81b4a87b1c93137b8c31da76ea9592ed14a935b9165715022009effdc87ed33741712bee98276a0f7b306e59f3f559dba78641497d4e250b7201210201973a41bb610e199a1fbb208398fbacc732c3658d132dbf9f3a394bedc9a7b5', 'index': 44, 'prev_out': {'type': 0, 'spent': True, 'value': 1896646336, 'spending_outpoints': [{'tx_index': 1648482771718813, 'n': 44}], 'n': 8, 'tx_index': 8352642893789858, 'script': '76a914adfb8786f19039b78a78a999e04d68348d0571be88ac', 'addr': '1GrwDkr33gT6LuumniYjKEGjTLhsL5kmqC'}}, {'sequence': 4294967295, 'witness': '', 'script': '483045022100a87f1c72d3d9b97198a973e02139130c307eaa1eb1cec993d9411bfa8c3ab56f02203f3fb5500090495b1fcfb2a6614c48ba3f80526440230b43f5c17ea604782d2601210201973a41bb610e199a1fbb208398fbacc732c3658d132dbf9f3a394bedc9a7b5', 'index': 45, 'prev_out': {'type': 0, 'spent': True, 'value': 1892095899, 'spending_outpoints': [{'tx_index': 1648482771718813, 'n': 45}], 'n': 0, 'tx_index': 5440196910737901, 'script': '76a914adfb8786f19039b78a78a999e04d68348d0571be88ac', 'addr': '1GrwDkr33gT6LuumniYjKEGjTLhsL5kmqC'}}, {'sequence': 4294967295, 'witness': '', 'script': '483045022100b9cba2b5a61c26e4f5f0ea44fe1b3e70d481f2fd59853d95a8d466fbfe4828dc02200631f37e9bcf9b9eded97f4fec8f3555f619ab6cddc934e8b77367a61b439a0301210201973a41bb610e199a1fbb208398fbacc732c3658d132dbf9f3a394bedc9a7b5', 'index': 46, 'prev_out': {'type': 0, 'spent': True, 'value': 1869916149, 'spending_outpoints': [{'tx_index': 1648482771718813, 'n': 46}], 'n': 0, 'tx_index': 3983018543271147, 'script': '76a914adfb8786f19039b78a78a999e04d68348d0571be88ac', 'addr': '1GrwDkr33gT6LuumniYjKEGjTLhsL5kmqC'}}, {'sequence': 4294967295, 'witness': '', 'script': '4830450221008b094f4177921bdb2948caf7928ea6d563dcd84a6c798e984adda9bd8832e0f202202053d617384b3861c1849de67693a9559444a60e936719f7fc322e2d177e423001210201973a41bb610e199a1fbb208398fbacc732c3658d132dbf9f3a394bedc9a7b5', 'index': 47, 'prev_out': {'type': 0, 'spent': True, 'value': 1841382939, 'spending_outpoints': [{'tx_index': 1648482771718813, 'n': 47}], 'n': 0, 'tx_index': 8628394632646381, 'script': '76a914adfb8786f19039b78a78a999e04d68348d0571be88ac', 'addr': '1GrwDkr33gT6LuumniYjKEGjTLhsL5kmqC'}}, {'sequence': 4294967295, 'witness': '', 'script': '48304502210098d150f36fedb86a7d9f6f33727905b0269e02efdc8baa6a616c5f0009a8465e02203b55df782027c443d50e1da210276a0c7129ec0066dca24fa12931a7e9aaf4da01210201973a41bb610e199a1fbb208398fbacc732c3658d132dbf9f3a394bedc9a7b5', 'index': 48, 'prev_out': {'type': 0, 'spent': True, 'value': 1814315371, 'spending_outpoints': [{'tx_index': 1648482771718813, 'n': 48}], 'n': 0, 'tx_index': 8878626453708285, 'script': '76a914adfb8786f19039b78a78a999e04d68348d0571be88ac', 'addr': '1GrwDkr33gT6LuumniYjKEGjTLhsL5kmqC'}}, {'sequence': 4294967295, 'witness': '', 'script': '483045022100c1f9657b67210748366c5905afc7b698464f158b0ceea9718207bd8ec7dc093f02203725e830d796270598a44ae895cfa56275acc7755fdfcb9419f76c96488ebae401210201973a41bb610e199a1fbb208398fbacc732c3658d132dbf9f3a394bedc9a7b5', 'index': 49, 'prev_out': {'type': 0, 'spent': True, 'value': 1799804990, 'spending_outpoints': [{'tx_index': 1648482771718813, 'n': 49}], 'n': 0, 'tx_index': 523617316604885, 'script': '76a914adfb8786f19039b78a78a999e04d68348d0571be88ac', 'addr': '1GrwDkr33gT6LuumniYjKEGjTLhsL5kmqC'}}, {'sequence': 4294967295, 'witness': '', 'script': '473044022073fb48481653e50d0841efe9d1bb508c53a01ae490b06c20858f743046feac290220383905a0e673f22d576cfb48e345594f37f06e03a9df124dfecbc7f9f77a0b8201210201973a41bb610e199a1fbb208398fbacc732c3658d132dbf9f3a394bedc9a7b5', 'index': 50, 'prev_out': {'type': 0, 'spent': True, 'value': 1771157164, 'spending_outpoints': [{'tx_index': 1648482771718813, 'n': 50}], 'n': 8, 'tx_index': 8950863796567947, 'script': '76a914adfb8786f19039b78a78a999e04d68348d0571be88ac', 'addr': '1GrwDkr33gT6LuumniYjKEGjTLhsL5kmqC'}}, {'sequence': 4294967295, 'witness': '', 'script': '47304402200c1e26bb74a77052ddc4a45672521f82f2c57559a2f0ff4dae1fe6ad57da517a0220047afee1e5e743d8ff258d2b1f0315f070e9882f3096ec53e102a559aac21f8901210201973a41bb610e199a1fbb208398fbacc732c3658d132dbf9f3a394bedc9a7b5', 'index': 51, 'prev_out': {'type': 0, 'spent': True, 'value': 1715389330, 'spending_outpoints': [{'tx_index': 1648482771718813, 'n': 51}], 'n': 0, 'tx_index': 8825875784367352, 'script': '76a914adfb8786f19039b78a78a999e04d68348d0571be88ac', 'addr': '1GrwDkr33gT6LuumniYjKEGjTLhsL5kmqC'}}, {'sequence': 4294967295, 'witness': '', 'script': '483045022100a8fb822534510753128c385ddb015ea2ce8303237439ee7cbcb3ba56ac507c5c0220341fb6847e3908a99b2e87ab6e7ceffae2d9734f2c44264add683be7ce9583ea01210201973a41bb610e199a1fbb208398fbacc732c3658d132dbf9f3a394bedc9a7b5', 'index': 52, 'prev_out': {'type': 0, 'spent': True, 'value': 1711888711, 'spending_outpoints': [{'tx_index': 1648482771718813, 'n': 52}], 'n': 0, 'tx_index': 2984371813305431, 'script': '76a914adfb8786f19039b78a78a999e04d68348d0571be88ac', 'addr': '1GrwDkr33gT6LuumniYjKEGjTLhsL5kmqC'}}, {'sequence': 4294967295, 'witness': '', 'script': '483045022100a5abe4b839b8cb800146251d6eb16b57f1cd57cb92202bb8fe886bc5af32aed702207ba08a1d939b4ce9c3ae74ca7d66bec24348d49a145bcc5b758249f57135d08101210201973a41bb610e199a1fbb208398fbacc732c3658d132dbf9f3a394bedc9a7b5', 'index': 53, 'prev_out': {'type': 0, 'spent': True, 'value': 1702812827, 'spending_outpoints': [{'tx_index': 1648482771718813, 'n': 53}], 'n': 9, 'tx_index': 6721796407602264, 'script': '76a914adfb8786f19039b78a78a999e04d68348d0571be88ac', 'addr': '1GrwDkr33gT6LuumniYjKEGjTLhsL5kmqC'}}, {'sequence': 4294967295, 'witness': '', 'script': '473044022036e5012f119c79064894ab6195b093d6d0708802a696b79667477507c15248900220096f12cb481b9d70512a85f3dc79a079bf5fc5e1454b848d1fe39565a33e185801210201973a41bb610e199a1fbb208398fbacc732c3658d132dbf9f3a394bedc9a7b5', 'index': 54, 'prev_out': {'type': 0, 'spent': True, 'value': 1668494119, 'spending_outpoints': [{'tx_index': 1648482771718813, 'n': 54}], 'n': 0, 'tx_index': 148542871294249, 'script': '76a914adfb8786f19039b78a78a999e04d68348d0571be88ac', 'addr': '1GrwDkr33gT6LuumniYjKEGjTLhsL5kmqC'}}, {'sequence': 4294967295, 'witness': '', 'script': '483045022100b4c135529341220c1cbd270a221b8e2a3255f5a398c0dca48a797fa3302582fd02200e054b812ea9b4cec850d8b5601a299d30a06b7c6c67eb782174c34b122c657c01210201973a41bb610e199a1fbb208398fbacc732c3658d132dbf9f3a394bedc9a7b5', 'index': 55, 'prev_out': {'type': 0, 'spent': True, 'value': 1656911300, 'spending_outpoints': [{'tx_index': 1648482771718813, 'n': 55}], 'n': 0, 'tx_index': 5454484098041119, 'script': '76a914adfb8786f19039b78a78a999e04d68348d0571be88ac', 'addr': '1GrwDkr33gT6LuumniYjKEGjTLhsL5kmqC'}}, {'sequence': 4294967295, 'witness': '', 'script': '473044022052104b6c1ff70068189481a6d93e98168ad8183ef821c853e3f41e620fba33640220772feeb116a7f39c9dbb3d03e1f5fab5177a98a299798cf7c75d3e1fa9b2d5b201210201973a41bb610e199a1fbb208398fbacc732c3658d132dbf9f3a394bedc9a7b5', 'index': 56, 'prev_out': {'type': 0, 'spent': True, 'value': 1639419038, 'spending_outpoints': [{'tx_index': 1648482771718813, 'n': 56}], 'n': 4, 'tx_index': 7321867987801440, 'script': '76a914adfb8786f19039b78a78a999e04d68348d0571be88ac', 'addr': '1GrwDkr33gT6LuumniYjKEGjTLhsL5kmqC'}}, {'sequence': 4294967295, 'witness': '', 'script': '483045022100c149a5d3debe0a88c35a7730055bf71e9859d775964b9ce0003a451c058996b202200f63df9999d57c0829ae5b7f63ca7562555886818ff7ce3f9c922c58755a025b01210201973a41bb610e199a1fbb208398fbacc732c3658d132dbf9f3a394bedc9a7b5', 'index': 57, 'prev_out': {'type': 0, 'spent': True, 'value': 1625583930, 'spending_outpoints': [{'tx_index': 1648482771718813, 'n': 57}], 'n': 9, 'tx_index': 5222403897871702, 'script': '76a914adfb8786f19039b78a78a999e04d68348d0571be88ac', 'addr': '1GrwDkr33gT6LuumniYjKEGjTLhsL5kmqC'}}, {'sequence': 4294967295, 'witness': '', 'script': '47304402204e173c119735a74ad492b9d8b1ea3d453ada630a3a0540a80f73d2a26f036abe02200b220bf99f2ca0f2bf505bf72c532e45f7b5e7cc75b0ceecc803ed1e7f1a591901210201973a41bb610e199a1fbb208398fbacc732c3658d132dbf9f3a394bedc9a7b5', 'index': 58, 'prev_out': {'type': 0, 'spent': True, 'value': 1616370595, 'spending_outpoints': [{'tx_index': 1648482771718813, 'n': 58}], 'n': 0, 'tx_index': 4326089975019763, 'script': '76a914adfb8786f19039b78a78a999e04d68348d0571be88ac', 'addr': '1GrwDkr33gT6LuumniYjKEGjTLhsL5kmqC'}}, {'sequence': 4294967295, 'witness': '', 'script': '4730440220115c2d73492fa752e85c874b1cc29be7b44060bb710c85aa2169f4b4fd8f2746022059e0cbea94ade5ff46b7701f1341e129904fe8e8f3fe25edeb23959726c0242601210201973a41bb610e199a1fbb208398fbacc732c3658d132dbf9f3a394bedc9a7b5', 'index': 59, 'prev_out': {'type': 0, 'spent': True, 'value': 1579705676, 'spending_outpoints': [{'tx_index': 1648482771718813, 'n': 59}], 'n': 0, 'tx_index': 7147830114026314, 'script': '76a914adfb8786f19039b78a78a999e04d68348d0571be88ac', 'addr': '1GrwDkr33gT6LuumniYjKEGjTLhsL5kmqC'}}, {'sequence': 4294967295, 'witness': '', 'script': '483045022100ded67d733b1ede6af2335d2027a44e629e953a1efbf83b01c1ff7236f756327302203a0d65400c70f707da474ee97d810ecd39acddcf3344baf6f1944186ff55d93c01210201973a41bb610e199a1fbb208398fbacc732c3658d132dbf9f3a394bedc9a7b5', 'index': 60, 'prev_out': {'type': 0, 'spent': True, 'value': 1559375550, 'spending_outpoints': [{'tx_index': 1648482771718813, 'n': 60}], 'n': 6, 'tx_index': 3857843198781881, 'script': '76a914adfb8786f19039b78a78a999e04d68348d0571be88ac', 'addr': '1GrwDkr33gT6LuumniYjKEGjTLhsL5kmqC'}}, {'sequence': 4294967295, 'witness': '', 'script': '483045022100c5be1e80e2d41a06a23d719b9ff40c20b7b4cee8daf2c21fa0ca200dc69c3fd102202ce85cdc421956585e45246e8b42cd8677f1fa38c50dc7b940803a5a6562efb901210201973a41bb610e199a1fbb208398fbacc732c3658d132dbf9f3a394bedc9a7b5', 'index': 61, 'prev_out': {'type': 0, 'spent': True, 'value': 1541248547, 'spending_outpoints': [{'tx_index': 1648482771718813, 'n': 61}], 'n': 0, 'tx_index': 1277818912047864, 'script': '76a914adfb8786f19039b78a78a999e04d68348d0571be88ac', 'addr': '1GrwDkr33gT6LuumniYjKEGjTLhsL5kmqC'}}, {'sequence': 4294967295, 'witness': '', 'script': '483045022100e655d4c9f7148c8fb217f7f3273967dcbe7119f037fd3043a2de8df1a20edeb102203aaae28a3bf0f218bfdbe0ca1844f5de956b2f90cf99e4e929011795fe229e2201210201973a41bb610e199a1fbb208398fbacc732c3658d132dbf9f3a394bedc9a7b5', 'index': 62, 'prev_out': {'type': 0, 'spent': True, 'value': 1536855926, 'spending_outpoints': [{'tx_index': 1648482771718813, 'n': 62}], 'n': 0, 'tx_index': 5489451647466630, 'script': '76a914adfb8786f19039b78a78a999e04d68348d0571be88ac', 'addr': '1GrwDkr33gT6LuumniYjKEGjTLhsL5kmqC'}}, {'sequence': 4294967295, 'witness': '', 'script': '473044022041b6c654791ef8df635fffa6fe4390bd97dc12403a8e6000382afbc920035bb4022028f1dfbd3714069cee81c4e04ee32e3c14a904b8e8ec8299cb5d5ba9ecdafb5701210201973a41bb610e199a1fbb208398fbacc732c3658d132dbf9f3a394bedc9a7b5', 'index': 63, 'prev_out': {'type': 0, 'spent': True, 'value': 1535646082, 'spending_outpoints': [{'tx_index': 1648482771718813, 'n': 63}], 'n': 0, 'tx_index': 3569799836615935, 'script': '76a914adfb8786f19039b78a78a999e04d68348d0571be88ac', 'addr': '1GrwDkr33gT6LuumniYjKEGjTLhsL5kmqC'}}, {'sequence': 4294967295, 'witness': '', 'script': '4730440220387f363a3cf9240ec8c14faa2d1d86fdd270043d109b64401f75b06a107cf5fe02207321ce4c2c14e63885113d1efdb5103fa1af350c6a674095580eb5462cd9ceed01210201973a41bb610e199a1fbb208398fbacc732c3658d132dbf9f3a394bedc9a7b5', 'index': 64, 'prev_out': {'type': 0, 'spent': True, 'value': 1447147098, 'spending_outpoints': [{'tx_index': 1648482771718813, 'n': 64}], 'n': 0, 'tx_index': 6840897444483977, 'script': '76a914adfb8786f19039b78a78a999e04d68348d0571be88ac', 'addr': '1GrwDkr33gT6LuumniYjKEGjTLhsL5kmqC'}}, {'sequence': 4294967295, 'witness': '', 'script': '483045022100eb0a9638929112a51f0e30d10ecf987fff76698c4fac32e0bded042a96c7d535022002a50a41e9e6a9f175ac69ea1fb501bf78ef900a7102dc3e86aeb496ab4e813001210201973a41bb610e199a1fbb208398fbacc732c3658d132dbf9f3a394bedc9a7b5', 'index': 65, 'prev_out': {'type': 0, 'spent': True, 'value': 1422470188, 'spending_outpoints': [{'tx_index': 1648482771718813, 'n': 65}], 'n': 0, 'tx_index': 6701377760662193, 'script': '76a914adfb8786f19039b78a78a999e04d68348d0571be88ac', 'addr': '1GrwDkr33gT6LuumniYjKEGjTLhsL5kmqC'}}, {'sequence': 4294967295, 'witness': '', 'script': '483045022100848ebc9706b154d919e36b66bbb492ec7c2cf4da9a41502567718d402133e652022075899cf89d260b715213235a3063c13b0ce7caee7acc337b4546798b9d7277d301210201973a41bb610e199a1fbb208398fbacc732c3658d132dbf9f3a394bedc9a7b5', 'index': 66, 'prev_out': {'type': 0, 'spent': True, 'value': 1390729117, 'spending_outpoints': [{'tx_index': 1648482771718813, 'n': 66}], 'n': 0, 'tx_index': 7940502411520208, 'script': '76a914adfb8786f19039b78a78a999e04d68348d0571be88ac', 'addr': '1GrwDkr33gT6LuumniYjKEGjTLhsL5kmqC'}}, {'sequence': 4294967295, 'witness': '', 'script': '483045022100eb92dfac73ba26ddacb6c4a34e7465a0a3d3fafcb574a2d86c610ade35f7c42802203bb572643c9599b65601f36f4b84381153ec64bd5d27f44307ecac579d2c52ea01210201973a41bb610e199a1fbb208398fbacc732c3658d132dbf9f3a394bedc9a7b5', 'index': 67, 'prev_out': {'type': 0, 'spent': True, 'value': 1355113981, 'spending_outpoints': [{'tx_index': 1648482771718813, 'n': 67}], 'n': 0, 'tx_index': 5838591262281190, 'script': '76a914adfb8786f19039b78a78a999e04d68348d0571be88ac', 'addr': '1GrwDkr33gT6LuumniYjKEGjTLhsL5kmqC'}}, {'sequence': 4294967295, 'witness': '', 'script': '483045022100b32d0a3548966d2e1cc2db8cbf164de566fe624383fe804ed602fb4555f45bde02207188a9486fd9690769090cb7f7893d0125064ab7055183a8840c153f5fd9d38d012103f250289afc1604963ad079a60a9654bd83f405fb0293258f405248eb53b4afdb', 'index': 68, 'prev_out': {'type': 0, 'spent': True, 'value': 1330000000, 'spending_outpoints': [{'tx_index': 1648482771718813, 'n': 68}], 'n': 1, 'tx_index': 6486731319457643, 'script': '76a914d27e576bc95c7c72078390a6bc3703ebfa9f23ce88ac', 'addr': '1LBzFeQSkU3gju2zQGU9D3mmpixTkFA9gr'}}, {'sequence': 4294967295, 'witness': '', 'script': '4730440220569b1f1eaecdd40b09bef9425c78cee991f68a84fbecf804866ffb5b101a9d3b022039203889f92955bd44bd53f06d92fe4b40af03f344230a78f4eeba4990e41c9801210201973a41bb610e199a1fbb208398fbacc732c3658d132dbf9f3a394bedc9a7b5', 'index': 69, 'prev_out': {'type': 0, 'spent': True, 'value': 1326331384, 'spending_outpoints': [{'tx_index': 1648482771718813, 'n': 69}], 'n': 0, 'tx_index': 8982016471940991, 'script': '76a914adfb8786f19039b78a78a999e04d68348d0571be88ac', 'addr': '1GrwDkr33gT6LuumniYjKEGjTLhsL5kmqC'}}, {'sequence': 4294967295, 'witness': '', 'script': '483045022100ea7f9f1bb1fa936e64ac8352e4e81eefe4d6b1d5ab3d4aa1c88cf8c41d8f7d8102202afd90dee87a20623f4d6c6f93b0505367c8b375a7cc0052ecc4dcfdb669c19f0121020e6965eb8397fcdaac0b323bde6f7d9fc8eb42011b33373df75e8d1c1d31746c', 'index': 70, 'prev_out': {'type': 0, 'spent': True, 'value': 1303000000, 'spending_outpoints': [{'tx_index': 1648482771718813, 'n': 70}], 'n': 3, 'tx_index': 4742602483200145, 'script': '76a9142b362e67196de5a2892712f1e718fe1746d8898488ac', 'addr': '14wUxq4jj7HWkDdAnCf2jakhCMDd79C3f8'}}, {'sequence': 4294967295, 'witness': '', 'script': '47304402201eda5702c44731e70c16c3c628f1003448472b4b8c586f1002813f4528d1ee46022073b1da0ce7d1f34993729ed9f97f2585ebd09bbbd7332fbaec1e7a3e9190da4a01210201973a41bb610e199a1fbb208398fbacc732c3658d132dbf9f3a394bedc9a7b5', 'index': 71, 'prev_out': {'type': 0, 'spent': True, 'value': 1300456925, 'spending_outpoints': [{'tx_index': 1648482771718813, 'n': 71}], 'n': 0, 'tx_index': 8630781715911895, 'script': '76a914adfb8786f19039b78a78a999e04d68348d0571be88ac', 'addr': '1GrwDkr33gT6LuumniYjKEGjTLhsL5kmqC'}}, {'sequence': 4294967295, 'witness': '', 'script': '483045022100eaa5b09f4e8264054ef1371b5632e518a1a8395a15dbed538dd872cdb14023280220080e1d2ea4884f8e383d975d6fc04a084dff486816bd2e7ca453d71c0c6281cb01210201973a41bb610e199a1fbb208398fbacc732c3658d132dbf9f3a394bedc9a7b5', 'index': 72, 'prev_out': {'type': 0, 'spent': True, 'value': 1265806430, 'spending_outpoints': [{'tx_index': 1648482771718813, 'n': 72}], 'n': 0, 'tx_index': 5095759940290967, 'script': '76a914adfb8786f19039b78a78a999e04d68348d0571be88ac', 'addr': '1GrwDkr33gT6LuumniYjKEGjTLhsL5kmqC'}}, {'sequence': 4294967295, 'witness': '', 'script': '483045022100b9b4e5432eecf424585acd57d38661cf4c179d3236dab1e6d3d18fa034f93245022051daa8167c6af6a1560f18015ef4fab8acd41df45e33da5fbd47dc814e4712f101210201973a41bb610e199a1fbb208398fbacc732c3658d132dbf9f3a394bedc9a7b5', 'index': 73, 'prev_out': {'type': 0, 'spent': True, 'value': 1257153659, 'spending_outpoints': [{'tx_index': 1648482771718813, 'n': 73}], 'n': 0, 'tx_index': 265755579566905, 'script': '76a914adfb8786f19039b78a78a999e04d68348d0571be88ac', 'addr': '1GrwDkr33gT6LuumniYjKEGjTLhsL5kmqC'}}, {'sequence': 4294967295, 'witness': '', 'script': '483045022100da31aab8664d2f7978b386f9669ee8dd508b900b577e1378037e5fa472c40e0b0220532ca752de243e90f915258af8a3742a4c961593a4736e1237404b9b95028e8901210201973a41bb610e199a1fbb208398fbacc732c3658d132dbf9f3a394bedc9a7b5', 'index': 74, 'prev_out': {'type': 0, 'spent': True, 'value': 1253543388, 'spending_outpoints': [{'tx_index': 1648482771718813, 'n': 74}], 'n': 0, 'tx_index': 2484247936171429, 'script': '76a914adfb8786f19039b78a78a999e04d68348d0571be88ac', 'addr': '1GrwDkr33gT6LuumniYjKEGjTLhsL5kmqC'}}, {'sequence': 4294967295, 'witness': '', 'script': '4730440220091aa3001c46e520204723fe6882e9450732bb21c644af7034934efc77f37627022032617fa270816f081e139442e08b6a85e963d5084d0179e41da2378e6d725a4801210201973a41bb610e199a1fbb208398fbacc732c3658d132dbf9f3a394bedc9a7b5', 'index': 75, 'prev_out': {'type': 0, 'spent': True, 'value': 1248210959, 'spending_outpoints': [{'tx_index': 1648482771718813, 'n': 75}], 'n': 0, 'tx_index': 7995289518982531, 'script': '76a914adfb8786f19039b78a78a999e04d68348d0571be88ac', 'addr': '1GrwDkr33gT6LuumniYjKEGjTLhsL5kmqC'}}, {'sequence': 4294967295, 'witness': '', 'script': '47304402200b619f5927118ccb0221f9217f50a84b6856521388b5980ade79c8e7d3753efe022032809439f32397566a42d41af53fcab0e765fd7d1217388f56074a5dc3e1273201210201973a41bb610e199a1fbb208398fbacc732c3658d132dbf9f3a394bedc9a7b5', 'index': 76, 'prev_out': {'type': 0, 'spent': True, 'value': 1225398061, 'spending_outpoints': [{'tx_index': 1648482771718813, 'n': 76}], 'n': 0, 'tx_index': 1146914704724198, 'script': '76a914adfb8786f19039b78a78a999e04d68348d0571be88ac', 'addr': '1GrwDkr33gT6LuumniYjKEGjTLhsL5kmqC'}}, {'sequence': 4294967295, 'witness': '', 'script': '47304402200bc6c2c2c2fdac74197ffe666000605a72755b67593b3d3d97ad30652513120902202ca6a1123f51fc5246d1912010554603fb84c9c11c339275ae387ce83499614201210201973a41bb610e199a1fbb208398fbacc732c3658d132dbf9f3a394bedc9a7b5', 'index': 77, 'prev_out': {'type': 0, 'spent': True, 'value': 1203899248, 'spending_outpoints': [{'tx_index': 1648482771718813, 'n': 77}], 'n': 0, 'tx_index': 3560503856100434, 'script': '76a914adfb8786f19039b78a78a999e04d68348d0571be88ac', 'addr': '1GrwDkr33gT6LuumniYjKEGjTLhsL5kmqC'}}, {'sequence': 4294967295, 'witness': '', 'script': '47304402205b593ee50b1a1cca7753ab697a7f76efb39483b6df3bf32d2830d2f33011ce4c022071ef9c767636e845eb5f0e9c039446b35ac6892823fb1df508c438f7bc7eced701210201973a41bb610e199a1fbb208398fbacc732c3658d132dbf9f3a394bedc9a7b5', 'index': 78, 'prev_out': {'type': 0, 'spent': True, 'value': 1185269221, 'spending_outpoints': [{'tx_index': 1648482771718813, 'n': 78}], 'n': 11, 'tx_index': 3583452805140780, 'script': '76a914adfb8786f19039b78a78a999e04d68348d0571be88ac', 'addr': '1GrwDkr33gT6LuumniYjKEGjTLhsL5kmqC'}}, {'sequence': 4294967295, 'witness': '', 'script': '4730440220445649d6e81d48872b7e634091228ea5f8849ffc222c41eac46b4928bce570da02200f0c974c2e6fa77b162caa0b1866fc0a75790b11213cda4c20eca7a03907dd7c01210201973a41bb610e199a1fbb208398fbacc732c3658d132dbf9f3a394bedc9a7b5', 'index': 79, 'prev_out': {'type': 0, 'spent': True, 'value': 1173583839, 'spending_outpoints': [{'tx_index': 1648482771718813, 'n': 79}], 'n': 0, 'tx_index': 5107762494946116, 'script': '76a914adfb8786f19039b78a78a999e04d68348d0571be88ac', 'addr': '1GrwDkr33gT6LuumniYjKEGjTLhsL5kmqC'}}, {'sequence': 4294967295, 'witness': '', 'script': '47304402204047c1c8dd2f0c1fcabdf0abf8d5c03c688f10a1026997b29cccf21c9b9b57c902205e1792ac07111c94890b534bca78cff2d9708a9f50a07c3aea3ecfef1f5f972b01210201973a41bb610e199a1fbb208398fbacc732c3658d132dbf9f3a394bedc9a7b5', 'index': 80, 'prev_out': {'type': 0, 'spent': True, 'value': 1147692686, 'spending_outpoints': [{'tx_index': 1648482771718813, 'n': 80}], 'n': 0, 'tx_index': 7488536303548481, 'script': '76a914adfb8786f19039b78a78a999e04d68348d0571be88ac', 'addr': '1GrwDkr33gT6LuumniYjKEGjTLhsL5kmqC'}}, {'sequence': 4294967295, 'witness': '', 'script': '483045022100f8ac7a248bc03579594e4acbf9d0481fa9a3c724335b7087a0d1136ea016b8d6022048dc02c76f98cd522048f0845bd02565c024d7fcd5800344b8103f53f167ed5901210201973a41bb610e199a1fbb208398fbacc732c3658d132dbf9f3a394bedc9a7b5', 'index': 81, 'prev_out': {'type': 0, 'spent': True, 'value': 1135563686, 'spending_outpoints': [{'tx_index': 1648482771718813, 'n': 81}], 'n': 0, 'tx_index': 6079647231383422, 'script': '76a914adfb8786f19039b78a78a999e04d68348d0571be88ac', 'addr': '1GrwDkr33gT6LuumniYjKEGjTLhsL5kmqC'}}]","[{'type': 0, 'spent': False, 'value': 200000000000, 'spending_outpoints': [], 'n': 0, 'tx_index': 1648482771718813, 'script': '0020eab3cd0683f9554a66261793846f509ceaefd2cd4dfc20adf400689eb4addc09', 'addr': 'bc1qa2eu6p5rl9255e3xz7fcgm6snn4wl5kdfh7zpt05qp5fad9dmsys0qjg0e'}, {'type': 0, 'spent': True, 'value': 251789637, 'spending_outpoints': [{'tx_index': 6394532380049053, 'n': 6}], 'n': 1, 'tx_index': 1648482771718813, 'script': '76a914adfb8786f19039b78a78a999e04d68348d0571be88ac', 'addr': '1GrwDkr33gT6LuumniYjKEGjTLhsL5kmqC'}]",200000000000,5171031881312
af41da245d15b90419eaaa6bc6102d00437ebb82d8971a3193f1e9b28f06d34e,2,21,2,3185,12740,79650,0.0.0.0,0,2773384164695358,False,1730473181,868424,868424,"[{'sequence': 4294967295, 'witness': '', 'script': '4730440220600f4ddfd40a3cbc75453eb44a3283ff359a8356addc750342285fff503226f50220063331719d17298976395eea86d73579aab1cf75fa075baae16919e6b255f10f01210201973a41bb610e199a1fbb208398fbacc732c3658d132dbf9f3a394bedc9a7b5', 'index': 0, 'prev_out': {'type': 0, 'spent': True, 'value': 2691433537, 'spending_outpoints': [{'tx_index': 2773384164695358, 'n': 0}], 'n': 18, 'tx_index': 7548290377005927, 'script': '76a914adfb8786f19039b78a78a999e04d68348d0571be88ac', 'addr': '1GrwDkr33gT6LuumniYjKEGjTLhsL5kmqC'}}, {'sequence': 4294967295, 'witness': '', 'script': '4830450221009aa6aa65877282174ebf204bde2c18cc2547f1ffeb94ccfe0583ced44e84b00e02201a54e4d35510ca463a74a71c8c827ffd39575e6061b8d867c53e47e71d8fa34501210201973a41bb610e199a1fbb208398fbacc732c3658d132dbf9f3a394bedc9a7b5', 'index': 1, 'prev_out': {'type': 0, 'spent': True, 'value': 2671676428, 'spending_outpoints': [{'tx_index': 2773384164695358, 'n': 1}], 'n': 20, 'tx_index': 8622549982827487, 'script': '76a914adfb8786f19039b78a78a999e04d68348d0571be88ac', 'addr': '1GrwDkr33gT6LuumniYjKEGjTLhsL5kmqC'}}, {'sequence': 4294967295, 'witness': '', 'script': '483045022100e9b331b0ca998a289d15a838c1953f754449f9fe4a30e191a18d7d4529759c7c02200a18d9e28839e307c6c3594ba8499d1b3088da6c6ee43035b118db7945dddc1d01210201973a41bb610e199a1fbb208398fbacc732c3658d132dbf9f3a394bedc9a7b5', 'index': 2, 'prev_out': {'type': 0, 'spent': True, 'value': 2624826574, 'spending_outpoints': [{'tx_index': 2773384164695358, 'n': 2}], 'n': 16, 'tx_index': 618881769309231, 'script': '76a914adfb8786f19039b78a78a999e04d68348d0571be88ac', 'addr': '1GrwDkr33gT6LuumniYjKEGjTLhsL5kmqC'}}, {'sequence': 4294967295, 'witness': '', 'script': '483045022100bd543722c25ffb86e05491df4066c97dc76928d467c892eb16a91da909e870b502207d75b37d8f07e7928caed4774b5d3a6b606219e8189d769d1f10f13986f38f7201210201973a41bb610e199a1fbb208398fbacc732c3658d132dbf9f3a394bedc9a7b5', 'index': 3, 'prev_out': {'type': 0, 'spent': True, 'value': 2568325943, 'spending_outpoints': [{'tx_index': 2773384164695358, 'n': 3}], 'n': 15, 'tx_index': 6823804922662913, 'script': '76a914adfb8786f19039b78a78a999e04d68348d0571be88ac', 'addr': '1GrwDkr33gT6LuumniYjKEGjTLhsL5kmqC'}}, {'sequence': 4294967295, 'witness': '', 'script': '4730440220133d419687602881181d6813d73e42ebe9ad38283387c69661df6ebebbd364c402201bb2204f401a621d9f475694f73fae1d1faa992c1e37eda06e062b667eb28c9501210201973a41bb610e199a1fbb208398fbacc732c3658d132dbf9f3a394bedc9a7b5', 'index': 4, 'prev_out': {'type': 0, 'spent': True, 'value': 2472960306, 'spending_outpoints': [{'tx_index': 2773384164695358, 'n': 4}], 'n': 16, 'tx_index': 6143663079123014, 'script': '76a914adfb8786f19039b78a78a999e04d68348d0571be88ac', 'addr': '1GrwDkr33gT6LuumniYjKEGjTLhsL5kmqC'}}, {'sequence': 4294967295, 'witness': '', 'script': '47304402206fb91dee73664e3b94035190c78636fc0cead2ef33d5f36803854b4b08cbb71c02200352eeba8129379ed38120917a577144fe5b5db1792324092a3866d1a51562b001210201973a41bb610e199a1fbb208398fbacc732c3658d132dbf9f3a394bedc9a7b5', 'index': 5, 'prev_out': {'type': 0, 'spent': True, 'value': 2463824088, 'spending_outpoints': [{'tx_index': 2773384164695358, 'n': 5}], 'n': 10, 'tx_index': 5308581812277387, 'script': '76a914adfb8786f19039b78a78a999e04d68348d0571be88ac', 'addr': '1GrwDkr33gT6LuumniYjKEGjTLhsL5kmqC'}}, {'sequence': 4294967295, 'witness': '', 'script': '47304402205b2cc7a452d45f13afbb5a38f0283aedf85b52e0c897b174c8fb2aacd72b54ad0220214bbc3fd70560a428dad547a36cc053f61fffcde5939bccff3099213e3d707701210201973a41bb610e199a1fbb208398fbacc732c3658d132dbf9f3a394bedc9a7b5', 'index': 6, 'prev_out': {'type': 0, 'spent': True, 'value': 2414121422, 'spending_outpoints': [{'tx_index': 2773384164695358, 'n': 6}], 'n': 22, 'tx_index': 2988898017582621, 'script': '76a914adfb8786f19039b78a78a999e04d68348d0571be88ac', 'addr': '1GrwDkr33gT6LuumniYjKEGjTLhsL5kmqC'}}, {'sequence': 4294967295, 'witness': '', 'script': '4730440220662bb6cab9e4f94499fca5ef8929288a1904d4f72cc86652a502282fc8ce2b640220544e6061d34591f6ae1f1eb8a575a1b29380b88382587b0d7280dbcacf6a6b3301210201973a41bb610e199a1fbb208398fbacc732c3658d132dbf9f3a394bedc9a7b5', 'index': 7, 'prev_out': {'type': 0, 'spent': True, 'value': 2407776126, 'spending_outpoints': [{'tx_index': 2773384164695358, 'n': 7}], 'n': 14, 'tx_index': 6415014268008477, 'script': '76a914adfb8786f19039b78a78a999e04d68348d0571be88ac', 'addr': '1GrwDkr33gT6LuumniYjKEGjTLhsL5kmqC'}}, {'sequence': 4294967295, 'witness': '', 'script': '47304402207da83e8c342c7e55f09f6eb2aa9ad611c3ff6ba67f3eaaab2747f3289a063c6002204d21b303157d21f2d21a73c3d9c2370ffe75f242ed362df9c87a5f0af390ce22012102cc21db868916d06d918624c35ff4a9fcd54b4e3d6e00a4f999e71e6b68ae171a', 'index': 8, 'prev_out': {'type': 0, 'spent': True, 'value': 2406720000, 'spending_outpoints': [{'tx_index': 2773384164695358, 'n': 8}], 'n': 0, 'tx_index': 4281107230635663, 'script': '76a914848970eba939f28cc4f8024517bb8db74fe2601b88ac', 'addr': '1D5nqtzQKMSUq4k9aqWHhRqH6Vsah51u3g'}}, {'sequence': 4294967295, 'witness': '', 'script': '483045022100c7bf5c745cf3860625c85a961166ae59757e6335441acca108e3ee4a8db31d9902202694861a44f8ac637858039751e502f38213e2fda1fef2eaa617740d44675ea801210201973a41bb610e199a1fbb208398fbacc732c3658d132dbf9f3a394bedc9a7b5', 'index': 9, 'prev_out': {'type': 0, 'spent': True, 'value': 2394804326, 'spending_outpoints': [{'tx_index': 2773384164695358, 'n': 9}], 'n': 12, 'tx_index': 8441638226659634, 'script': '76a914adfb8786f19039b78a78a999e04d68348d0571be88ac', 'addr': '1GrwDkr33gT6LuumniYjKEGjTLhsL5kmqC'}}, {'sequence': 4294967295, 'witness': '', 'script': '483045022100f71b0d4ca5b23b2e7dab04485778353f7db4c0f7210f4feedec293ce858d27600220479b1bc2b208f2a1ffae46cebbb1393ae25d3c1a7ba6a80aca7796f8a7e3d0ab01210201973a41bb610e199a1fbb208398fbacc732c3658d132dbf9f3a394bedc9a7b5', 'index': 10, 'prev_out': {'type': 0, 'spent': True, 'value': 2381468502, 'spending_outpoints': [{'tx_index': 2773384164695358, 'n': 10}], 'n': 6, 'tx_index': 137650005496320, 'script': '76a914adfb8786f19039b78a78a999e04d68348d0571be88ac', 'addr': '1GrwDkr33gT6LuumniYjKEGjTLhsL5kmqC'}}, {'sequence': 4294967295, 'witness': '', 'script': '47304402207e874da620709eb509bb75ee06168bc87fd90dae7d9657c40423670f900d22c90220796c36be3cb23e741cab8674dffa6bb01dbb97ddc1c39ceac30bd9e50b14847601210201973a41bb610e199a1fbb208398fbacc732c3658d132dbf9f3a394bedc9a7b5', 'index': 11, 'prev_out': {'type': 0, 'spent': True, 'value': 2323144887, 'spending_outpoints': [{'tx_index': 2773384164695358, 'n': 11}], 'n': 18, 'tx_index': 3724368035130609, 'script': '76a914adfb8786f19039b78a78a999e04d68348d0571be88ac', 'addr': '1GrwDkr33gT6LuumniYjKEGjTLhsL5kmqC'}}, {'sequence': 4294967295, 'witness': '', 'script': '4830450221008128d43ded782a8006f6e5ef54265aa2e70c433d797e103634e32c4cddd1408f0220509b9a35daa617a63c3bfc34e08c3410af43e33b4ec57db8cd504e0f49bce34d01210201973a41bb610e199a1fbb208398fbacc732c3658d132dbf9f3a394bedc9a7b5', 'index': 12, 'prev_out': {'type': 0, 'spent': True, 'value': 2319935229, 'spending_outpoints': [{'tx_index': 2773384164695358, 'n': 12}], 'n': 15, 'tx_index': 5548937981804875, 'script': '76a914adfb8786f19039b78a78a999e04d68348d0571be88ac', 'addr': '1GrwDkr33gT6LuumniYjKEGjTLhsL5kmqC'}}, {'sequence': 4294967295, 'witness': '', 'script': '483045022100fa546a66e3f238be4a465f8d4526271049600f262b68e5f4031283536582d1e002200ff4eefa3c0fe58353cd6abb057e4e3a356f78742640f14428f10aaf5770589701210201973a41bb610e199a1fbb208398fbacc732c3658d132dbf9f3a394bedc9a7b5', 'index': 13, 'prev_out': {'type': 0, 'spent': True, 'value': 2318220153, 'spending_outpoints': [{'tx_index': 2773384164695358, 'n': 13}], 'n': 13, 'tx_index': 382713434211362, 'script': '76a914adfb8786f19039b78a78a999e04d68348d0571be88ac', 'addr': '1GrwDkr33gT6LuumniYjKEGjTLhsL5kmqC'}}, {'sequence': 4294967295, 'witness': '', 'script': '47304402207affb2377d6b19e78edf909da77a70f7a91e50e002a6782193b6629449e413d7022014824bd88bc6b79de6a80fe293b6e53197023ada17ce72a52db91962e8230cb101210201973a41bb610e199a1fbb208398fbacc732c3658d132dbf9f3a394bedc9a7b5', 'index': 14, 'prev_out': {'type': 0, 'spent': True, 'value': 2317930973, 'spending_outpoints': [{'tx_index': 2773384164695358, 'n': 14}], 'n': 13, 'tx_index': 2850467032193687, 'script': '76a914adfb8786f19039b78a78a999e04d68348d0571be88ac', 'addr': '1GrwDkr33gT6LuumniYjKEGjTLhsL5kmqC'}}, {'sequence': 4294967295, 'witness': '', 'script': '483045022100e088f39335fc48bc20240ce3065eba7434eea24fd4de14d0cfddbe1a684e02020220457f4328467a977d0c325293330d77930efa3086d7f61043597981e9bf0ea20401210201973a41bb610e199a1fbb208398fbacc732c3658d132dbf9f3a394bedc9a7b5', 'index': 15, 'prev_out': {'type': 0, 'spent': True, 'value': 2296644441, 'spending_outpoints': [{'tx_index': 2773384164695358, 'n': 15}], 'n': 14, 'tx_index': 7844948320371003, 'script': '76a914adfb8786f19039b78a78a999e04d68348d0571be88ac', 'addr': '1GrwDkr33gT6LuumniYjKEGjTLhsL5kmqC'}}, {'sequence': 4294967295, 'witness': '', 'script': '4730440220019946e9ca8c8961ed54ee6ba9221c98c836d1b4fe1edde203344371cecea836022054c6a430a85705c8b80a07ff2b8cc9f063c424de6a5d25979e3ce2bed22d450f01210201973a41bb610e199a1fbb208398fbacc732c3658d132dbf9f3a394bedc9a7b5', 'index': 16, 'prev_out': {'type': 0, 'spent': True, 'value': 2276546080, 'spending_outpoints': [{'tx_index': 2773384164695358, 'n': 16}], 'n': 14, 'tx_index': 6336765349281173, 'script': '76a914adfb8786f19039b78a78a999e04d68348d0571be88ac', 'addr': '1GrwDkr33gT6LuumniYjKEGjTLhsL5kmqC'}}, {'sequence': 4294967295, 'witness': '', 'script': '47304402201aa5dc1a86728ba802fa948aa289daae5a6c2bb7cb20d1652832e780764ce88502201abb85068a7049a91e58cca9be42d079e99f574eef8e671461cb1fddc430392f01210201973a41bb610e199a1fbb208398fbacc732c3658d132dbf9f3a394bedc9a7b5', 'index': 17, 'prev_out': {'type': 0, 'spent': True, 'value': 2239454101, 'spending_outpoints': [{'tx_index': 2773384164695358, 'n': 17}], 'n': 11, 'tx_index': 6318500530128950, 'script': '76a914adfb8786f19039b78a78a999e04d68348d0571be88ac', 'addr': '1GrwDkr33gT6LuumniYjKEGjTLhsL5kmqC'}}, {'sequence': 4294967295, 'witness': '', 'script': '483045022100eaaa52caa5598d2234a6dc7a1d01e0f1b76e9aba8428ee6d62fc93eb26fd705502207532aef51a187bdc633f0e216a030e0da92ba110ce6c304f2ad75e1950065c1601210201973a41bb610e199a1fbb208398fbacc732c3658d132dbf9f3a394bedc9a7b5', 'index': 18, 'prev_out': {'type': 0, 'spent': True, 'value': 2238374942, 'spending_outpoints': [{'tx_index': 2773384164695358, 'n': 18}], 'n': 14, 'tx_index': 4451627853182454, 'script': '76a914adfb8786f19039b78a78a999e04d68348d0571be88ac', 'addr': '1GrwDkr33gT6LuumniYjKEGjTLhsL5kmqC'}}, {'sequence': 4294967295, 'witness': '', 'script': '483045022100aee443e9f5072ae64df72ea8638601a69da4d8a44bda0e42e713897bb4e8e64402203c26ff58a4e2e8f26d8caa2a82e12d093770c5d1eb5b011b3ce707f7eea7061a012102fce629b33936fcf264630bbbe47062a653ac11abf7e5eaac79165bddde66e68e', 'index': 19, 'prev_out': {'type': 0, 'spent': True, 'value': 2232190000, 'spending_outpoints': [{'tx_index': 2773384164695358, 'n': 19}], 'n': 8, 'tx_index': 5912563300676671, 'script': '76a914bc943b5beee47bd1fc68dffdd6bd2c51998e3bbe88ac', 'addr': '1JC7cPvAFbwFkh1twHBYxiddLj2X8FFio7'}}, {'sequence': 4294967295, 'witness': '', 'script': '48304502210093dec17c6990ecc8a3c30933f6a170ae945c779dc0cf84fd019ae70a8e4a97fb022054784140a9ffaa953c887ee03fcbfd6da9de882f60ad5454f934f2098cca996401210201973a41bb610e199a1fbb208398fbacc732c3658d132dbf9f3a394bedc9a7b5', 'index': 20, 'prev_out': {'type': 0, 'spent': True, 'value': 2219013215, 'spending_outpoints': [{'tx_index': 2773384164695358, 'n': 20}], 'n': 12, 'tx_index': 7263458085326590, 'script': '76a914adfb8786f19039b78a78a999e04d68348d0571be88ac', 'addr': '1GrwDkr33gT6LuumniYjKEGjTLhsL5kmqC'}}]","[{'type': 0, 'spent': False, 'value': 50000000000, 'spending_outpoints': [], 'n': 0, 'tx_index': 2773384164695358, 'script': '0020eab3cd0683f9554a66261793846f509ceaefd2cd4dfc20adf400689eb4addc09', 'addr': 'bc1qa2eu6p5rl9255e3xz7fcgm6snn4wl5kdfh7zpt05qp5fad9dmsys0qjg0e'}, {'type': 0, 'spent': True, 'value': 279311623, 'spending_outpoints': [{'tx_index': 5479213065975131, 'n': 1}], 'n': 1, 'tx_index': 2773384164695358, 'script': '76a914adfb8786f19039b78a78a999e04d68348d0571be88ac', 'addr': '1GrwDkr33gT6LuumniYjKEGjTLhsL5kmqC'}]",50000000000,4971031881312
b44ce887f7e112576dfb968d3e31884d3e6f33399a1ac2d99f53806f3e6fd96b,2,1,1,461,743,410,0.0.0.0,0,3794611790016522,False,1730104322,867740,867740,"[{'sequence': 4294967295, 'witness': '0340109c24b67818aaf241337e18fee118bff68b6ee1d252fccd8e82d357dc1c4487744d5a2d1207512f11e4331333c93cda3b32190769548b26e095a38234b9cd6ffd060120609ab433637235f2aa15e6e6c19c552777c0e1f8c72357516fb818a45b5fc1f6ac0063036f7264010117746578742f68746d6c3b636861727365743d7574662d38004cc03c7363726970740a2020743d22302c312c31342c31362c33372c35332c35362c3537220a20207372633d222f636f6e74656e742f366262336366333065303736646564663662323437643436353666613164313561663531333933356630386530376562313935323261663637343139336237656930220a20206d3d277b2270223a2262726336392220226f70223a226d696e7422202273223a226e616b61736b756c6c732220226964223a22333633227d270a3e3c2f7363726970743e0a0a6821c1609ab433637235f2aa15e6e6c19c552777c0e1f8c72357516fb818a45b5fc1f6', 'script': '', 'index': 0, 'prev_out': {'type': 0, 'spent': True, 'value': 956, 'spending_outpoints': [{'tx_index': 3794611790016522, 'n': 0}], 'n': 362, 'tx_index': 7593719301420135, 'script': '51204a76703ee463f44a4cb338e20419a461726779072c43935075b0338fac16769a', 'addr': 'bc1pffm8q0hyv06y5n9n8r3qgxdyv9exw7g893pex5r4kqecltqkw6dqtmfj4y'}}]","[{'type': 0, 'spent': False, 'value': 546, 'spending_outpoints': [], 'n': 0, 'tx_index': 3794611790016522, 'script': '0020eab3cd0683f9554a66261793846f509ceaefd2cd4dfc20adf400689eb4addc09', 'addr': 'bc1qa2eu6p5rl9255e3xz7fcgm6snn4wl5kdfh7zpt05qp5fad9dmsys0qjg0e'}]",546,4921031881312
da2a0b277a1f470a9897649fd1ddda4a7f625bd2396fa612f584235e6d11f917,2,6,1,2865,3762,23575,0.0.0.0,864125,843472213623920,False,1729394741,866453,866453,"[{'sequence': 4294967293, 'witness': '05004730440220351d913567de9aac51ab67e8f5bc1b786d7bc74db7f209cddb57048a2c642feb02202d869e2c54baba706de33babe3adf6deb02005176f8b82f030d7885299c7093501483045022100b044d87abc44e640976be5343e51b729d164c0346c5b762aecf022b60d06b55b02200d25127f86d59e17be7eaf14e467f70bb12ed0c28ba069e47ce278d7289b23f90147304402203047738c8c66e7b9714d102afaaff9ec6c1dead3698535d03beec79a3865c5ea022036490bec82bd4e637dc9e375388338a8ea6a34012917a33521fed2520d386aab01cf5321022c5d5e92daa8385ffb21e6e1fd71e469bf5b9119f3ce07f647838c4de909b4a4210276aa4fb293c832ef88662a621c96f26c9aeb758dadeb46e6e010483d6c7d359a21029590ccde66ad5d5427fc33b2758d1dda371ad8a0c90be05e3f5c7ac5b7f2280a2102e072a0e826d9239f77cc880cbba9fa05508eff41f5d6107755cd77d4602bcdc72102ec833fcc4ae61136bdab25be06f6d20924f069d50587b054bfd14b0d1fc272712103ed321a7e5989fc26ce883c063705632e9daa1194af27d51c85b3f4da5876462356ae', 'script': '', 'index': 0, 'prev_out': {'type': 0, 'spent': True, 'value': 163035157925, 'spending_outpoints': [{'tx_index': 843472213623920, 'n': 0}], 'n': 0, 'tx_index': 5520065084121648, 'script': '00208518d05b901559e0770724ccf62cb21e6cee7026527f4e3425903f180df11451', 'addr': 'bc1qs5vdqkusz4v7qac8ynx0vt9jrekwuupx2fl5udp9jql3sr03z3gsr2mf0f'}}, {'sequence': 4294967293, 'witness': '050047304402202f1a423ab2e260ef81c29c974959c5ee892ff2f2f28afb626b7a9d2113b2647002203e68be0c2d008092ce480dabead62fd6452e9b42fe4c8c50de42925fc4f124b7014730440220470b41a4e2fcb5a25d6d921a958a8025f3f2c2eebedadca8bb10d16b216d464602200aa4dc46713798e6994cbca291836953ab3b0f583db55b8678e4e5237012464a01473044022035f0c72627cee4b67744782b27a0e2be9c81188ad852f6473ac4d6ed5b75f81f02200fdc1830fde353350fd9c7badbc06200c8f6a560805b91a66629b3a3eabf3ff501cf5321022c5d5e92daa8385ffb21e6e1fd71e469bf5b9119f3ce07f647838c4de909b4a4210276aa4fb293c832ef88662a621c96f26c9aeb758dadeb46e6e010483d6c7d359a21029590ccde66ad5d5427fc33b2758d1dda371ad8a0c90be05e3f5c7ac5b7f2280a2102e072a0e826d9239f77cc880cbba9fa05508eff41f5d6107755cd77d4602bcdc72102ec833fcc4ae61136bdab25be06f6d20924f069d50587b054bfd14b0d1fc272712103ed321a7e5989fc26ce883c063705632e9daa1194af27d51c85b3f4da5876462356ae', 'script': '', 'index': 1, 'prev_out': {'type': 0, 'spent': True, 'value': 110026358120, 'spending_outpoints': [{'tx_index': 843472213623920, 'n': 1}], 'n': 0, 'tx_index': 7752166789197206, 'script': '00208518d05b901559e0770724ccf62cb21e6cee7026527f4e3425903f180df11451', 'addr': 'bc1qs5vdqkusz4v7qac8ynx0vt9jrekwuupx2fl5udp9jql3sr03z3gsr2mf0f'}}, {'sequence': 4294967293, 'witness': '0500483045022100b0945c8843604e35e6ac538166ae07d851b61b9914153af2d157e205ded78585022042396ee08f74c9ff9314e06f719b54aa35fc94ede444a2a7fff51ff065ed4dcb01483045022100c58b2dea5502d535c791b27426806ab98ec60afa9a0b638695d5c8e8e59c006c022062b969b459ebdc9df4564c8464cf7fd6c4db744f6f2ff20cfca1e54779b2acad01483045022100d54f470f883aeb9ce47fc6bc49c6a9c9111987664f07efb8a2129653bf0eef32022051f6ad7da80b6be61b312886269c8c98de359de1c2f1abbf9188c3bcf4d2273601cf5321022c5d5e92daa8385ffb21e6e1fd71e469bf5b9119f3ce07f647838c4de909b4a4210276aa4fb293c832ef88662a621c96f26c9aeb758dadeb46e6e010483d6c7d359a21029590ccde66ad5d5427fc33b2758d1dda371ad8a0c90be05e3f5c7ac5b7f2280a2102e072a0e826d9239f77cc880cbba9fa05508eff41f5d6107755cd77d4602bcdc72102ec833fcc4ae61136bdab25be06f6d20924f069d50587b054bfd14b0d1fc272712103ed321a7e5989fc26ce883c063705632e9daa1194af27d51c85b3f4da5876462356ae', 'script': '', 'index': 2, 'prev_out': {'type': 0, 'spent': True, 'value': 26966050606, 'spending_outpoints': [{'tx_index': 843472213623920, 'n': 2}], 'n': 0, 'tx_index': 783568308351931, 'script': '00208518d05b901559e0770724ccf62cb21e6cee7026527f4e3425903f180df11451', 'addr': 'bc1qs5vdqkusz4v7qac8ynx0vt9jrekwuupx2fl5udp9jql3sr03z3gsr2mf0f'}}, {'sequence': 4294967293, 'witness': '0500483045022100fa2465dd70354e56d72f6adc135e311d4632680e423dc2bde2fa05fd31d3238102202e1181aec3a8cd91dd76a384e294a0cd87efcd4c303e75a3ab30ce76c161af260147304402204fef55e9ccae488d9913901824feacc4468d3cc53e4bf5c55c47fbf7aeb9aa69022047ee2b74941d1206052ce62724349983000a13a7a4130f45179b48b5af3aa3e301483045022100f8f5b34d6f256fd7708346e3e717188c74bbe36843515f868bde597c6c41c68502200a8d0915fdb6da7708fa3f605d688aa1f8e7fb8271ffc630577c2f2af3c40b0101cf5321022c5d5e92daa8385ffb21e6e1fd71e469bf5b9119f3ce07f647838c4de909b4a4210276aa4fb293c832ef88662a621c96f26c9aeb758dadeb46e6e010483d6c7d359a21029590ccde66ad5d5427fc33b2758d1dda371ad8a0c90be05e3f5c7ac5b7f2280a2102e072a0e826d9239f77cc880cbba9fa05508eff41f5d6107755cd77d4602bcdc72102ec833fcc4ae61136bdab25be06f6d20924f069d50587b054bfd14b0d1fc272712103ed321a7e5989fc26ce883c063705632e9daa1194af27d51c85b3f4da5876462356ae', 'script': '', 'index': 3, 'prev_out': {'type': 0, 'spent': True, 'value': 106253203817, 'spending_outpoints': [{'tx_index': 843472213623920, 'n': 3}], 'n': 0, 'tx_index': 4843834477551771, 'script': '00208518d05b901559e0770724ccf62cb21e6cee7026527f4e3425903f180df11451', 'addr': 'bc1qs5vdqkusz4v7qac8ynx0vt9jrekwuupx2fl5udp9jql3sr03z3gsr2mf0f'}}, {'sequence': 4294967293, 'witness': '05004730440220183b79731fd20d2cb931cafcf19dc2e6039566132d69fd6cf53fa09e4a26ab30022020b4c9c4cc9eea2e7a19955b544739b927efc85adbeb58f1052644c95af2a6a501473044022032971216321491bdf70fac344b0bdff81df66ad7334b572bbd42f3dc2d5231d002200e3dcadd50789643ce3414b2fdccb1c193721d0ffd73ef57e5ee90468cf6cbc901483045022100f02418043609db06bd485e4b6c4d991e5a32471d5274cfb6adf0d2319e41361c022014d57ef64c653b6db23bf280cc9caecf8d4f4ca0f3102e662f2d5f41c51cac1e01cf5321022c5d5e92daa8385ffb21e6e1fd71e469bf5b9119f3ce07f647838c4de909b4a4210276aa4fb293c832ef88662a621c96f26c9aeb758dadeb46e6e010483d6c7d359a21029590ccde66ad5d5427fc33b2758d1dda371ad8a0c90be05e3f5c7ac5b7f2280a2102e072a0e826d9239f77cc880cbba9fa05508eff41f5d6107755cd77d4602bcdc72102ec833fcc4ae61136bdab25be06f6d20924f069d50587b054bfd14b0d1fc272712103ed321a7e5989fc26ce883c063705632e9daa1194af27d51c85b3f4da5876462356ae', 'script': '', 'index': 4, 'prev_out': {'type': 0, 'spent': True, 'value': 82392813687, 'spending_outpoints': [{'tx_index': 843472213623920, 'n': 4}], 'n': 0, 'tx_index': 1822863532816119, 'script': '00208518d05b901559e0770724ccf62cb21e6cee7026527f4e3425903f180df11451', 'addr': 'bc1qs5vdqkusz4v7qac8ynx0vt9jrekwuupx2fl5udp9jql3sr03z3gsr2mf0f'}}, {'sequence': 4294967293, 'witness': '0500473044022056bd0e29dc35453556719378ec8e739684b83317df120d2f515801a463faf4ee0220391663a833a41fc359c35bc053345016e9e3dfdd50bd8eae78c1061f98c6daf90147304402200ed757d0ccbee696b823da90d7c4f1e1bb0be9cf913e39d11b317511d5c31c99022037da75f2f402feeba29d7213066f01b4158eb77efa2bcc7f59e4da75e26f9bd501483045022100faf4f9d6063c859b435b03e79bce838a51375ed294cecf858ba262f85a954c2402200eed3f764710909ea3895ba178b1cb30afb566b692690518b2ee40c13f16335301cf5321022c5d5e92daa8385ffb21e6e1fd71e469bf5b9119f3ce07f647838c4de909b4a4210276aa4fb293c832ef88662a621c96f26c9aeb758dadeb46e6e010483d6c7d359a21029590ccde66ad5d5427fc33b2758d1dda371ad8a0c90be05e3f5c7ac5b7f2280a2102e072a0e826d9239f77cc880cbba9fa05508eff41f5d6107755cd77d4602bcdc72102ec833fcc4ae61136bdab25be06f6d20924f069d50587b054bfd14b0d1fc272712103ed321a7e5989fc26ce883c063705632e9daa1194af27d51c85b3f4da5876462356ae', 'script': '', 'index': 5, 'prev_out': {'type': 0, 'spent': True, 'value': 150592882870, 'spending_outpoints': [{'tx_index': 843472213623920, 'n': 5}], 'n': 0, 'tx_index': 1361870649097565, 'script': '00208518d05b901559e0770724ccf62cb21e6cee7026527f4e3425903f180df11451', 'addr': 'bc1qs5vdqkusz4v7qac8ynx0vt9jrekwuupx2fl5udp9jql3sr03z3gsr2mf0f'}}]","[{'type': 0, 'spent': False, 'value': 639266443450, 'spending_outpoints': [], 'n': 0, 'tx_index': 843472213623920, 'script': '0020eab3cd0683f9554a66261793846f509ceaefd2cd4dfc20adf400689eb4addc09', 'addr': 'bc1qa2eu6p5rl9255e3xz7fcgm6snn4wl5kdfh7zpt05qp5fad9dmsys0qjg0e'}]",639266443450,4921031880766
9c7bee7b257e85a4259bcdb00259b3861bf3a681c482ef9754759d7f92d8692e,2,1,1,524,806,4040,0.0.0.0,851494,1633028477547438,False,1729393199,866452,866452,"[{'sequence': 4294967293, 'witness': '0500483045022100c27ab8b46f4fd48e2b44780fe8f5ce804979f6f2c880b7bcad7f376ef342793002207ef5cb001e3919694ecd7e7c21a414e84c4cabd5c38dd319cee5b4b5ca2fffe901483045022100e450bd94a63f47eef306973f77db621f9af2e876e74d9039d6f0b4bf39d280c002203c284605e5b451036caa447e2911bbda5e55665f28272a360669e21ad9af32a30147304402205196193e4b168958ead44ea537ca02eecfaedc9d55248b983a0803a23f2b5ced02206a5dde430679324df25d6d8259fc07a253e4187b6152414abf8b7ac18c92356201cf5321022c5d5e92daa8385ffb21e6e1fd71e469bf5b9119f3ce07f647838c4de909b4a4210276aa4fb293c832ef88662a621c96f26c9aeb758dadeb46e6e010483d6c7d359a21029590ccde66ad5d5427fc33b2758d1dda371ad8a0c90be05e3f5c7ac5b7f2280a2102e072a0e826d9239f77cc880cbba9fa05508eff41f5d6107755cd77d4602bcdc72102ec833fcc4ae61136bdab25be06f6d20924f069d50587b054bfd14b0d1fc272712103ed321a7e5989fc26ce883c063705632e9daa1194af27d51c85b3f4da5876462356ae', 'script': '', 'index': 0, 'prev_out': {'type': 0, 'spent': True, 'value': 505798430131, 'spending_outpoints': [{'tx_index': 1633028477547438, 'n': 0}], 'n': 0, 'tx_index': 7136350469111654, 'script': '00208518d05b901559e0770724ccf62cb21e6cee7026527f4e3425903f180df11451', 'addr': 'bc1qs5vdqkusz4v7qac8ynx0vt9jrekwuupx2fl5udp9jql3sr03z3gsr2mf0f'}}]","[{'type': 0, 'spent': False, 'value': 505798426091, 'spending_outpoints': [], 'n': 0, 'tx_index': 1633028477547438, 'script': '0020eab3cd0683f9554a66261793846f509ceaefd2cd4dfc20adf400689eb4addc09', 'addr': 'bc1qa2eu6p5rl9255e3xz7fcgm6snn4wl5kdfh7zpt05qp5fad9dmsys0qjg0e'}]",505798426091,4281765437316
7fdebd985cf1c390b0f456c65b4ece299c5b2860af2f0405c170c507283bd6aa,2,6,1,2864,3761,18860,0.0.0.0,851492,6010786950477998,False,1729393690,866452,866452,"[{'sequence': 4294967293, 'witness': '0500483045022100846ed6faa23581dd0f19d5b92dea0afce6f40496bea197fad1365bb1670bce47022001107e1d734a4c54c0377d10df1416d48ff72b165a8eaf8c3003b6582278c30b01473044022065e0d18228a966de14917b5515d00cde907127389e9c99f5c19edef27923865002200834ffb83105f571dc22f272b36f1a43e8e3351663cbbfef9f2620a7fa09880901483045022100ceb566725b731ab33960c882f062bf40661379afd9e53d83e8400ac797dee6b302205cff21f4ce18952696b7ed824053dcd31f8449c6f3950f0013b52091d6259b0901cf5321022c5d5e92daa8385ffb21e6e1fd71e469bf5b9119f3ce07f647838c4de909b4a4210276aa4fb293c832ef88662a621c96f26c9aeb758dadeb46e6e010483d6c7d359a21029590ccde66ad5d5427fc33b2758d1dda371ad8a0c90be05e3f5c7ac5b7f2280a2102e072a0e826d9239f77cc880cbba9fa05508eff41f5d6107755cd77d4602bcdc72102ec833fcc4ae61136bdab25be06f6d20924f069d50587b054bfd14b0d1fc272712103ed321a7e5989fc26ce883c063705632e9daa1194af27d51c85b3f4da5876462356ae', 'script': '', 'index': 0, 'prev_out': {'type': 0, 'spent': True, 'value': 215412205935, 'spending_outpoints': [{'tx_index': 6010786950477998, 'n': 0}], 'n': 0, 'tx_index': 2841389597875061, 'script': '00208518d05b901559e0770724ccf62cb21e6cee7026527f4e3425903f180df11451', 'addr': 'bc1qs5vdqkusz4v7qac8ynx0vt9jrekwuupx2fl5udp9jql3sr03z3gsr2mf0f'}}, {'sequence': 4294967293, 'witness': '0500483045022100d6bf244b9ae4a109bbb5f7e7dc665a459a079902d182646613034b5e1771f45702205fb10455643ae37f92a1d328c3a53df16e993e0baac41a7d1fa04a0b4a65742901483045022100afe900c97480d63e639af70f556731a809aebe8f5c62ab7303869c55784e6d3b022027ea919d3942a9026407e71879160333bcbe412b4b4be64c9ed2f9f0943d762d014730440220030d875525028ae1a474eb053b278e4a8f64c69577fa1a2335e2c051fb921f1c0220790aca73baa1e69574b87c297038580832dcd6b2d2b86db79be025485899a2ba01cf5321022c5d5e92daa8385ffb21e6e1fd71e469bf5b9119f3ce07f647838c4de909b4a4210276aa4fb293c832ef88662a621c96f26c9aeb758dadeb46e6e010483d6c7d359a21029590ccde66ad5d5427fc33b2758d1dda371ad8a0c90be05e3f5c7ac5b7f2280a2102e072a0e826d9239f77cc880cbba9fa05508eff41f5d6107755cd77d4602bcdc72102ec833fcc4ae61136bdab25be06f6d20924f069d50587b054bfd14b0d1fc272712103ed321a7e5989fc26ce883c063705632e9daa1194af27d51c85b3f4da5876462356ae', 'script': '', 'index': 1, 'prev_out': {'type': 0, 'spent': True, 'value': 35848550546, 'spending_outpoints': [{'tx_index': 6010786950477998, 'n': 1}], 'n': 0, 'tx_index': 2924312746157786, 'script': '00208518d05b901559e0770724ccf62cb21e6cee7026527f4e3425903f180df11451', 'addr': 'bc1qs5vdqkusz4v7qac8ynx0vt9jrekwuupx2fl5udp9jql3sr03z3gsr2mf0f'}}, {'sequence': 4294967293, 'witness': '0500473044022036e5fddc0e2997ee4ffdea9eef04eb517dc8dff2ee9ca7583581e9825f2e9a0402207613c75186db440f37888229c02e90163db703e410b59930b6fb801b46e495de0147304402205225afe505c7a815975ebf5d4ee5e34c283be13113d22d0f08efce9e48142f5b02207166c0f8057de82512872af99e4b69ad019b8463747926adf4ca1a8f732d72b401473044022016882dc7874e923dd6898f699f8d2c8e058b7ef0c48d8eaefd692da885cf01ed02202084f53986e926bd8948be1c9b411e732e034b618ff4aca9c2f66f78ea34bea101cf5321022c5d5e92daa8385ffb21e6e1fd71e469bf5b9119f3ce07f647838c4de909b4a4210276aa4fb293c832ef88662a621c96f26c9aeb758dadeb46e6e010483d6c7d359a21029590ccde66ad5d5427fc33b2758d1dda371ad8a0c90be05e3f5c7ac5b7f2280a2102e072a0e826d9239f77cc880cbba9fa05508eff41f5d6107755cd77d4602bcdc72102ec833fcc4ae61136bdab25be06f6d20924f069d50587b054bfd14b0d1fc272712103ed321a7e5989fc26ce883c063705632e9daa1194af27d51c85b3f4da5876462356ae', 'script': '', 'index': 2, 'prev_out': {'type': 0, 'spent': True, 'value': 40814359211, 'spending_outpoints': [{'tx_index': 6010786950477998, 'n': 2}], 'n': 0, 'tx_index': 3748612781201009, 'script': '00208518d05b901559e0770724ccf62cb21e6cee7026527f4e3425903f180df11451', 'addr': 'bc1qs5vdqkusz4v7qac8ynx0vt9jrekwuupx2fl5udp9jql3sr03z3gsr2mf0f'}}, {'sequence': 4294967293, 'witness': '05004730440220305cbc62ca1bc872dacc785f98f01d59d9298d0b10bba5f5aaf6973ca0a0de0202201fc7b69c35bca58f078af9c9055f4875a9ffb294fd6bcef5fc9d36a1195a6f31014830450221009a75b3ea5196c2bef126ce6cafd2c8e7c069e8192b57e068aa7de7d72b489ef302204db747fd46c52a9d9fca9244f530a700d89358776b1ffa3f59c5d161c72ec35101483045022100d151251ed3c9ac6d648a0577b657bf7d15700c2f2dd7cddffa6aaeb889fc0f79022050d52ef167a8198d6e0e070cf98f951d24c4e39acff1fabbc0c2d7f6bc6cc1a801cf5321022c5d5e92daa8385ffb21e6e1fd71e469bf5b9119f3ce07f647838c4de909b4a4210276aa4fb293c832ef88662a621c96f26c9aeb758dadeb46e6e010483d6c7d359a21029590ccde66ad5d5427fc33b2758d1dda371ad8a0c90be05e3f5c7ac5b7f2280a2102e072a0e826d9239f77cc880cbba9fa05508eff41f5d6107755cd77d4602bcdc72102ec833fcc4ae61136bdab25be06f6d20924f069d50587b054bfd14b0d1fc272712103ed321a7e5989fc26ce883c063705632e9daa1194af27d51c85b3f4da5876462356ae', 'script': '', 'index': 3, 'prev_out': {'type': 0, 'spent': True, 'value': 40723780915, 'spending_outpoints': [{'tx_index': 6010786950477998, 'n': 3}], 'n': 0, 'tx_index': 3219058762745545, 'script': '00208518d05b901559e0770724ccf62cb21e6cee7026527f4e3425903f180df11451', 'addr': 'bc1qs5vdqkusz4v7qac8ynx0vt9jrekwuupx2fl5udp9jql3sr03z3gsr2mf0f'}}, {'sequence': 4294967293, 'witness': '0500483045022100b16d2ddedff0aed628e31615da5d2dbeb2daa3a25afafbe49b0a0bcce86654bb02200d7eba1af9cfc3433716a0bdc2fc70e2bbe0cda254804365d3860350e2e2c0180147304402205077d8609141c652140888e886cbeda388ff378dec7ab6c0eae50da745a7b98c0220287cdc3fb3a2e9e88ef1c657ad875d7802c377a84b429b734aacde4ec350b61701473044022047d748521ab8f20892b04cc48a58462b8fc9f430295e1aea953fcfdc21262c4302201f20dad4019b318d99ad6b3c6b8c46a4d7f6da942dabe6fa90def72b825e81e701cf5321022c5d5e92daa8385ffb21e6e1fd71e469bf5b9119f3ce07f647838c4de909b4a4210276aa4fb293c832ef88662a621c96f26c9aeb758dadeb46e6e010483d6c7d359a21029590ccde66ad5d5427fc33b2758d1dda371ad8a0c90be05e3f5c7ac5b7f2280a2102e072a0e826d9239f77cc880cbba9fa05508eff41f5d6107755cd77d4602bcdc72102ec833fcc4ae61136bdab25be06f6d20924f069d50587b054bfd14b0d1fc272712103ed321a7e5989fc26ce883c063705632e9daa1194af27d51c85b3f4da5876462356ae', 'script': '', 'index': 4, 'prev_out': {'type': 0, 'spent': True, 'value': 175616683909, 'spending_outpoints': [{'tx_index': 6010786950477998, 'n': 4}], 'n': 0, 'tx_index': 3347633576841364, 'script': '00208518d05b901559e0770724ccf62cb21e6cee7026527f4e3425903f180df11451', 'addr': 'bc1qs5vdqkusz4v7qac8ynx0vt9jrekwuupx2fl5udp9jql3sr03z3gsr2mf0f'}}, {'sequence': 4294967293, 'witness': '0500473044022033867b02c6ee163e0e371491e5abf14ba65ee9dcde40fa9baea4974c19728a6e02206e85a38a7d01aff3279188e9e0861b50f71cf23254a3961c6feb826f76d42a5a01473044022052ebc2c78b28e08bd8e6965e895e4d12103454415c7b981eefde1bb07ec458d002204c133f2455597f28a52cd8dfac93fd1348feeb96b7fe314200a6fe4746ab646b014730440220499574f34edbdf0e0441b4cb717740ae32122724da1344664a80bfae8dacecb5022018e91d35bc0dedc1fd46f33a7df4e81f7824cbfc165ffe7cbfb8f310ea64315a01cf5321022c5d5e92daa8385ffb21e6e1fd71e469bf5b9119f3ce07f647838c4de909b4a4210276aa4fb293c832ef88662a621c96f26c9aeb758dadeb46e6e010483d6c7d359a21029590ccde66ad5d5427fc33b2758d1dda371ad8a0c90be05e3f5c7ac5b7f2280a2102e072a0e826d9239f77cc880cbba9fa05508eff41f5d6107755cd77d4602bcdc72102ec833fcc4ae61136bdab25be06f6d20924f069d50587b054bfd14b0d1fc272712103ed321a7e5989fc26ce883c063705632e9daa1194af27d51c85b3f4da5876462356ae', 'script': '', 'index': 5, 'prev_out': {'type': 0, 'spent': True, 'value': 34478283044, 'spending_outpoints': [{'tx_index': 6010786950477998, 'n': 5}], 'n': 0, 'tx_index': 2846183653235493, 'script': '00208518d05b901559e0770724ccf62cb21e6cee7026527f4e3425903f180df11451', 'addr': 'bc1qs5vdqkusz4v7qac8ynx0vt9jrekwuupx2fl5udp9jql3sr03z3gsr2mf0f'}}]","[{'type': 0, 'spent': False, 'value': 542893844700, 'spending_outpoints': [], 'n': 0, 'tx_index': 6010786950477998, 'script': '0020eab3cd0683f9554a66261793846f509ceaefd2cd4dfc20adf400689eb4addc09', 'addr': 'bc1qa2eu6p5rl9255e3xz7fcgm6snn4wl5kdfh7zpt05qp5fad9dmsys0qjg0e'}]",542893844700,3775967011225
8d1a5f5c8211134f29d585c328f596fe6620261c2dbe40deb903cc0a2b78997c,2,1,1,524,806,4040,0.0.0.0,851494,4383954813671808,False,1729392759,866451,866451,"[{'sequence': 4294967293, 'witness': '05004830450221008bf868fdc1ddd1d45640e4a5a24ece3815a4b99e2944c3c5f921284c6fbeec7a02203c81f41242004d2a1a896de022ebbe209915f3c015e7f03a2bbf9ba74dfde6d70147304402201286b76b6bf8e5174e2e771dc40a31610d8b49ee60303e598ff82787b06e8778022048b670ce655ad1f95e04077f0c992cbd027e11f47257932b6c42053d74a68848014830450221009189abf72dcbc50be1124964876bb9e789eb38570d718910922e908dddb855c9022001535c853ba8deeaaabd346d3f0a19ec0dcba9370b9c84332349ed5405df24ca01cf5321022c5d5e92daa8385ffb21e6e1fd71e469bf5b9119f3ce07f647838c4de909b4a4210276aa4fb293c832ef88662a621c96f26c9aeb758dadeb46e6e010483d6c7d359a21029590ccde66ad5d5427fc33b2758d1dda371ad8a0c90be05e3f5c7ac5b7f2280a2102e072a0e826d9239f77cc880cbba9fa05508eff41f5d6107755cd77d4602bcdc72102ec833fcc4ae61136bdab25be06f6d20924f069d50587b054bfd14b0d1fc272712103ed321a7e5989fc26ce883c063705632e9daa1194af27d51c85b3f4da5876462356ae', 'script': '', 'index': 0, 'prev_out': {'type': 0, 'spent': True, 'value': 514088996780, 'spending_outpoints': [{'tx_index': 4383954813671808, 'n': 0}], 'n': 0, 'tx_index': 530985130495541, 'script': '00208518d05b901559e0770724ccf62cb21e6cee7026527f4e3425903f180df11451', 'addr': 'bc1qs5vdqkusz4v7qac8ynx0vt9jrekwuupx2fl5udp9jql3sr03z3gsr2mf0f'}}]","[{'type': 0, 'spent': False, 'value': 514088992740, 'spending_outpoints': [], 'n': 0, 'tx_index': 4383954813671808, 'script': '0020eab3cd0683f9554a66261793846f509ceaefd2cd4dfc20adf400689eb4addc09', 'addr': 'bc1qa2eu6p5rl9255e3xz7fcgm6snn4wl5kdfh7zpt05qp5fad9dmsys0qjg0e'}]",514088992740,3233073166525
34744d5346df8638e7c4b1d6daca13a56a9a43e1cfe5616cce16a4483ae8e0d3,2,1,1,524,806,4040,0.0.0.0,851494,7454813512602754,False,1729392467,866450,866450,"[{'sequence': 4294967293, 'witness': '0500473044022038bc8b603e2e714519af5cf8a4cad5396b7aad9dc1091241d0cd425d5ea3c4eb022045d6980c32d2508fc10ce314d7b6d82de0839ccab92755f79dcdfdcdd838070a01483045022100fe6b0c552b24def8f128d8539f58490d48b1f67bb360b0429b6274f0127d9b5d0220618457d574d7e5ef92483b53b72f9baf25c28be9d6eafa7e52de79e8bf19e9bd014830450221008f1302ebb34aba7b1ac44b00f67dc2024f0f9a678176b9f9ac8a71e4b536b7da0220361b05e9869e54fa296364d51015f61d87957c5369a89c142f959896d24d4f0d01cf5321022c5d5e92daa8385ffb21e6e1fd71e469bf5b9119f3ce07f647838c4de909b4a4210276aa4fb293c832ef88662a621c96f26c9aeb758dadeb46e6e010483d6c7d359a21029590ccde66ad5d5427fc33b2758d1dda371ad8a0c90be05e3f5c7ac5b7f2280a2102e072a0e826d9239f77cc880cbba9fa05508eff41f5d6107755cd77d4602bcdc72102ec833fcc4ae61136bdab25be06f6d20924f069d50587b054bfd14b0d1fc272712103ed321a7e5989fc26ce883c063705632e9daa1194af27d51c85b3f4da5876462356ae', 'script': '', 'index': 0, 'prev_out': {'type': 0, 'spent': True, 'value': 534592992018, 'spending_outpoints': [{'tx_index': 7454813512602754, 'n': 0}], 'n': 0, 'tx_index': 4281326501566051, 'script': '00208518d05b901559e0770724ccf62cb21e6cee7026527f4e3425903f180df11451', 'addr': 'bc1qs5vdqkusz4v7qac8ynx0vt9jrekwuupx2fl5udp9jql3sr03z3gsr2mf0f'}}]","[{'type': 0, 'spent': False, 'value': 534592987978, 'spending_outpoints': [], 'n': 0, 'tx_index': 7454813512602754, 'script': '0020eab3cd0683f9554a66261793846f509ceaefd2cd4dfc20adf400689eb4addc09', 'addr': 'bc1qa2eu6p5rl9255e3xz7fcgm6snn4wl5kdfh7zpt05qp5fad9dmsys0qjg0e'}]",534592987978,2718984173785
17b3ffd28b6c4d530ae43d121f894ff1357bba4d54102760b7c5a61385c0977f,2,1,1,523,805,4040,0.0.0.0,851432,4489271895553240,False,1729391446,866447,866447,"[{'sequence': 4294967293, 'witness': '050047304402205819ee92246cbf6564cf9aee9d42f71934b64f4eb1e5e6f1750fbc44aa3ce12402202a50f300a87e0a08c60d073a8f214e678c02e7a37b1d038787f54f6ecc8c171001473044022100e4005a5b7ee8f9c796176e11281cac6d74492b5150a1f8418a728330a2ee7535021f77935d4ce998d5ef6b05342e3450772ac86612b2b515c0307d459e9668631b0148304502210094bb95908939b69368119e8ee115ed3d9ad16e6198aa8ef027f0813d7d15ccfc02203052b10162fde2192ad5d7fde05d6e78ac858c321982471459102b24b3cc31cc01cf5321022c5d5e92daa8385ffb21e6e1fd71e469bf5b9119f3ce07f647838c4de909b4a4210276aa4fb293c832ef88662a621c96f26c9aeb758dadeb46e6e010483d6c7d359a21029590ccde66ad5d5427fc33b2758d1dda371ad8a0c90be05e3f5c7ac5b7f2280a2102e072a0e826d9239f77cc880cbba9fa05508eff41f5d6107755cd77d4602bcdc72102ec833fcc4ae61136bdab25be06f6d20924f069d50587b054bfd14b0d1fc272712103ed321a7e5989fc26ce883c063705632e9daa1194af27d51c85b3f4da5876462356ae', 'script': '', 'index': 0, 'prev_out': {'type': 0, 'spent': True, 'value': 536028527277, 'spending_outpoints': [{'tx_index': 4489271895553240, 'n': 0}], 'n': 0, 'tx_index': 4658761084047471, 'script': '00208518d05b901559e0770724ccf62cb21e6cee7026527f4e3425903f180df11451', 'addr': 'bc1qs5vdqkusz4v7qac8ynx0vt9jrekwuupx2fl5udp9jql3sr03z3gsr2mf0f'}}]","[{'type': 0, 'spent': False, 'value': 536028523237, 'spending_outpoints': [], 'n': 0, 'tx_index': 4489271895553240, 'script': '0020eab3cd0683f9554a66261793846f509ceaefd2cd4dfc20adf400689eb4addc09', 'addr': 'bc1qa2eu6p5rl9255e3xz7fcgm6snn4wl5kdfh7zpt05qp5fad9dmsys0qjg0e'}]",536028523237,2184391185807
7c0e3d449f70c9060dd6ff02e553c8be5b6560888f22282d419c9291600a50ec,2,1,1,525,807,4040,0.0.0.0,851494,8314512500470355,False,1729390681,866445,866445,"[{'sequence': 4294967293, 'witness': '0500483045022100f22b19305b4a4cfcec6239dfb47afd2b4c61f1046b615837d41ce4719b021ee1022017e46ab0aa8297ad4afd566ba25bf3e1624735ce585028acf23c7a9e8387476d01483045022100c291cfb2c40bb5c5f254833e79690e117a28bb7bcaa2f2a5c403cda21f8bdbd9022028ded943d7030c9a3087e7ac4ee54677decdce84f8e168968454e11b42be025701483045022100b97df455ba16b47e9ffe9053454b4def511050de8a0e278767eec9e379fd449e0220746d139a63a1cfa636ca66ff8778a731e1b60866efc172f53ee897dccb760a9501cf5321022c5d5e92daa8385ffb21e6e1fd71e469bf5b9119f3ce07f647838c4de909b4a4210276aa4fb293c832ef88662a621c96f26c9aeb758dadeb46e6e010483d6c7d359a21029590ccde66ad5d5427fc33b2758d1dda371ad8a0c90be05e3f5c7ac5b7f2280a2102e072a0e826d9239f77cc880cbba9fa05508eff41f5d6107755cd77d4602bcdc72102ec833fcc4ae61136bdab25be06f6d20924f069d50587b054bfd14b0d1fc272712103ed321a7e5989fc26ce883c063705632e9daa1194af27d51c85b3f4da5876462356ae', 'script': '', 'index': 0, 'prev_out': {'type': 0, 'spent': True, 'value': 553765001100, 'spending_outpoints': [{'tx_index': 8314512500470355, 'n': 0}], 'n': 0, 'tx_index': 820256921376629, 'script': '00208518d05b901559e0770724ccf62cb21e6cee7026527f4e3425903f180df11451', 'addr': 'bc1qs5vdqkusz4v7qac8ynx0vt9jrekwuupx2fl5udp9jql3sr03z3gsr2mf0f'}}]","[{'type': 0, 'spent': False, 'value': 553764997060, 'spending_outpoints': [], 'n': 0, 'tx_index': 8314512500470355, 'script': '0020eab3cd0683f9554a66261793846f509ceaefd2cd4dfc20adf400689eb4addc09', 'addr': 'bc1qa2eu6p5rl9255e3xz7fcgm6snn4wl5kdfh7zpt05qp5fad9dmsys0qjg0e'}]",553764997060,1648362662570
5ffe39dcdfe082d09e5be14d7023df6e41561804e94f5ddf0c9fcc04cceef2b0,2,64,2,9530,38120,1862250,0.0.0.0,0,6225837917510035,False,1729169384,866051,866051,"[{'sequence': 4294967295, 'witness': '', 'script': '483045022100d01cf05e4813f4aa9bf87dd623ea73ee818465bf07dc5ce36d54cec1e53e604402203d525f1fec35a7cf02435d0e0ed67fca8f2ab924cf592114e79f3edc56178b7e01210201973a41bb610e199a1fbb208398fbacc732c3658d132dbf9f3a394bedc9a7b5', 'index': 0, 'prev_out': {'type': 0, 'spent': True, 'value': 6065347653, 'spending_outpoints': [{'tx_index': 6225837917510035, 'n': 0}], 'n': 21, 'tx_index': 3163079266800527, 'script': '76a914adfb8786f19039b78a78a999e04d68348d0571be88ac', 'addr': '1GrwDkr33gT6LuumniYjKEGjTLhsL5kmqC'}}, {'sequence': 4294967295, 'witness': '', 'script': '46304302201cdc3301920dc8a9a906e7c79b45b2b316e57484a8da1cf524c9bd9de5131e86021f5fdb52ae59f071e4576c40c0222b131c362af3f3dc36cbc54f01ccc29790af01210201973a41bb610e199a1fbb208398fbacc732c3658d132dbf9f3a394bedc9a7b5', 'index': 1, 'prev_out': {'type': 0, 'spent': True, 'value': 4527876240, 'spending_outpoints': [{'tx_index': 6225837917510035, 'n': 1}], 'n': 11, 'tx_index': 5670972244146956, 'script': '76a914adfb8786f19039b78a78a999e04d68348d0571be88ac', 'addr': '1GrwDkr33gT6LuumniYjKEGjTLhsL5kmqC'}}, {'sequence': 4294967295, 'witness': '', 'script': '483045022100b38548981d27bcbb9da45048d673222f96ac4747cc712ea6362c1f75c37744610220018d96cbc0781d5775239e4cbd1b6095cc5130b4ea06ca35ee3aa08a11a5497201210201973a41bb610e199a1fbb208398fbacc732c3658d132dbf9f3a394bedc9a7b5', 'index': 2, 'prev_out': {'type': 0, 'spent': True, 'value': 4483161907, 'spending_outpoints': [{'tx_index': 6225837917510035, 'n': 2}], 'n': 0, 'tx_index': 3230555554674191, 'script': '76a914adfb8786f19039b78a78a999e04d68348d0571be88ac', 'addr': '1GrwDkr33gT6LuumniYjKEGjTLhsL5kmqC'}}, {'sequence': 4294967295, 'witness': '', 'script': '47304402200a274dfcff062316cc95ab6c243e05cc774cb096bcef94f2324bce6b00d2b3ea0220246fb626b458e89fe09c3d5f23adad105cbb9c20282c7189b3299071adea939601210201973a41bb610e199a1fbb208398fbacc732c3658d132dbf9f3a394bedc9a7b5', 'index': 3, 'prev_out': {'type': 0, 'spent': True, 'value': 4448454812, 'spending_outpoints': [{'tx_index': 6225837917510035, 'n': 3}], 'n': 0, 'tx_index': 8609770777090301, 'script': '76a914adfb8786f19039b78a78a999e04d68348d0571be88ac', 'addr': '1GrwDkr33gT6LuumniYjKEGjTLhsL5kmqC'}}, {'sequence': 4294967295, 'witness': '', 'script': '483045022100ac52ba0222b18eb94d84ae50c8456a05e165e59c50651e2b7fc7a63691f91657022024d1091dd68d41a2ac6ab837b6daaea20236089380d7c874d11990c7f30a551e01210201973a41bb610e199a1fbb208398fbacc732c3658d132dbf9f3a394bedc9a7b5', 'index': 4, 'prev_out': {'type': 0, 'spent': True, 'value': 4203608146, 'spending_outpoints': [{'tx_index': 6225837917510035, 'n': 4}], 'n': 11, 'tx_index': 2663376448039100, 'script': '76a914adfb8786f19039b78a78a999e04d68348d0571be88ac', 'addr': '1GrwDkr33gT6LuumniYjKEGjTLhsL5kmqC'}}, {'sequence': 4294967295, 'witness': '', 'script': '4830450221009d8321b9102d965b5575b411427eadc11bc5144c5f56c0d443603d7540700168022001154e4c1fb03db63b0c4ffeca98f86f1c93e96f8131f1ef292bf3ca015f947801210201973a41bb610e199a1fbb208398fbacc732c3658d132dbf9f3a394bedc9a7b5', 'index': 5, 'prev_out': {'type': 0, 'spent': True, 'value': 3947026569, 'spending_outpoints': [{'tx_index': 6225837917510035, 'n': 5}], 'n': 16, 'tx_index': 2797579573676795, 'script': '76a914adfb8786f19039b78a78a999e04d68348d0571be88ac', 'addr': '1GrwDkr33gT6LuumniYjKEGjTLhsL5kmqC'}}, {'sequence': 4294967295, 'witness': '', 'script': '4730440220014d43fedd20d71c250d4ada2492bac46ae00e1a9bf815f67752363b215fba5f02200e723755c747e806437e253de813f8f5b67856a7c8b0c1d309b9a1a5b58275dc01210201973a41bb610e199a1fbb208398fbacc732c3658d132dbf9f3a394bedc9a7b5', 'index': 6, 'prev_out': {'type': 0, 'spent': True, 'value': 3762400640, 'spending_outpoints': [{'tx_index': 6225837917510035, 'n': 6}], 'n': 0, 'tx_index': 8042254815433945, 'script': '76a914adfb8786f19039b78a78a999e04d68348d0571be88ac', 'addr': '1GrwDkr33gT6LuumniYjKEGjTLhsL5kmqC'}}, {'sequence': 4294967295, 'witness': '', 'script': '47304402203266026e7e8c0fc7704c1f48ba796ea32e7ec6628f4a15c756f3f7dc4b30a9aa02206ee28027bd34f3bf6f307918ecd97810bdd96c053296936ebb87bb042adda43a01210201973a41bb610e199a1fbb208398fbacc732c3658d132dbf9f3a394bedc9a7b5', 'index': 7, 'prev_out': {'type': 0, 'spent': True, 'value': 3237428153, 'spending_outpoints': [{'tx_index': 6225837917510035, 'n': 7}], 'n': 16, 'tx_index': 8986283940198797, 'script': '76a914adfb8786f19039b78a78a999e04d68348d0571be88ac', 'addr': '1GrwDkr33gT6LuumniYjKEGjTLhsL5kmqC'}}, {'sequence': 4294967295, 'witness': '', 'script': '4730440220582e9b7b01c18f69ffff6f64d063d4cb05a8f0e0af29c42577455831d967fb14022058ed5127beaa0901103c4127fe6879771edf752cb944ce54f77ad093351ad17d01210201973a41bb610e199a1fbb208398fbacc732c3658d132dbf9f3a394bedc9a7b5', 'index': 8, 'prev_out': {'type': 0, 'spent': True, 'value': 2894456238, 'spending_outpoints': [{'tx_index': 6225837917510035, 'n': 8}], 'n': 11, 'tx_index': 7397876851227463, 'script': '76a914adfb8786f19039b78a78a999e04d68348d0571be88ac', 'addr': '1GrwDkr33gT6LuumniYjKEGjTLhsL5kmqC'}}, {'sequence': 4294967295, 'witness': '', 'script': '483045022100e0e3640396395b9f3fe6426efb8f7d3965661d26ef88b43a44b95439f7012b4a02204cab13510ee24c43146bf3d7ab1cb99e9836bff178e4c9a722bbf155c9ce03c501210201973a41bb610e199a1fbb208398fbacc732c3658d132dbf9f3a394bedc9a7b5', 'index': 9, 'prev_out': {'type': 0, 'spent': True, 'value': 2685959055, 'spending_outpoints': [{'tx_index': 6225837917510035, 'n': 9}], 'n': 14, 'tx_index': 5728675728882726, 'script': '76a914adfb8786f19039b78a78a999e04d68348d0571be88ac', 'addr': '1GrwDkr33gT6LuumniYjKEGjTLhsL5kmqC'}}, {'sequence': 4294967295, 'witness': '', 'script': '483045022100919b8ed2b4a338a1993fa3055c0cd185c8031749c818bb25b6efcc98fd7a468e02200ba2e2549da430b454c5a313385b868d1741d7548d601f4ff45c9e9fd01b039301210201973a41bb610e199a1fbb208398fbacc732c3658d132dbf9f3a394bedc9a7b5', 'index': 10, 'prev_out': {'type': 0, 'spent': True, 'value': 2522219771, 'spending_outpoints': [{'tx_index': 6225837917510035, 'n': 10}], 'n': 15, 'tx_index': 4518728873671181, 'script': '76a914adfb8786f19039b78a78a999e04d68348d0571be88ac', 'addr': '1GrwDkr33gT6LuumniYjKEGjTLhsL5kmqC'}}, {'sequence': 4294967295, 'witness': '', 'script': '4830450221009e5de27f7f4d2ee3fbe5afcde164d66be45015a96cdd8252db6001263859aecd02201515e76538adbab5c1dfa354ec8d46a6d4b35a0b369375eb466f1b611b711a2801210201973a41bb610e199a1fbb208398fbacc732c3658d132dbf9f3a394bedc9a7b5', 'index': 11, 'prev_out': {'type': 0, 'spent': True, 'value': 2131818682, 'spending_outpoints': [{'tx_index': 6225837917510035, 'n': 11}], 'n': 14, 'tx_index': 1285821881027914, 'script': '76a914adfb8786f19039b78a78a999e04d68348d0571be88ac', 'addr': '1GrwDkr33gT6LuumniYjKEGjTLhsL5kmqC'}}, {'sequence': 4294967295, 'witness': '', 'script': '48304502210096b6d27e50944db0803e0927b56b6764b58ea66466f0ba8f4d4e90a8f48af0d502200291ebb3543962d48b88afc1f72aa193c4fd855e374687ca4130033126a9b4f501210201973a41bb610e199a1fbb208398fbacc732c3658d132dbf9f3a394bedc9a7b5', 'index': 12, 'prev_out': {'type': 0, 'spent': True, 'value': 2064379011, 'spending_outpoints': [{'tx_index': 6225837917510035, 'n': 12}], 'n': 12, 'tx_index': 176217993536981, 'script': '76a914adfb8786f19039b78a78a999e04d68348d0571be88ac', 'addr': '1GrwDkr33gT6LuumniYjKEGjTLhsL5kmqC'}}, {'sequence': 4294967295, 'witness': '', 'script': '483045022100e63e0bc9fd36c660a9248bbe0d5c5774ecb96975deb2cb923c40ee850b73bb1102207f12aeadd3e30e94e4f78dbb15d3fe095281c8f6dd3635d6cda32047b40bdc9e01210201973a41bb610e199a1fbb208398fbacc732c3658d132dbf9f3a394bedc9a7b5', 'index': 13, 'prev_out': {'type': 0, 'spent': True, 'value': 1951057150, 'spending_outpoints': [{'tx_index': 6225837917510035, 'n': 13}], 'n': 11, 'tx_index': 7538238376668114, 'script': '76a914adfb8786f19039b78a78a999e04d68348d0571be88ac', 'addr': '1GrwDkr33gT6LuumniYjKEGjTLhsL5kmqC'}}, {'sequence': 4294967295, 'witness': '', 'script': '483045022100b61b9f2e38c8bc637cd06bebe1bd3e5aeacd0696fe897ae0ed1d9ecae729d9f202202251ffc001389be8785abba2250eb645503f93044e171e74e3fe85abbdf390f001210201973a41bb610e199a1fbb208398fbacc732c3658d132dbf9f3a394bedc9a7b5', 'index': 14, 'prev_out': {'type': 0, 'spent': True, 'value': 1762389228, 'spending_outpoints': [{'tx_index': 6225837917510035, 'n': 14}], 'n': 13, 'tx_index': 8726446097685111, 'script': '76a914adfb8786f19039b78a78a999e04d68348d0571be88ac', 'addr': '1GrwDkr33gT6LuumniYjKEGjTLhsL5kmqC'}}, {'sequence': 4294967295, 'witness': '', 'script': '483045022100b33ff38bb310262360e4575b0d7571c8789665eac4e88f49274817b7136490a30220752e8d0cf1d463c175b6541725a172a33ac405a1ff92df7eaee707f332eaaf7301210201973a41bb610e199a1fbb208398fbacc732c3658d132dbf9f3a394bedc9a7b5', 'index': 15, 'prev_out': {'type': 0, 'spent': True, 'value': 1753832943, 'spending_outpoints': [{'tx_index': 6225837917510035, 'n': 15}], 'n': 0, 'tx_index': 2891976294035287, 'script': '76a914adfb8786f19039b78a78a999e04d68348d0571be88ac', 'addr': '1GrwDkr33gT6LuumniYjKEGjTLhsL5kmqC'}}, {'sequence': 4294967295, 'witness': '', 'script': '483045022100e74da03382c612c9577461b21c07013a658d6759b45c195fcd0633c8fab5896a02207bcb4beb154466a817cca1504bf29ffa0198f7a092cd2c7e491b042a61a269310121020bbd562aecea0bd775dab92c2073a042a0191371360b326a35ade30ee5c83a48', 'index': 16, 'prev_out': {'type': 0, 'spent': True, 'value': 1600000000, 'spending_outpoints': [{'tx_index': 6225837917510035, 'n': 16}], 'n': 0, 'tx_index': 1640337769865180, 'script': '76a9142687c01fffdf4b1a45cfdd3fb1c96b6506d33a3188ac', 'addr': '14WjJQ8gvNUih1pDaXx2p9QHs2qm6f6ec1'}}, {'sequence': 4294967295, 'witness': '', 'script': '483045022100b3e81e75efc139b545eeb68f1fb71910149711ce2112db784393faad6ef7f72a022058a734212763bed218597049169d2dff75b6c7c15a4790209e78d5cc5c1eee5e01210201973a41bb610e199a1fbb208398fbacc732c3658d132dbf9f3a394bedc9a7b5', 'index': 17, 'prev_out': {'type': 0, 'spent': True, 'value': 1527995243, 'spending_outpoints': [{'tx_index': 6225837917510035, 'n': 17}], 'n': 0, 'tx_index': 6151712814166682, 'script': '76a914adfb8786f19039b78a78a999e04d68348d0571be88ac', 'addr': '1GrwDkr33gT6LuumniYjKEGjTLhsL5kmqC'}}, {'sequence': 4294967295, 'witness': '', 'script': '483045022100ff39b66961673afe4c788a023f5e6ce369b0992397262f5c5b3a08c6a636455c0220056f5b5b4e6735a54f38cc78f430e2e11b17bcff40a10d18b886b434176040d5012102cc21db868916d06d918624c35ff4a9fcd54b4e3d6e00a4f999e71e6b68ae171a', 'index': 18, 'prev_out': {'type': 0, 'spent': True, 'value': 1519390000, 'spending_outpoints': [{'tx_index': 6225837917510035, 'n': 18}], 'n': 0, 'tx_index': 1648067956004427, 'script': '76a914848970eba939f28cc4f8024517bb8db74fe2601b88ac', 'addr': '1D5nqtzQKMSUq4k9aqWHhRqH6Vsah51u3g'}}, {'sequence': 4294967295, 'witness': '', 'script': '483045022100a218e494276371e4e95436c46919d15fe510228bfe4e0a46c03466971533e8ff022041067656e902985db32402267abf95251b294693c794dfdeaad414251b5389f601210201973a41bb610e199a1fbb208398fbacc732c3658d132dbf9f3a394bedc9a7b5', 'index': 19, 'prev_out': {'type': 0, 'spent': True, 'value': 1360808369, 'spending_outpoints': [{'tx_index': 6225837917510035, 'n': 19}], 'n': 14, 'tx_index': 814193330828254, 'script': '76a914adfb8786f19039b78a78a999e04d68348d0571be88ac', 'addr': '1GrwDkr33gT6LuumniYjKEGjTLhsL5kmqC'}}, {'sequence': 4294967295, 'witness': '', 'script': '473044022011157cb3da11292f918b131ac80fb99644be654c0896c5c175b6cea1653753f002200905ddf98e0be97de6811d838645a1f3e9a450dd376946866aaf423f5cc52d4c01210201973a41bb610e199a1fbb208398fbacc732c3658d132dbf9f3a394bedc9a7b5', 'index': 20, 'prev_out': {'type': 0, 'spent': True, 'value': 1333980979, 'spending_outpoints': [{'tx_index': 6225837917510035, 'n': 20}], 'n': 0, 'tx_index': 6558026414583750, 'script': '76a914adfb8786f19039b78a78a999e04d68348d0571be88ac', 'addr': '1GrwDkr33gT6LuumniYjKEGjTLhsL5kmqC'}}, {'sequence': 4294967295, 'witness': '', 'script': '473044022011aaf6ad8d424665bca24e0c0fd356059b84b6d8978a5d30221900dc6a01395e02203367f7aa7f2dc29e21353ff5b85ed45d04d003b42f5a01e7abba8538d2fada3701210201973a41bb610e199a1fbb208398fbacc732c3658d132dbf9f3a394bedc9a7b5', 'index': 21, 'prev_out': {'type': 0, 'spent': True, 'value': 1320389473, 'spending_outpoints': [{'tx_index': 6225837917510035, 'n': 21}], 'n': 10, 'tx_index': 5221176674250366, 'script': '76a914adfb8786f19039b78a78a999e04d68348d0571be88ac', 'addr': '1GrwDkr33gT6LuumniYjKEGjTLhsL5kmqC'}}, {'sequence': 4294967295, 'witness': '', 'script': '483045022100eda18f30586627462fbb13cc88db7f90a4dc90f89a81d41b8a9f0f19940927a102201352bf47e76bf73cdaf2e54333467c3496a0f777432a26e263779f21bd061ca30121030f40d730abdf92f639584671bf7bee2a909f7193c8f0a66811327cbb534ccd69', 'index': 22, 'prev_out': {'type': 0, 'spent': True, 'value': 1295792169, 'spending_outpoints': [{'tx_index': 6225837917510035, 'n': 22}], 'n': 0, 'tx_index': 3397534014465144, 'script': '76a914c012fb10a04d0e92c900f35216d0a2a98a679f0788ac', 'addr': '1JWbUdqfcByYVdLgc9LcVZpAwY1x24YAgz'}}, {'sequence': 4294967295, 'witness': '', 'script': '473044022019f75177b0c402d4d06cd63de445b3978d1549c0c1dd95919a63312b12431380022024fafa391c4c54b3d8d115e94a63aba5cdd9dd507b69221761bf9d3093295ee801210201973a41bb610e199a1fbb208398fbacc732c3658d132dbf9f3a394bedc9a7b5', 'index': 23, 'prev_out': {'type': 0, 'spent': True, 'value': 1263362314, 'spending_outpoints': [{'tx_index': 6225837917510035, 'n': 23}], 'n': 8, 'tx_index': 7027554493772288, 'script': '76a914adfb8786f19039b78a78a999e04d68348d0571be88ac', 'addr': '1GrwDkr33gT6LuumniYjKEGjTLhsL5kmqC'}}, {'sequence': 4294967295, 'witness': '', 'script': '483045022100cb2c42ba69f1fe4a0b6092f7cd7f8f52751f005af53884e1c9fdda7de1d6717f022023947a2a3836d98153db5df6a487c535354b5ec8aa91c3fcd93b9ca05c69108501210201973a41bb610e199a1fbb208398fbacc732c3658d132dbf9f3a394bedc9a7b5', 'index': 24, 'prev_out': {'type': 0, 'spent': True, 'value': 1215856547, 'spending_outpoints': [{'tx_index': 6225837917510035, 'n': 24}], 'n': 0, 'tx_index': 3918899472013794, 'script': '76a914adfb8786f19039b78a78a999e04d68348d0571be88ac', 'addr': '1GrwDkr33gT6LuumniYjKEGjTLhsL5kmqC'}}, {'sequence': 4294967295, 'witness': '', 'script': '47304402200519d0c863ef79d86563d227b26658ad1ffe403de8dad8cf6e83260a7a07914e02204fc374a509484691b40156b33f1b93f5cca8995e0705102f94fa51c38a7c784a01210201973a41bb610e199a1fbb208398fbacc732c3658d132dbf9f3a394bedc9a7b5', 'index': 25, 'prev_out': {'type': 0, 'spent': True, 'value': 1178275579, 'spending_outpoints': [{'tx_index': 6225837917510035, 'n': 25}], 'n': 12, 'tx_index': 1122390721807191, 'script': '76a914adfb8786f19039b78a78a999e04d68348d0571be88ac', 'addr': '1GrwDkr33gT6LuumniYjKEGjTLhsL5kmqC'}}, {'sequence': 4294967295, 'witness': '', 'script': '4830450221008ef5b8488282a078bda3be0bbcf6ed2fd425d500baa0d9b020e9f559400797a102201482c5daa97880805e3076c8e4b271b48e6b0c0a75726ccafacdb2073dbd285301210201973a41bb610e199a1fbb208398fbacc732c3658d132dbf9f3a394bedc9a7b5', 'index': 26, 'prev_out': {'type': 0, 'spent': True, 'value': 1151107804, 'spending_outpoints': [{'tx_index': 6225837917510035, 'n': 26}], 'n': 10, 'tx_index': 3543897190047454, 'script': '76a914adfb8786f19039b78a78a999e04d68348d0571be88ac', 'addr': '1GrwDkr33gT6LuumniYjKEGjTLhsL5kmqC'}}, {'sequence': 4294967295, 'witness': '', 'script': '483045022100a2b011e6696b528251bce7e61ee395bc7e1efab70cd5dec58709677728e5b17902200de06af398c1c74581e33651993ae13425aab1bca3c2d14847ba1b041bb57cbb01210201973a41bb610e199a1fbb208398fbacc732c3658d132dbf9f3a394bedc9a7b5', 'index': 27, 'prev_out': {'type': 0, 'spent': True, 'value': 1073811358, 'spending_outpoints': [{'tx_index': 6225837917510035, 'n': 27}], 'n': 22, 'tx_index': 5094783435831254, 'script': '76a914adfb8786f19039b78a78a999e04d68348d0571be88ac', 'addr': '1GrwDkr33gT6LuumniYjKEGjTLhsL5kmqC'}}, {'sequence': 4294967295, 'witness': '', 'script': '47304402200aa7ae12ffda9b935a20d5f32c017617ea51055597f8cbe83475f8a23e133e1b0220592141e4944d1f7da644f5485b6389ebeb99c59cce1bc43844cf4f509e91b36c0121020e6965eb8397fcdaac0b323bde6f7d9fc8eb42011b33373df75e8d1c1d31746c', 'index': 28, 'prev_out': {'type': 0, 'spent': True, 'value': 1017028379, 'spending_outpoints': [{'tx_index': 6225837917510035, 'n': 28}], 'n': 2, 'tx_index': 540285165027413, 'script': '76a9142b362e67196de5a2892712f1e718fe1746d8898488ac', 'addr': '14wUxq4jj7HWkDdAnCf2jakhCMDd79C3f8'}}, {'sequence': 4294967295, 'witness': '', 'script': '483045022100fa3498e4857fc98dc137c204aecb060cb212608fad8f69471bb759aa5ed3f83902205081b7ed71a33dc1724eac4f9fdcebd9dc3a956d93f044cef494a90da2109e0b012103322ec6938793addb9593af2914d935c780b3993d6eb6c2d3770e30b75d2cd68f', 'index': 29, 'prev_out': {'type': 0, 'spent': True, 'value': 1000000000, 'spending_outpoints': [{'tx_index': 6225837917510035, 'n': 29}], 'n': 0, 'tx_index': 4062453819091064, 'script': '76a914c8fbb5df3ed41eb018904befff3568668ee35c3888ac', 'addr': '1KKhgWomFo8sTiM5GckMHXCXnY9mBHwNXE'}}, {'sequence': 4294967295, 'witness': '', 'script': '483045022100d713e69b644acfdea4e652038e1be000c48f629c93fc81280f204f48dd5b28b102202087053deb3a9907491ad5727f0374cf7e8dfc6d643b4504db5f4a991aad94a0012102b071ebf1132b4c26fc6a1883d814914a387e2ce1163a79493baf411290cc37fc', 'index': 30, 'prev_out': {'type': 0, 'spent': True, 'value': 1000000000, 'spending_outpoints': [{'tx_index': 6225837917510035, 'n': 30}], 'n': 0, 'tx_index': 7847721522793072, 'script': '76a9143c2fe370a5c2d239cd48197b8c38d5567857ddd088ac', 'addr': '16VEurhHY6Zevfe6qapxcxh3NcjpBQMtVp'}}, {'sequence': 4294967295, 'witness': '', 'script': '483045022100d4c2d09bc9b048af7cd545adffa31c55261aa7ab40d0ac4248271b2d3a3be83b02207187b79457abde71b62b7b622bf4df14aa04f45da5c86a50d1d64b5be44a7a7501210201973a41bb610e199a1fbb208398fbacc732c3658d132dbf9f3a394bedc9a7b5', 'index': 31, 'prev_out': {'type': 0, 'spent': True, 'value': 975663871, 'spending_outpoints': [{'tx_index': 6225837917510035, 'n': 31}], 'n': 10, 'tx_index': 6634485423070458, 'script': '76a914adfb8786f19039b78a78a999e04d68348d0571be88ac', 'addr': '1GrwDkr33gT6LuumniYjKEGjTLhsL5kmqC'}}, {'sequence': 4294967295, 'witness': '', 'script': '48304502210080c97233848030635151f4c75d9302e529f9b4fe933aa14457dfbafa8ea61e0e022054a9b6f97f96fff073a385d56db545d3e3acbcd95f4f0395b78049f03c1620cf0121034d3eef78b31f620eecc109622f1d16d8991368dd45bc7fa6fa1b0fbc6000680f', 'index': 32, 'prev_out': {'type': 0, 'spent': True, 'value': 969990000, 'spending_outpoints': [{'tx_index': 6225837917510035, 'n': 32}], 'n': 13, 'tx_index': 4405732445576265, 'script': '76a914edeb38361178fcf9c977e53d0bcb28bfb0885d6788ac', 'addr': '1NgzvomjEyj2qk1F4p9yVt5CxKhaLLd4V9'}}, {'sequence': 4294967295, 'witness': '', 'script': '483045022100c7a43966416e3069ae4ee6e0fd0386e307a66c564f4c53f86a65faf7b56a629f0220221f2d6fa1cc964f5618985f75452cd06c8b08cd4da634fa77b566bd5651a54301210201973a41bb610e199a1fbb208398fbacc732c3658d132dbf9f3a394bedc9a7b5', 'index': 33, 'prev_out': {'type': 0, 'spent': True, 'value': 969763869, 'spending_outpoints': [{'tx_index': 6225837917510035, 'n': 33}], 'n': 18, 'tx_index': 79316347279257, 'script': '76a914adfb8786f19039b78a78a999e04d68348d0571be88ac', 'addr': '1GrwDkr33gT6LuumniYjKEGjTLhsL5kmqC'}}, {'sequence': 4294967295, 'witness': '', 'script': '483045022100d20746aa6ea26e16c5a7b96fe0f00ef47c7c19aa27db1c2bc68d7aee079d3bf302207ad5cf482fde83384b36b6b21c9caca5bcfa9467910180ce8ca04bf42ca5e92a012102bda43b7719a0d0d9d34ddb5828f391d2c7b81642ebb2d83f29889c713c3db21f', 'index': 34, 'prev_out': {'type': 0, 'spent': True, 'value': 969596000, 'spending_outpoints': [{'tx_index': 6225837917510035, 'n': 34}], 'n': 12, 'tx_index': 979255956905939, 'script': '76a914bc60167d92a59df643d2f088aaf4a44aee778e8088ac', 'addr': '1JB39NBdhYCphGehZax76NLoR9RrPisXgs'}}, {'sequence': 4294967295, 'witness': '', 'script': '473044022040e0ab66a23d1a49c154ba204ce7f3e310ef26af627b4d6337b638cdd3ffba0e02206109a565f5d71e5cfce1a7db6aa2186e4e713984d5c9dd1de2ccf7d06db7b3df0121022c311c1e609ca0f34eb4d46f7cefe45642b2d3d5edd2f8c2c345e40d388b180a', 'index': 35, 'prev_out': {'type': 0, 'spent': True, 'value': 946985000, 'spending_outpoints': [{'tx_index': 6225837917510035, 'n': 35}], 'n': 3, 'tx_index': 6020052619954302, 'script': '76a914ef14834756d6f48bb3d385a56a509c7aac56258d88ac', 'addr': '1No956wAVv1w1Ukj7GdGTQscJd4fPyqnas'}}, {'sequence': 4294967295, 'witness': '', 'script': '483045022100a1be3c242a94e1672e2d4816350dbc668b9b11f8dc979355b68359a192b466190220364c9b5e6540bebc819cfd8370ba0db0e713fc6781462e7c751f906ddcc16e3201210201973a41bb610e199a1fbb208398fbacc732c3658d132dbf9f3a394bedc9a7b5', 'index': 36, 'prev_out': {'type': 0, 'spent': True, 'value': 943171648, 'spending_outpoints': [{'tx_index': 6225837917510035, 'n': 36}], 'n': 16, 'tx_index': 7390361781825520, 'script': '76a914adfb8786f19039b78a78a999e04d68348d0571be88ac', 'addr': '1GrwDkr33gT6LuumniYjKEGjTLhsL5kmqC'}}, {'sequence': 4294967295, 'witness': '', 'script': '47304402204ce90fb1872c3a90493a6956416dd221182b234644618d0be47ee1dd1f5941ee022043a88ddd91aa1ec6888d4af6df9b79562b07f1c5643a36f7ed1a3353243a8dbc01210201973a41bb610e199a1fbb208398fbacc732c3658d132dbf9f3a394bedc9a7b5', 'index': 37, 'prev_out': {'type': 0, 'spent': True, 'value': 920560178, 'spending_outpoints': [{'tx_index': 6225837917510035, 'n': 37}], 'n': 25, 'tx_index': 7757857826419128, 'script': '76a914adfb8786f19039b78a78a999e04d68348d0571be88ac', 'addr': '1GrwDkr33gT6LuumniYjKEGjTLhsL5kmqC'}}, {'sequence': 4294967295, 'witness': '', 'script': '4730440220302f0d5310efd8b8ae24d63758875af5d72001d144c553d140e6638b528c598d022013b5cf024dabba81f837d5f6988e5f29c5efb6b69e65d5e35a5fd2a35c1418f001210201973a41bb610e199a1fbb208398fbacc732c3658d132dbf9f3a394bedc9a7b5', 'index': 38, 'prev_out': {'type': 0, 'spent': True, 'value': 913541043, 'spending_outpoints': [{'tx_index': 6225837917510035, 'n': 38}], 'n': 11, 'tx_index': 519999023135031, 'script': '76a914adfb8786f19039b78a78a999e04d68348d0571be88ac', 'addr': '1GrwDkr33gT6LuumniYjKEGjTLhsL5kmqC'}}, {'sequence': 4294967295, 'witness': '', 'script': '473044022010b368fea3c2f8aa6c958f5f2973038b66cf4c2ebc9f81217ac5d29acb03ee79022061e9954a0edcdfafcbaba212c05a64ba3142f1a10eeaa7f649837c21a71f6d9801210201973a41bb610e199a1fbb208398fbacc732c3658d132dbf9f3a394bedc9a7b5', 'index': 39, 'prev_out': {'type': 0, 'spent': True, 'value': 908202515, 'spending_outpoints': [{'tx_index': 6225837917510035, 'n': 39}], 'n': 14, 'tx_index': 7031972764138811, 'script': '76a914adfb8786f19039b78a78a999e04d68348d0571be88ac', 'addr': '1GrwDkr33gT6LuumniYjKEGjTLhsL5kmqC'}}, {'sequence': 4294967295, 'witness': '', 'script': '4730440220326ccaa21cf1266e9bb1d4882e00101593f18af23b785331a198f9de8fc0912802206a3c822a51ad4e39f1706b5f0c4ad54595d72ec8b39ff34f59c658a7002016a401210201973a41bb610e199a1fbb208398fbacc732c3658d132dbf9f3a394bedc9a7b5', 'index': 40, 'prev_out': {'type': 0, 'spent': True, 'value': 900324642, 'spending_outpoints': [{'tx_index': 6225837917510035, 'n': 40}], 'n': 15, 'tx_index': 6906425683662423, 'script': '76a914adfb8786f19039b78a78a999e04d68348d0571be88ac', 'addr': '1GrwDkr33gT6LuumniYjKEGjTLhsL5kmqC'}}, {'sequence': 4294967295, 'witness': '', 'script': '483045022100e5094a4fc66d374df3dabdf7c81521fd74e50df3945d2c860d2eea43dc3e1396022023475d99bcb6a45373496a2f97348ca7c90ee881b01a9d9c3d41646d107d4c190121020bbd562aecea0bd775dab92c2073a042a0191371360b326a35ade30ee5c83a48', 'index': 41, 'prev_out': {'type': 0, 'spent': True, 'value': 900000000, 'spending_outpoints': [{'tx_index': 6225837917510035, 'n': 41}], 'n': 0, 'tx_index': 2287832311297379, 'script': '76a9142687c01fffdf4b1a45cfdd3fb1c96b6506d33a3188ac', 'addr': '14WjJQ8gvNUih1pDaXx2p9QHs2qm6f6ec1'}}, {'sequence': 4294967295, 'witness': '', 'script': '483045022100d099043f1eb5e410ce7a00b9b2ccc75d09c74e242de442d5082d3b935c97320402206dff82cb57139ff7c28a233fdc95f4fe741d51fddb00de19cd57b8941139ea02012103113dddb72bc55d72159a98fb4447c217965b0981658b98283d04b5be328255f0', 'index': 42, 'prev_out': {'type': 0, 'spent': True, 'value': 900000000, 'spending_outpoints': [{'tx_index': 6225837917510035, 'n': 42}], 'n': 1, 'tx_index': 328462303975742, 'script': '76a9148b86649c0887b7d8ffc5a88936def94b65657cc688ac', 'addr': '1DijvTLrq7sH5VCHHopGRX3LDx5d7u1v2p'}}, {'sequence': 4294967295, 'witness': '', 'script': '4730440220526422f8144432347b269f976de7f47aa6161a2c43f89300ee31d74268433160022050ebdd9f98e1940c816d52858660d0fc05985abb837e7368d05c0b66439ebe1801210275532f6feb02e818771995740c55ce94f0f72dd805fb8751c86bacbb38b51ebd', 'index': 43, 'prev_out': {'type': 0, 'spent': True, 'value': 899980000, 'spending_outpoints': [{'tx_index': 6225837917510035, 'n': 43}], 'n': 1, 'tx_index': 6028834940542582, 'script': '76a91453d8597b3aec1b791d1368cc1a92f44c0e59c39e88ac', 'addr': '18eLG9mqeCKVrL7hGcYG1QMQHRHtdCykyX'}}, {'sequence': 4294967295, 'witness': '', 'script': '483045022100cca8f032348893a70fa945d4227431c0f1e5c92efc85bce21d6e056ebf712a1202200f93f66848d27998b1e9f066ec268bb25d2129a7079cd058bb4809edd22f930501210201973a41bb610e199a1fbb208398fbacc732c3658d132dbf9f3a394bedc9a7b5', 'index': 44, 'prev_out': {'type': 0, 'spent': True, 'value': 883536449, 'spending_outpoints': [{'tx_index': 6225837917510035, 'n': 44}], 'n': 23, 'tx_index': 7137686310776457, 'script': '76a914adfb8786f19039b78a78a999e04d68348d0571be88ac', 'addr': '1GrwDkr33gT6LuumniYjKEGjTLhsL5kmqC'}}, {'sequence': 4294967295, 'witness': '', 'script': '483045022100aed75ed4a099cffc89f472ab6db35315a179f81f9e49e8cc7f9e9c45bfce273e0220093035c6865e26e7e97d78d0e49246bad78f974f70b2dedab459932c516239f501210201973a41bb610e199a1fbb208398fbacc732c3658d132dbf9f3a394bedc9a7b5', 'index': 45, 'prev_out': {'type': 0, 'spent': True, 'value': 877550043, 'spending_outpoints': [{'tx_index': 6225837917510035, 'n': 45}], 'n': 0, 'tx_index': 112984256332966, 'script': '76a914adfb8786f19039b78a78a999e04d68348d0571be88ac', 'addr': '1GrwDkr33gT6LuumniYjKEGjTLhsL5kmqC'}}, {'sequence': 4294967295, 'witness': '', 'script': '47304402202df9922784ebe509eacbe8499843e6e4a74fda07491f70a2e3f3c8c7053424100220609ed52b33cca335f6ccddc08c97ac26ba83833b440f31cf6aa1a86c7eadd78401210383d15e7958aa9ace2db1d6fe7e183a27a40747d3e2b889637f1236d6f547c89e', 'index': 46, 'prev_out': {'type': 0, 'spent': True, 'value': 875990000, 'spending_outpoints': [{'tx_index': 6225837917510035, 'n': 46}], 'n': 0, 'tx_index': 409990172862222, 'script': '76a91444dab65da4b42897c2d2eb9296cf5f0916bde0ea88ac', 'addr': '17H4xSsfdj5h25dym8cZmd7bSHaaCMxzFG'}}, {'sequence': 4294967295, 'witness': '', 'script': '473044022075929056494dab33fa7e0f30e99f663de7e8faeea1cf220a92c728e1171d7b67022069b21920ba06069d1cab63147f44997c7d589bd691f7f938efa1b4c5a47a3d9201210201973a41bb610e199a1fbb208398fbacc732c3658d132dbf9f3a394bedc9a7b5', 'index': 47, 'prev_out': {'type': 0, 'spent': True, 'value': 870113731, 'spending_outpoints': [{'tx_index': 6225837917510035, 'n': 47}], 'n': 23, 'tx_index': 4054197531984022, 'script': '76a914adfb8786f19039b78a78a999e04d68348d0571be88ac', 'addr': '1GrwDkr33gT6LuumniYjKEGjTLhsL5kmqC'}}, {'sequence': 4294967295, 'witness': '', 'script': '483045022100ace4769773ee79433056a76095af84638139fa15c6f484d9489c0d0d8ce3717102201a30817fee2f1e097fe6ef3c7b9478469fa1b35a048cea383974e326d592014a01210201973a41bb610e199a1fbb208398fbacc732c3658d132dbf9f3a394bedc9a7b5', 'index': 48, 'prev_out': {'type': 0, 'spent': True, 'value': 867633595, 'spending_outpoints': [{'tx_index': 6225837917510035, 'n': 48}], 'n': 0, 'tx_index': 7019217286399010, 'script': '76a914adfb8786f19039b78a78a999e04d68348d0571be88ac', 'addr': '1GrwDkr33gT6LuumniYjKEGjTLhsL5kmqC'}}, {'sequence': 4294967295, 'witness': '', 'script': '483045022100fca71930d2cc11a2425396b1b1061692ab44314ba39966280ea4f0a61a252f30022024dc1b7c0ef9f5cd3df961787ff65b9386ca435cf9ea26c62dc021da0582c7e401210201973a41bb610e199a1fbb208398fbacc732c3658d132dbf9f3a394bedc9a7b5', 'index': 49, 'prev_out': {'type': 0, 'spent': True, 'value': 859178403, 'spending_outpoints': [{'tx_index': 6225837917510035, 'n': 49}], 'n': 16, 'tx_index': 1895855622346647, 'script': '76a914adfb8786f19039b78a78a999e04d68348d0571be88ac', 'addr': '1GrwDkr33gT6LuumniYjKEGjTLhsL5kmqC'}}, {'sequence': 4294967295, 'witness': '', 'script': '4730440220261c1122b20b60f7862cf7294c905931d0f992d9af3b9328a2ef69e0eba7ac42022010e6a0aef0d474c52ddf978f4d590882f7c75d0685d43cb8f583cf35868e948901210201973a41bb610e199a1fbb208398fbacc732c3658d132dbf9f3a394bedc9a7b5', 'index': 50, 'prev_out': {'type': 0, 'spent': True, 'value': 852093783, 'spending_outpoints': [{'tx_index': 6225837917510035, 'n': 50}], 'n': 8, 'tx_index': 8455029341558256, 'script': '76a914adfb8786f19039b78a78a999e04d68348d0571be88ac', 'addr': '1GrwDkr33gT6LuumniYjKEGjTLhsL5kmqC'}}, {'sequence': 4294967295, 'witness': '', 'script': '473044022028b2194d3be5ef1d3e12d193a24249e035a31e5b6a857f1ef00147b8822492350220312edaeedcdb6235450b3d5adc8c743d8bda3286993b5ef453e2b6cf616e55f301210201973a41bb610e199a1fbb208398fbacc732c3658d132dbf9f3a394bedc9a7b5', 'index': 51, 'prev_out': {'type': 0, 'spent': True, 'value': 848772822, 'spending_outpoints': [{'tx_index': 6225837917510035, 'n': 51}], 'n': 15, 'tx_index': 5979184943739509, 'script': '76a914adfb8786f19039b78a78a999e04d68348d0571be88ac', 'addr': '1GrwDkr33gT6LuumniYjKEGjTLhsL5kmqC'}}, {'sequence': 4294967295, 'witness': '', 'script': '47304402201cf0ab8dc1c08a33d6227122d5d2954704e5f7c8d0ff559eb0612d2aead2fdbb022054151459b92c3f29f67bffc2f10fa2acc2783f450129c8f7eca0d3c039dda93601210201973a41bb610e199a1fbb208398fbacc732c3658d132dbf9f3a394bedc9a7b5', 'index': 52, 'prev_out': {'type': 0, 'spent': True, 'value': 837531248, 'spending_outpoints': [{'tx_index': 6225837917510035, 'n': 52}], 'n': 19, 'tx_index': 8698192024782374, 'script': '76a914adfb8786f19039b78a78a999e04d68348d0571be88ac', 'addr': '1GrwDkr33gT6LuumniYjKEGjTLhsL5kmqC'}}, {'sequence': 4294967295, 'witness': '', 'script': '473044022077c7c36a1a4bb4821fd157b2ad0e10e81c3dab0de1e458956201d4b3717dad1a022075c0433ce9753624e8a1b69d379194c5e08c0463839d9df2e3fb5bd4c069b1680121022c311c1e609ca0f34eb4d46f7cefe45642b2d3d5edd2f8c2c345e40d388b180a', 'index': 53, 'prev_out': {'type': 0, 'spent': True, 'value': 834485000, 'spending_outpoints': [{'tx_index': 6225837917510035, 'n': 53}], 'n': 5, 'tx_index': 1938677538264189, 'script': '76a914ef14834756d6f48bb3d385a56a509c7aac56258d88ac', 'addr': '1No956wAVv1w1Ukj7GdGTQscJd4fPyqnas'}}, {'sequence': 4294967295, 'witness': '', 'script': '47304402202f3f7ecbf7898bd7ef105b61e4abcf85ad8d3876d330403606745104e2f09e6f02200c4b49634da30bcfca7db46b7a5ae3b1797cf79fcade3b3f5cfadf78f2e843d70121020e6965eb8397fcdaac0b323bde6f7d9fc8eb42011b33373df75e8d1c1d31746c', 'index': 54, 'prev_out': {'type': 0, 'spent': True, 'value': 826620250, 'spending_outpoints': [{'tx_index': 6225837917510035, 'n': 54}], 'n': 1, 'tx_index': 4517632002205283, 'script': '76a9142b362e67196de5a2892712f1e718fe1746d8898488ac', 'addr': '14wUxq4jj7HWkDdAnCf2jakhCMDd79C3f8'}}, {'sequence': 4294967295, 'witness': '', 'script': '47304402202b062591e3b71cb1b0f0c45e108c48133054f553b973b3e3772ceee87076593f022034cfc49601e4434d56780917cf079afc252426a902fe17aa0526e96c58aa5428012102ffdbdda6d76e773f0a362ae36d2ebfd6e7c96bbb004b23a2cc55356f2e3041d9', 'index': 55, 'prev_out': {'type': 0, 'spent': True, 'value': 824000000, 'spending_outpoints': [{'tx_index': 6225837917510035, 'n': 55}], 'n': 0, 'tx_index': 310990578179088, 'script': '76a9145a0229e80aef2d18ff75a71e2afcd5eb8ae8822888ac', 'addr': '19CvQbrtVPPN9HiCDSzEXipSiQa9CpPMnb'}}, {'sequence': 4294967295, 'witness': '', 'script': '483045022100e07086e8ee8ca449b40b25f2c8fdce2f07d6815000be45d9127e444246a14d0e02207862e66c477abab88aa684cfc1cf135fd252087c671ed0bc8420f1b629eecb0a01210201973a41bb610e199a1fbb208398fbacc732c3658d132dbf9f3a394bedc9a7b5', 'index': 56, 'prev_out': {'type': 0, 'spent': True, 'value': 821545406, 'spending_outpoints': [{'tx_index': 6225837917510035, 'n': 56}], 'n': 0, 'tx_index': 4152636152171434, 'script': '76a914adfb8786f19039b78a78a999e04d68348d0571be88ac', 'addr': '1GrwDkr33gT6LuumniYjKEGjTLhsL5kmqC'}}, {'sequence': 4294967295, 'witness': '', 'script': '473044022025ba6fe8c895ef436d0c0c985c65fdb85084cda14f1558ed1c0ec8d7bdc66f020220104cff9cace6c8cd1703faa8c7848a06cfca2b3a380a0751df260e6cc841605201210201973a41bb610e199a1fbb208398fbacc732c3658d132dbf9f3a394bedc9a7b5', 'index': 57, 'prev_out': {'type': 0, 'spent': True, 'value': 816086898, 'spending_outpoints': [{'tx_index': 6225837917510035, 'n': 57}], 'n': 7, 'tx_index': 5950391808787192, 'script': '76a914adfb8786f19039b78a78a999e04d68348d0571be88ac', 'addr': '1GrwDkr33gT6LuumniYjKEGjTLhsL5kmqC'}}, {'sequence': 4294967295, 'witness': '', 'script': '4830450221009526619010a38ea35c328f36d4410a055dc107e3ae65b2057bec7fcac634cd8a022005d2f02f3bdcb01c57b7fd73e06084525acf2125aebb5a9154fa0ed35327bbbe012103c958f2550bce6f81f721d249b4b827d72aa145d38a96ffc25ce4dc85bfdc0021', 'index': 58, 'prev_out': {'type': 0, 'spent': True, 'value': 804614445, 'spending_outpoints': [{'tx_index': 6225837917510035, 'n': 58}], 'n': 0, 'tx_index': 4835503423639997, 'script': '76a914e8d7e618238ad155e77d800fb9e3ff1588f3a44988ac', 'addr': '1NEAQRAgKoiti45oJUmyybY6ryi5dVU7px'}}, {'sequence': 4294967295, 'witness': '', 'script': '4830450221009306a253dc234708fee8bf49ee2751aef83d42c38b342c18f73a96426d054d5502205e5698722cd6e2bcfc8c577fc083b72d4c1264aaea44317e061de0a8dd14e5020121020e6965eb8397fcdaac0b323bde6f7d9fc8eb42011b33373df75e8d1c1d31746c', 'index': 59, 'prev_out': {'type': 0, 'spent': True, 'value': 800000000, 'spending_outpoints': [{'tx_index': 6225837917510035, 'n': 59}], 'n': 3, 'tx_index': 4547251315981505, 'script': '76a9142b362e67196de5a2892712f1e718fe1746d8898488ac', 'addr': '14wUxq4jj7HWkDdAnCf2jakhCMDd79C3f8'}}, {'sequence': 4294967295, 'witness': '', 'script': '4730440220685c46a063c663ea0533631a6ec6c91625a416b141f580ed27208bd5d563aa34022076cac8b37877ef8fb0b4d336a06f1dce2a949265da569897f395dedc98b6bcff0121020bbd562aecea0bd775dab92c2073a042a0191371360b326a35ade30ee5c83a48', 'index': 60, 'prev_out': {'type': 0, 'spent': True, 'value': 800000000, 'spending_outpoints': [{'tx_index': 6225837917510035, 'n': 60}], 'n': 0, 'tx_index': 2669138373605475, 'script': '76a9142687c01fffdf4b1a45cfdd3fb1c96b6506d33a3188ac', 'addr': '14WjJQ8gvNUih1pDaXx2p9QHs2qm6f6ec1'}}, {'sequence': 4294967295, 'witness': '', 'script': '47304402204b7dd168c37bea7b1932f98be9b953caf8e8eb42841545b647e0e50aa8ba5749022070654d8189b6a8677582997c58180f4c80f47708b5a0e1d8318ce1bbbf51e50f01210275532f6feb02e818771995740c55ce94f0f72dd805fb8751c86bacbb38b51ebd', 'index': 61, 'prev_out': {'type': 0, 'spent': True, 'value': 800000000, 'spending_outpoints': [{'tx_index': 6225837917510035, 'n': 61}], 'n': 1, 'tx_index': 4711086006756302, 'script': '76a91453d8597b3aec1b791d1368cc1a92f44c0e59c39e88ac', 'addr': '18eLG9mqeCKVrL7hGcYG1QMQHRHtdCykyX'}}, {'sequence': 4294967295, 'witness': '', 'script': '47304402200d8ab5984289b98d8be0a51b8243172ce8b602c7deeac0c6088f5fd726afa1df02200b62d285325d6e1ff61f5a56dfe347f041f7530a32aab37bd80205afdf11206201210355712bafc849320f223f8c0aee2001de32ff823547d97cc355f70953903d54fa', 'index': 62, 'prev_out': {'type': 0, 'spent': True, 'value': 800000000, 'spending_outpoints': [{'tx_index': 6225837917510035, 'n': 62}], 'n': 0, 'tx_index': 1729812832051088, 'script': '76a914a55be9634fbc6521f0a2a152efbd6cc6be7f3c6488ac', 'addr': '1G5LbneCYeBrZYrCaUHSQGb49g5M5MrXcs'}}, {'sequence': 4294967295, 'witness': '', 'script': '483045022100ae509748166afc36d9e1a169caa59bcd7e04060d588f14dd8dca4a66af57da19022003973e7978b94b6be0104dfd473c11414d3f69a726609fdc916e453fc404c5fc01210275532f6feb02e818771995740c55ce94f0f72dd805fb8751c86bacbb38b51ebd', 'index': 63, 'prev_out': {'type': 0, 'spent': True, 'value': 799990000, 'spending_outpoints': [{'tx_index': 6225837917510035, 'n': 63}], 'n': 7, 'tx_index': 8259530024701560, 'script': '76a91453d8597b3aec1b791d1368cc1a92f44c0e59c39e88ac', 'addr': '18eLG9mqeCKVrL7hGcYG1QMQHRHtdCykyX'}}]","[{'type': 0, 'spent': False, 'value': 100000000000, 'spending_outpoints': [], 'n': 0, 'tx_index': 6225837917510035, 'script': '0020eab3cd0683f9554a66261793846f509ceaefd2cd4dfc20adf400689eb4addc09', 'addr': 'bc1qa2eu6p5rl9255e3xz7fcgm6snn4wl5kdfh7zpt05qp5fad9dmsys0qjg0e'}, {'type': 0, 'spent': True, 'value': 114873001, 'spending_outpoints': [{'tx_index': 8517727441285580, 'n': 4}], 'n': 1, 'tx_index': 6225837917510035, 'script': '76a914adfb8786f19039b78a78a999e04d68348d0571be88ac', 'addr': '1GrwDkr33gT6LuumniYjKEGjTLhsL5kmqC'}]",100000000000,1094597665510
cf2753e3d7a880f0eff8b85e0ec033b73f79f510b92995109b276fa21c91abd4,2,7,2,1119,4476,33420,0.0.0.0,0,7482666850209252,False,1728962320,865689,865689,"[{'sequence': 4294967295, 'witness': '', 'script': '47304402201de8e845b6672276758d4d001d0204dbdb7fb8a95ef4278ec9d4e08a27fe6752022065b40abdcb27b45745d67f010638e8bf42170b3ec4d9cfcdf96dac81d5e83e4901210201973a41bb610e199a1fbb208398fbacc732c3658d132dbf9f3a394bedc9a7b5', 'index': 0, 'prev_out': {'type': 0, 'spent': True, 'value': 9364299688, 'spending_outpoints': [{'tx_index': 7482666850209252, 'n': 0}], 'n': 9, 'tx_index': 713572685099979, 'script': '76a914adfb8786f19039b78a78a999e04d68348d0571be88ac', 'addr': '1GrwDkr33gT6LuumniYjKEGjTLhsL5kmqC'}}, {'sequence': 4294967295, 'witness': '', 'script': '4730440220181a5fcf45cff714bd4645663c52c36fa8855a7ba6c08f15606c1b8d3cf8af0e022028f1aef81ac4aea168232e1098ed914c712cf7dbc54a1c3d91dfd8c9e355786201210201973a41bb610e199a1fbb208398fbacc732c3658d132dbf9f3a394bedc9a7b5', 'index': 1, 'prev_out': {'type': 0, 'spent': True, 'value': 9193736878, 'spending_outpoints': [{'tx_index': 7482666850209252, 'n': 1}], 'n': 8, 'tx_index': 3677699176850724, 'script': '76a914adfb8786f19039b78a78a999e04d68348d0571be88ac', 'addr': '1GrwDkr33gT6LuumniYjKEGjTLhsL5kmqC'}}, {'sequence': 4294967295, 'witness': '', 'script': '483045022100fe117e585a504bf2350c42b9f8fefd35f2fbb916e68930005e4bc314cf85c619022055a0fe080e907216292894dbb4b9cafe1f2716b6c3509f7681d1948ab45f2c2001210201973a41bb610e199a1fbb208398fbacc732c3658d132dbf9f3a394bedc9a7b5', 'index': 2, 'prev_out': {'type': 0, 'spent': True, 'value': 9134894331, 'spending_outpoints': [{'tx_index': 7482666850209252, 'n': 2}], 'n': 7, 'tx_index': 3716689693096524, 'script': '76a914adfb8786f19039b78a78a999e04d68348d0571be88ac', 'addr': '1GrwDkr33gT6LuumniYjKEGjTLhsL5kmqC'}}, {'sequence': 4294967295, 'witness': '', 'script': '47304402200ca793732b2559ebcf412bc4ce54ef8c6115722cf656623297d93892befc5a7802203d7d415524a1a65a85260bae350c6daaf9c3b08f4b3eaa783d919d5facc96b9901210201973a41bb610e199a1fbb208398fbacc732c3658d132dbf9f3a394bedc9a7b5', 'index': 3, 'prev_out': {'type': 0, 'spent': True, 'value': 8199497263, 'spending_outpoints': [{'tx_index': 7482666850209252, 'n': 3}], 'n': 7, 'tx_index': 2003604998266722, 'script': '76a914adfb8786f19039b78a78a999e04d68348d0571be88ac', 'addr': '1GrwDkr33gT6LuumniYjKEGjTLhsL5kmqC'}}, {'sequence': 4294967295, 'witness': '', 'script': '483045022100c4d63e834b4cf882cdedee6790cea5d39a41a3d98687fc617018c21699bdf3cc02203e8a9a9939a8e53fe59acfbf1d44085391ec517cc47642fdb5c8f58fcd6e53f701210201973a41bb610e199a1fbb208398fbacc732c3658d132dbf9f3a394bedc9a7b5', 'index': 4, 'prev_out': {'type': 0, 'spent': True, 'value': 7025054001, 'spending_outpoints': [{'tx_index': 7482666850209252, 'n': 4}], 'n': 5, 'tx_index': 3403169326499596, 'script': '76a914adfb8786f19039b78a78a999e04d68348d0571be88ac', 'addr': '1GrwDkr33gT6LuumniYjKEGjTLhsL5kmqC'}}, {'sequence': 4294967295, 'witness': '', 'script': '483045022100e09412a39e40f41f37e20d3dd06ebe5da8f5cd458390fe19c8641ff7be5eb917022008f4150c9fe95215170fd0c267b040e06b2fd069b4f3fb3589447babfe45a12201210201973a41bb610e199a1fbb208398fbacc732c3658d132dbf9f3a394bedc9a7b5', 'index': 5, 'prev_out': {'type': 0, 'spent': True, 'value': 6522332153, 'spending_outpoints': [{'tx_index': 7482666850209252, 'n': 5}], 'n': 0, 'tx_index': 6509966242615267, 'script': '76a914adfb8786f19039b78a78a999e04d68348d0571be88ac', 'addr': '1GrwDkr33gT6LuumniYjKEGjTLhsL5kmqC'}}, {'sequence': 4294967295, 'witness': '', 'script': '4730440220072e604caa36208d4fccb69610990add17ed4dbb561940887135d0a01ed9f26d02204de2a934acbd97423b2aa0587fbd7007cdceb8ebd1026a3f80be4e78e42dc21f01210201973a41bb610e199a1fbb208398fbacc732c3658d132dbf9f3a394bedc9a7b5', 'index': 6, 'prev_out': {'type': 0, 'spent': True, 'value': 6231464768, 'spending_outpoints': [{'tx_index': 7482666850209252, 'n': 6}], 'n': 0, 'tx_index': 2030555854121398, 'script': '76a914adfb8786f19039b78a78a999e04d68348d0571be88ac', 'addr': '1GrwDkr33gT6LuumniYjKEGjTLhsL5kmqC'}}]","[{'type': 0, 'spent': False, 'value': 50000000000, 'spending_outpoints': [], 'n': 0, 'tx_index': 7482666850209252, 'script': '0020eab3cd0683f9554a66261793846f509ceaefd2cd4dfc20adf400689eb4addc09', 'addr': 'bc1qa2eu6p5rl9255e3xz7fcgm6snn4wl5kdfh7zpt05qp5fad9dmsys0qjg0e'}, {'type': 0, 'spent': True, 'value': 5671245662, 'spending_outpoints': [{'tx_index': 2699110765995858, 'n': 0}], 'n': 1, 'tx_index': 7482666850209252, 'script': '76a914adfb8786f19039b78a78a999e04d68348d0571be88ac', 'addr': '1GrwDkr33gT6LuumniYjKEGjTLhsL5kmqC'}]",50000000000,994597665510
6cfde4b83c2bae5df8911f8612e6455deca30b0bd51227fbe9a4c1a31d47795a,2,11,2,1709,6836,64828,0.0.0.0,0,3183261781358644,False,1728895541,865576,865576,"[{'sequence': 4294967295, 'witness': '', 'script': '473044022057751e32d9d4a9669477099dfb2fc5464eba96a3e3a1a3fc6996f9bf5835469002202b8bf1b4228f0528f37ded63077d7e7a6f5aadcdf60b4394a5ed15527fb4876001210201973a41bb610e199a1fbb208398fbacc732c3658d132dbf9f3a394bedc9a7b5', 'index': 0, 'prev_out': {'type': 0, 'spent': True, 'value': 3087601929, 'spending_outpoints': [{'tx_index': 3183261781358644, 'n': 0}], 'n': 11, 'tx_index': 5786306075917187, 'script': '76a914adfb8786f19039b78a78a999e04d68348d0571be88ac', 'addr': '1GrwDkr33gT6LuumniYjKEGjTLhsL5kmqC'}}, {'sequence': 4294967295, 'witness': '', 'script': '483045022100d83030534361f70dc22e0b7172bd6f7d3bea7590985dd4407bb256a6551bdc390220193756b32539433cba40c5f86bbd1999561e48e8a35eab12a1f5814f740a752f012102f65b2a474d5ae38bf40abfc4b7eb3ee58a4f7e183d7d8c5daa04972499fa539e', 'index': 1, 'prev_out': {'type': 0, 'spent': True, 'value': 2270000000, 'spending_outpoints': [{'tx_index': 3183261781358644, 'n': 1}], 'n': 2, 'tx_index': 7182634292700450, 'script': '76a9147d162007c5bffe3a8db6dc288eb3a841c87c01a088ac', 'addr': '1CQPyG2FeEvTRKRGBVesbadyYMUxBWhxx7'}}, {'sequence': 4294967295, 'witness': '', 'script': '483045022100a0ff943c39f8e09b1300c63af09983cf9a67c9b3c26b0e99db94e56aa1b79abf0220332062255aff51e52a4767fb9caac7d932a4ffc2099c70f3fcf706a7b1be0ee70121034d3eef78b31f620eecc109622f1d16d8991368dd45bc7fa6fa1b0fbc6000680f', 'index': 2, 'prev_out': {'type': 0, 'spent': True, 'value': 2219990000, 'spending_outpoints': [{'tx_index': 3183261781358644, 'n': 2}], 'n': 7, 'tx_index': 1600452495475289, 'script': '76a914edeb38361178fcf9c977e53d0bcb28bfb0885d6788ac', 'addr': '1NgzvomjEyj2qk1F4p9yVt5CxKhaLLd4V9'}}, {'sequence': 4294967295, 'witness': '', 'script': '483045022100da20b2f8270031bd4db78b0c9c89aaeab57a97f63738ec5e8a74c377e55c04bf0220601eb19e98b882734138c35c0ff475db5d2d1b84d46dfd3e760bb6a37a25c9ad01210201973a41bb610e199a1fbb208398fbacc732c3658d132dbf9f3a394bedc9a7b5', 'index': 3, 'prev_out': {'type': 0, 'spent': True, 'value': 2146150327, 'spending_outpoints': [{'tx_index': 3183261781358644, 'n': 3}], 'n': 13, 'tx_index': 4502959491088508, 'script': '76a914adfb8786f19039b78a78a999e04d68348d0571be88ac', 'addr': '1GrwDkr33gT6LuumniYjKEGjTLhsL5kmqC'}}, {'sequence': 4294967295, 'witness': '', 'script': '473044022040e3dbfd4e291669576fcad0b35575f88754d034571a161c1e4cff03490a4a0802202c2de279bb1b66060c580df428e7815c8375f9d8b1da27187fec8ba7cd2d4da2012102192aa2871ef28143a1847db6991e610bf2d41dab0509fa572211e8be133c79c2', 'index': 4, 'prev_out': {'type': 0, 'spent': True, 'value': 1899990000, 'spending_outpoints': [{'tx_index': 3183261781358644, 'n': 4}], 'n': 6, 'tx_index': 2931912797120532, 'script': '76a9146cf8743b33c162a7ea25672436d63e0d26f4ed6388ac', 'addr': '1AwBccAJeECtjke6h3ZemLU9hQeFWNrrzj'}}, {'sequence': 4294967295, 'witness': '', 'script': '47304402205d9ac5da000e407bc19edc55538ce62f707ed819f8d61b8a483ccf9f3d93c88902205e25cec739fbad22dc75482ee054e67c1713b4b820dcbc7b8e40c5dd93b90c0e012103f250289afc1604963ad079a60a9654bd83f405fb0293258f405248eb53b4afdb', 'index': 5, 'prev_out': {'type': 0, 'spent': True, 'value': 1640000000, 'spending_outpoints': [{'tx_index': 3183261781358644, 'n': 5}], 'n': 3, 'tx_index': 8916095272010552, 'script': '76a914d27e576bc95c7c72078390a6bc3703ebfa9f23ce88ac', 'addr': '1LBzFeQSkU3gju2zQGU9D3mmpixTkFA9gr'}}, {'sequence': 4294967295, 'witness': '', 'script': '4830450221008a6dff4b38550e07c818927cfe83b0c5db84c9e722f9942b5bbe3abc82331b8702200e431bf639814e64469c72febeb1fdd044fa8e5119d8968523b719923618762301210201973a41bb610e199a1fbb208398fbacc732c3658d132dbf9f3a394bedc9a7b5', 'index': 6, 'prev_out': {'type': 0, 'spent': True, 'value': 1632181894, 'spending_outpoints': [{'tx_index': 3183261781358644, 'n': 6}], 'n': 16, 'tx_index': 2015768321508472, 'script': '76a914adfb8786f19039b78a78a999e04d68348d0571be88ac', 'addr': '1GrwDkr33gT6LuumniYjKEGjTLhsL5kmqC'}}, {'sequence': 4294967295, 'witness': '', 'script': '47304402203df039e0e74bed42b68b962db4af1307ed1f8eb1f8ad9e2bedbfa13e6e3d960d022025f5f6b52e86ffc1b8259e356ab0da4963f061346bc633f7e06900a780b3fe2f01210201973a41bb610e199a1fbb208398fbacc732c3658d132dbf9f3a394bedc9a7b5', 'index': 7, 'prev_out': {'type': 0, 'spent': True, 'value': 1617199803, 'spending_outpoints': [{'tx_index': 3183261781358644, 'n': 7}], 'n': 8, 'tx_index': 2227820872156734, 'script': '76a914adfb8786f19039b78a78a999e04d68348d0571be88ac', 'addr': '1GrwDkr33gT6LuumniYjKEGjTLhsL5kmqC'}}, {'sequence': 4294967295, 'witness': '', 'script': '4830450221009d942d8086854ff81e1565f16ddcfb95e42c3948aa01360ef8f291594bdbf45002203ef47f7aa3db497c5ca4759b0bdeb9d830f6d26f25b08bce5bd5ac362fcea18201210201973a41bb610e199a1fbb208398fbacc732c3658d132dbf9f3a394bedc9a7b5', 'index': 8, 'prev_out': {'type': 0, 'spent': True, 'value': 1608838983, 'spending_outpoints': [{'tx_index': 3183261781358644, 'n': 8}], 'n': 14, 'tx_index': 8489287843817323, 'script': '76a914adfb8786f19039b78a78a999e04d68348d0571be88ac', 'addr': '1GrwDkr33gT6LuumniYjKEGjTLhsL5kmqC'}}, {'sequence': 4294967295, 'witness': '', 'script': '47304402200bbc010eb746c9a23712cf72402b3c6200074929caf120577130bb59287a353602203162f72c67c9053631d1716640d206a0f15b50d39625710832d9ad5a5b49a97d01210201973a41bb610e199a1fbb208398fbacc732c3658d132dbf9f3a394bedc9a7b5', 'index': 9, 'prev_out': {'type': 0, 'spent': True, 'value': 1395925322, 'spending_outpoints': [{'tx_index': 3183261781358644, 'n': 9}], 'n': 5, 'tx_index': 7519880612842680, 'script': '76a914adfb8786f19039b78a78a999e04d68348d0571be88ac', 'addr': '1GrwDkr33gT6LuumniYjKEGjTLhsL5kmqC'}}, {'sequence': 4294967295, 'witness': '', 'script': '4730440220126ac771a149e6d2730310b3958b0e40ca24d58dcda17e32f94bfa49d6e8e79d022054d9b4f528ad09096cea7bf52a9aeeda4b3db451c2c259b675eaf7ad1c10c4f50121031fb1a055cab371ee18d66fb65cc5443ac92d3d037fc784013438d1c058371397', 'index': 10, 'prev_out': {'type': 0, 'spent': True, 'value': 1299945000, 'spending_outpoints': [{'tx_index': 3183261781358644, 'n': 10}], 'n': 0, 'tx_index': 1706160032032694, 'script': '76a91433582c90ac0919afa1cd40869aca3a7767486fae88ac', 'addr': '15gV6E7HzjPMtpqAMWkzohZpDUyVUG5KLZ'}}]","[{'type': 0, 'spent': False, 'value': 20000000000, 'spending_outpoints': [], 'n': 0, 'tx_index': 3183261781358644, 'script': '0020eab3cd0683f9554a66261793846f509ceaefd2cd4dfc20adf400689eb4addc09', 'addr': 'bc1qa2eu6p5rl9255e3xz7fcgm6snn4wl5kdfh7zpt05qp5fad9dmsys0qjg0e'}, {'type': 0, 'spent': True, 'value': 817758430, 'spending_outpoints': [{'tx_index': 4822005905702801, 'n': 2}], 'n': 1, 'tx_index': 3183261781358644, 'script': '76a914adfb8786f19039b78a78a999e04d68348d0571be88ac', 'addr': '1GrwDkr33gT6LuumniYjKEGjTLhsL5kmqC'}]",20000000000,944597665510
d88471e4ab31f6c16255e158def5210400952a6bb858ad4f8c1491cf20e85257,2,56,2,8347,33388,125490,0.0.0.0,0,3072434988773922,False,1728033691,864095,864095,"[{'sequence': 4294967295, 'witness': '', 'script': '47304402206059c8043f09b5eecef98517aa71387ab1117194e069cba98b12f01eeca1cf1b02205d4603ca502e92a60fb412ecd3c81537789d57cd4e4aaf0517f4f9788cca743101210201973a41bb610e199a1fbb208398fbacc732c3658d132dbf9f3a394bedc9a7b5', 'index': 0, 'prev_out': {'type': 0, 'spent': True, 'value': 16155502204, 'spending_outpoints': [{'tx_index': 3072434988773922, 'n': 0}], 'n': 16, 'tx_index': 6750972110998565, 'script': '76a914adfb8786f19039b78a78a999e04d68348d0571be88ac', 'addr': '1GrwDkr33gT6LuumniYjKEGjTLhsL5kmqC'}}, {'sequence': 4294967295, 'witness': '', 'script': '483045022100f5ba669c6aff84329e1fd870882a7df98a66e58f98fe59c1dc75ea00b6f6063f0220326851552a46b4a77f0a55465f6206ff9354d4d04cdb9433143176a59516792101210201973a41bb610e199a1fbb208398fbacc732c3658d132dbf9f3a394bedc9a7b5', 'index': 1, 'prev_out': {'type': 0, 'spent': True, 'value': 13989409291, 'spending_outpoints': [{'tx_index': 3072434988773922, 'n': 1}], 'n': 17, 'tx_index': 7685762618481328, 'script': '76a914adfb8786f19039b78a78a999e04d68348d0571be88ac', 'addr': '1GrwDkr33gT6LuumniYjKEGjTLhsL5kmqC'}}, {'sequence': 4294967295, 'witness': '', 'script': '47304402202207216783f0f491693254e767614416087bdc692fa66cf5a323a60b10bc6c280220087c9b533be7255e22b1a1e8830058f13c97f91210fe762b0a5d81caab12bc8b01210201973a41bb610e199a1fbb208398fbacc732c3658d132dbf9f3a394bedc9a7b5', 'index': 2, 'prev_out': {'type': 0, 'spent': True, 'value': 13875145595, 'spending_outpoints': [{'tx_index': 3072434988773922, 'n': 2}], 'n': 15, 'tx_index': 7038393159208902, 'script': '76a914adfb8786f19039b78a78a999e04d68348d0571be88ac', 'addr': '1GrwDkr33gT6LuumniYjKEGjTLhsL5kmqC'}}, {'sequence': 4294967295, 'witness': '', 'script': '483045022100f5ec0a64e085af07673f2e9f872171d30f69a9e70ef9595e03ad4fc10f1fb7d1022043143f109f1ca122ec51b845b8bcd3954da3b0ac0f33d2d022a4e5ea896d92fd01210201973a41bb610e199a1fbb208398fbacc732c3658d132dbf9f3a394bedc9a7b5', 'index': 3, 'prev_out': {'type': 0, 'spent': True, 'value': 13471402294, 'spending_outpoints': [{'tx_index': 3072434988773922, 'n': 3}], 'n': 0, 'tx_index': 7536419471925779, 'script': '76a914adfb8786f19039b78a78a999e04d68348d0571be88ac', 'addr': '1GrwDkr33gT6LuumniYjKEGjTLhsL5kmqC'}}, {'sequence': 4294967295, 'witness': '', 'script': '473044022070622294c33a3acc071542ec4cf539277477bf5c4a60b068c3ee29a4ad6b5db8022029abc72551acf423c25875befcb8fbdbc6d80cc85e86c61cf53644928353866101210201973a41bb610e199a1fbb208398fbacc732c3658d132dbf9f3a394bedc9a7b5', 'index': 4, 'prev_out': {'type': 0, 'spent': True, 'value': 13272993553, 'spending_outpoints': [{'tx_index': 3072434988773922, 'n': 4}], 'n': 0, 'tx_index': 5058584707497032, 'script': '76a914adfb8786f19039b78a78a999e04d68348d0571be88ac', 'addr': '1GrwDkr33gT6LuumniYjKEGjTLhsL5kmqC'}}, {'sequence': 4294967295, 'witness': '', 'script': '4730440220714d55c8b00cf7f224a66d9ee4c39fa6eced0a4737a60937b712f97adb5302af02203d62fa44100f6f42d0da31e613466acbc6ee032ffb85844d0d5df776c55379b601210201973a41bb610e199a1fbb208398fbacc732c3658d132dbf9f3a394bedc9a7b5', 'index': 5, 'prev_out': {'type': 0, 'spent': True, 'value': 11445270034, 'spending_outpoints': [{'tx_index': 3072434988773922, 'n': 5}], 'n': 0, 'tx_index': 287516860919708, 'script': '76a914adfb8786f19039b78a78a999e04d68348d0571be88ac', 'addr': '1GrwDkr33gT6LuumniYjKEGjTLhsL5kmqC'}}, {'sequence': 4294967295, 'witness': '', 'script': '473044022074214da7e6097b47a83fd723d793dbb6f7087ccd156d85401150795cef5e6884022029365a567af180bc8d5dfe3ecd7e187e13ff67f36d5ee3b6f23387f9bbf86ba401210201973a41bb610e199a1fbb208398fbacc732c3658d132dbf9f3a394bedc9a7b5', 'index': 6, 'prev_out': {'type': 0, 'spent': True, 'value': 10651560651, 'spending_outpoints': [{'tx_index': 3072434988773922, 'n': 6}], 'n': 0, 'tx_index': 1613337555600146, 'script': '76a914adfb8786f19039b78a78a999e04d68348d0571be88ac', 'addr': '1GrwDkr33gT6LuumniYjKEGjTLhsL5kmqC'}}, {'sequence': 4294967295, 'witness': '', 'script': '4830450221009365b8f96f5e88ee5c3f885ca1a65c160dae97f8662bb2fd5c01f09f28524ba2022046df05358328d6ce2889ef5b63a9e49b38c7b1a1f9e7aa7607bbf053dd461a8901210201973a41bb610e199a1fbb208398fbacc732c3658d132dbf9f3a394bedc9a7b5', 'index': 7, 'prev_out': {'type': 0, 'spent': True, 'value': 10260000021, 'spending_outpoints': [{'tx_index': 3072434988773922, 'n': 7}], 'n': 1, 'tx_index': 2971997909171646, 'script': '76a914adfb8786f19039b78a78a999e04d68348d0571be88ac', 'addr': '1GrwDkr33gT6LuumniYjKEGjTLhsL5kmqC'}}, {'sequence': 4294967295, 'witness': '', 'script': '473044022062325c9accef8486a268b1ea057d8ce63ae81a501d50e213fff4a77b842e667502205012710ebfcb096fec7f5f036e4246c8d8e97f6fb92f3760089b37e3a7a274a301210201973a41bb610e199a1fbb208398fbacc732c3658d132dbf9f3a394bedc9a7b5', 'index': 8, 'prev_out': {'type': 0, 'spent': True, 'value': 9827783777, 'spending_outpoints': [{'tx_index': 3072434988773922, 'n': 8}], 'n': 16, 'tx_index': 1496559060376516, 'script': '76a914adfb8786f19039b78a78a999e04d68348d0571be88ac', 'addr': '1GrwDkr33gT6LuumniYjKEGjTLhsL5kmqC'}}, {'sequence': 4294967295, 'witness': '', 'script': '47304402206c4635f54959d416dba9fc1e87fa30665f8c517b6bfa2e5d6744b116577568b2022046773eaead298295583cfdc8474ab9679ca8c200c8e5f3d94a7b62f41c214e7f01210201973a41bb610e199a1fbb208398fbacc732c3658d132dbf9f3a394bedc9a7b5', 'index': 9, 'prev_out': {'type': 0, 'spent': True, 'value': 9131233681, 'spending_outpoints': [{'tx_index': 3072434988773922, 'n': 9}], 'n': 15, 'tx_index': 2378698122990963, 'script': '76a914adfb8786f19039b78a78a999e04d68348d0571be88ac', 'addr': '1GrwDkr33gT6LuumniYjKEGjTLhsL5kmqC'}}, {'sequence': 4294967295, 'witness': '', 'script': '47304402200b91bc6ee635d49b111ac5cc0fcf277ae177cc280272adf5aa1ebdfaa8eb806c0220783a5552209a4aad4338e482dc79a8635d4b9af98e762efdfa7644e84d49eaa801210201973a41bb610e199a1fbb208398fbacc732c3658d132dbf9f3a394bedc9a7b5', 'index': 10, 'prev_out': {'type': 0, 'spent': True, 'value': 8043786404, 'spending_outpoints': [{'tx_index': 3072434988773922, 'n': 10}], 'n': 8, 'tx_index': 588964025152009, 'script': '76a914adfb8786f19039b78a78a999e04d68348d0571be88ac', 'addr': '1GrwDkr33gT6LuumniYjKEGjTLhsL5kmqC'}}, {'sequence': 4294967295, 'witness': '', 'script': '483045022100c32ec5474699bcbee7ffd920070925870e8d35737d3b086c52f2daf13a47fd0802201c42798522ed8c1ee8a2e5afb19592b8f7e61d74b46a2762eb61893300933ca401210201973a41bb610e199a1fbb208398fbacc732c3658d132dbf9f3a394bedc9a7b5', 'index': 11, 'prev_out': {'type': 0, 'spent': True, 'value': 6481250923, 'spending_outpoints': [{'tx_index': 3072434988773922, 'n': 11}], 'n': 0, 'tx_index': 4905366382244419, 'script': '76a914adfb8786f19039b78a78a999e04d68348d0571be88ac', 'addr': '1GrwDkr33gT6LuumniYjKEGjTLhsL5kmqC'}}, {'sequence': 4294967295, 'witness': '', 'script': '483045022100925b9acf8d440c537fa2ca4c60aafc758ebbcbff2082830249160379c212a9b2022078637e01f657edca423369f56cc68a8c09e8aa8e3f514f636a3ae0300af5251a01210201973a41bb610e199a1fbb208398fbacc732c3658d132dbf9f3a394bedc9a7b5', 'index': 12, 'prev_out': {'type': 0, 'spent': True, 'value': 5556808701, 'spending_outpoints': [{'tx_index': 3072434988773922, 'n': 12}], 'n': 11, 'tx_index': 3603578293550725, 'script': '76a914adfb8786f19039b78a78a999e04d68348d0571be88ac', 'addr': '1GrwDkr33gT6LuumniYjKEGjTLhsL5kmqC'}}, {'sequence': 4294967295, 'witness': '', 'script': '48304502210091eb3475e2a7dd361baa33b249f5ef0575e6f5489363ac75acda1a266390177c02206ed9d8853b45e4ab914a131324d5b59abb76b4e83b70319b9d548e829c76da3201210201973a41bb610e199a1fbb208398fbacc732c3658d132dbf9f3a394bedc9a7b5', 'index': 13, 'prev_out': {'type': 0, 'spent': True, 'value': 5529785525, 'spending_outpoints': [{'tx_index': 3072434988773922, 'n': 13}], 'n': 18, 'tx_index': 1408737617010115, 'script': '76a914adfb8786f19039b78a78a999e04d68348d0571be88ac', 'addr': '1GrwDkr33gT6LuumniYjKEGjTLhsL5kmqC'}}, {'sequence': 4294967295, 'witness': '', 'script': '47304402203321d9fddf338ca7ea909ec3371bbf01e002b0e701e9451ad52122c7837d9e8e0220629f4872c0f2c9bdf2a55782d211c98ad57940e8f48c683b7ccb795d6dce61e201210201973a41bb610e199a1fbb208398fbacc732c3658d132dbf9f3a394bedc9a7b5', 'index': 14, 'prev_out': {'type': 0, 'spent': True, 'value': 5436847314, 'spending_outpoints': [{'tx_index': 3072434988773922, 'n': 14}], 'n': 13, 'tx_index': 36383069693185, 'script': '76a914adfb8786f19039b78a78a999e04d68348d0571be88ac', 'addr': '1GrwDkr33gT6LuumniYjKEGjTLhsL5kmqC'}}, {'sequence': 4294967295, 'witness': '', 'script': '47304402207e159e0023284292f16faea3ee3d6287153071ee201c0f5ced14dd21b14ec39702207638c2f06da5823465d45f896c27a01c3f2e029644d9eafcebb689ae827a23fc01210201973a41bb610e199a1fbb208398fbacc732c3658d132dbf9f3a394bedc9a7b5', 'index': 15, 'prev_out': {'type': 0, 'spent': True, 'value': 5232498832, 'spending_outpoints': [{'tx_index': 3072434988773922, 'n': 15}], 'n': 17, 'tx_index': 4627344777000774, 'script': '76a914adfb8786f19039b78a78a999e04d68348d0571be88ac', 'addr': '1GrwDkr33gT6LuumniYjKEGjTLhsL5kmqC'}}, {'sequence': 4294967295, 'witness': '', 'script': '473044022025a29719dbe349a77b83d5edf4fce7274685de0dcda3a6a9754cd15bac93c23d0220096fc971c853bf1d463c3eb0fda4b527ece0cbba3e93734c2afa72659251f6c301210201973a41bb610e199a1fbb208398fbacc732c3658d132dbf9f3a394bedc9a7b5', 'index': 16, 'prev_out': {'type': 0, 'spent': True, 'value': 5202527727, 'spending_outpoints': [{'tx_index': 3072434988773922, 'n': 16}], 'n': 16, 'tx_index': 4996762726013349, 'script': '76a914adfb8786f19039b78a78a999e04d68348d0571be88ac', 'addr': '1GrwDkr33gT6LuumniYjKEGjTLhsL5kmqC'}}, {'sequence': 4294967295, 'witness': '', 'script': '48304502210098ad6b734c9057450c79042bed32902024d5803eac58e2b2eed7956a55644bb602200a45a7769de4c39ec7ae9e723902a4274508a1e51ee2b26e8f60fed5e81ae89101210201973a41bb610e199a1fbb208398fbacc732c3658d132dbf9f3a394bedc9a7b5', 'index': 17, 'prev_out': {'type': 0, 'spent': True, 'value': 4984224415, 'spending_outpoints': [{'tx_index': 3072434988773922, 'n': 17}], 'n': 0, 'tx_index': 3772112603313423, 'script': '76a914adfb8786f19039b78a78a999e04d68348d0571be88ac', 'addr': '1GrwDkr33gT6LuumniYjKEGjTLhsL5kmqC'}}, {'sequence': 4294967295, 'witness': '', 'script': '47304402203a4d4e750d97993ed59cfa7116074119b489f62185a3dc808e00c2338b19561b02204aee1a673ac61e8919c00c0edf53290262d86ebff3b9701b78a84e52fd92bb6a01210201973a41bb610e199a1fbb208398fbacc732c3658d132dbf9f3a394bedc9a7b5', 'index': 18, 'prev_out': {'type': 0, 'spent': True, 'value': 4120463506, 'spending_outpoints': [{'tx_index': 3072434988773922, 'n': 18}], 'n': 0, 'tx_index': 2994964996912476, 'script': '76a914adfb8786f19039b78a78a999e04d68348d0571be88ac', 'addr': '1GrwDkr33gT6LuumniYjKEGjTLhsL5kmqC'}}, {'sequence': 4294967295, 'witness': '', 'script': '4830450221008081059d0228d2b41e8efc690d28545c35972c1fa515c3d0abfc228ab7900c2d02202ed07b0f92b78fbf92ce597734e5a6573fa876987b096abb374f4c5f645158c101210201973a41bb610e199a1fbb208398fbacc732c3658d132dbf9f3a394bedc9a7b5', 'index': 19, 'prev_out': {'type': 0, 'spent': True, 'value': 4040817025, 'spending_outpoints': [{'tx_index': 3072434988773922, 'n': 19}], 'n': 0, 'tx_index': 8947881571774810, 'script': '76a914adfb8786f19039b78a78a999e04d68348d0571be88ac', 'addr': '1GrwDkr33gT6LuumniYjKEGjTLhsL5kmqC'}}, {'sequence': 4294967295, 'witness': '', 'script': '4730440220791a57e047fe8c9375788e2bb0db34802bb80e6a3c6a90e5d7937b3abcbf1b03022013bb03ce5d62dfab234462eb35aa277cbc035d941db5995a569e114a9871cc7701210201973a41bb610e199a1fbb208398fbacc732c3658d132dbf9f3a394bedc9a7b5', 'index': 20, 'prev_out': {'type': 0, 'spent': True, 'value': 3631870945, 'spending_outpoints': [{'tx_index': 3072434988773922, 'n': 20}], 'n': 0, 'tx_index': 4922739020646059, 'script': '76a914adfb8786f19039b78a78a999e04d68348d0571be88ac', 'addr': '1GrwDkr33gT6LuumniYjKEGjTLhsL5kmqC'}}, {'sequence': 4294967295, 'witness': '', 'script': '47304402206a713c5b8043a286163856062897860c52ab521849c36e5dfac9a75dca96959f022059825ec925b2f0a2ff3561c7354c67e384b41e888d4e19cb0c75c33fcaf1e3a90121039006d301c67df0ca3554a4befe77e4699ee12b4463c26c4a3c4db2bfb4c3c410', 'index': 21, 'prev_out': {'type': 0, 'spent': True, 'value': 3470000000, 'spending_outpoints': [{'tx_index': 3072434988773922, 'n': 21}], 'n': 13, 'tx_index': 2701390007530026, 'script': '76a9148f06629e4648effd7675be7768a84343cc20f45988ac', 'addr': '1E3FH5wQpFXWjYqV76ejM1L1dmL97aUGtq'}}, {'sequence': 4294967295, 'witness': '', 'script': '483045022100e95d518fb93c1fed42a5a86a2b7cfde6519c7fcec4740cf0ab78617a23fa643d022038111109b76361e84cf22863e68219cf78dd8be591c94c8a8762e6b48ea959090121039006d301c67df0ca3554a4befe77e4699ee12b4463c26c4a3c4db2bfb4c3c410', 'index': 22, 'prev_out': {'type': 0, 'spent': True, 'value': 3450000000, 'spending_outpoints': [{'tx_index': 3072434988773922, 'n': 22}], 'n': 12, 'tx_index': 5316792459892737, 'script': '76a9148f06629e4648effd7675be7768a84343cc20f45988ac', 'addr': '1E3FH5wQpFXWjYqV76ejM1L1dmL97aUGtq'}}, {'sequence': 4294967295, 'witness': '', 'script': '47304402201257fa14b9010660e846bb51534485604921a4c56be68ac822b3d44c2450a71a02204b0c95eae504a8a79b7dc63b8921e3f1637d1ab75c52d999fdea22ceb2f1f1ee0121039006d301c67df0ca3554a4befe77e4699ee12b4463c26c4a3c4db2bfb4c3c410', 'index': 23, 'prev_out': {'type': 0, 'spent': True, 'value': 3450000000, 'spending_outpoints': [{'tx_index': 3072434988773922, 'n': 23}], 'n': 17, 'tx_index': 4777589180288949, 'script': '76a9148f06629e4648effd7675be7768a84343cc20f45988ac', 'addr': '1E3FH5wQpFXWjYqV76ejM1L1dmL97aUGtq'}}, {'sequence': 4294967295, 'witness': '', 'script': '48304502210099d0270c60eec202daf03351e07839e17e6e2633ee7fd492b5435530a596f9d70220504a9e839a884ce3c5bccc4132275d3638184399c75fb56ebdc774cb5a29a1b501210201973a41bb610e199a1fbb208398fbacc732c3658d132dbf9f3a394bedc9a7b5', 'index': 24, 'prev_out': {'type': 0, 'spent': True, 'value': 3441129358, 'spending_outpoints': [{'tx_index': 3072434988773922, 'n': 24}], 'n': 0, 'tx_index': 6502510144483684, 'script': '76a914adfb8786f19039b78a78a999e04d68348d0571be88ac', 'addr': '1GrwDkr33gT6LuumniYjKEGjTLhsL5kmqC'}}, {'sequence': 4294967295, 'witness': '', 'script': '483045022100c52f5fcdd7f03c65fdb3ed05c09af6dbdd67a3b9d25825498bdf3771b853342702200ed486156df028a12dcfaeaf51411847ff2be8a973ef6bedca3374b661de4e5801210201973a41bb610e199a1fbb208398fbacc732c3658d132dbf9f3a394bedc9a7b5', 'index': 25, 'prev_out': {'type': 0, 'spent': True, 'value': 3404750531, 'spending_outpoints': [{'tx_index': 3072434988773922, 'n': 25}], 'n': 0, 'tx_index': 7698880101637029, 'script': '76a914adfb8786f19039b78a78a999e04d68348d0571be88ac', 'addr': '1GrwDkr33gT6LuumniYjKEGjTLhsL5kmqC'}}, {'sequence': 4294967295, 'witness': '', 'script': '473044022074c53a6a3f91586791b37dd99629c09fbe5c16660e2ba91896044a43b4bb4bf902204f65ac2aa70f3eea5de0e34b3d2b71a802f27ab722f47d300721c0c55167771201210201973a41bb610e199a1fbb208398fbacc732c3658d132dbf9f3a394bedc9a7b5', 'index': 26, 'prev_out': {'type': 0, 'spent': True, 'value': 2850454082, 'spending_outpoints': [{'tx_index': 3072434988773922, 'n': 26}], 'n': 13, 'tx_index': 1412208193049672, 'script': '76a914adfb8786f19039b78a78a999e04d68348d0571be88ac', 'addr': '1GrwDkr33gT6LuumniYjKEGjTLhsL5kmqC'}}, {'sequence': 4294967295, 'witness': '', 'script': '47304402200d54f6a24eb5c9697c7d3254300e8c8daccb169ff28a523dac485e036ec70be602203fcb9db7af7e4e2d49143b48bc862946de088e7f851af421aac7f503f01e035701210201973a41bb610e199a1fbb208398fbacc732c3658d132dbf9f3a394bedc9a7b5', 'index': 27, 'prev_out': {'type': 0, 'spent': True, 'value': 2485483841, 'spending_outpoints': [{'tx_index': 3072434988773922, 'n': 27}], 'n': 0, 'tx_index': 4106498980918583, 'script': '76a914adfb8786f19039b78a78a999e04d68348d0571be88ac', 'addr': '1GrwDkr33gT6LuumniYjKEGjTLhsL5kmqC'}}, {'sequence': 4294967295, 'witness': '', 'script': '47304402201fe68f60b84fab2f6dd017d50eb40eda47cb559f1c2dd674d4012c3c85adeaa3022076ac504ec1ba4d4ac06bbd82309c27a3177cc6d82345f3f873a1b1d364ad3e2801210201973a41bb610e199a1fbb208398fbacc732c3658d132dbf9f3a394bedc9a7b5', 'index': 28, 'prev_out': {'type': 0, 'spent': True, 'value': 2478617060, 'spending_outpoints': [{'tx_index': 3072434988773922, 'n': 28}], 'n': 18, 'tx_index': 6949746966902254, 'script': '76a914adfb8786f19039b78a78a999e04d68348d0571be88ac', 'addr': '1GrwDkr33gT6LuumniYjKEGjTLhsL5kmqC'}}, {'sequence': 4294967295, 'witness': '', 'script': '47304402204ba240fb95b3fc06a01db74f6a0e8fe4c9a797a92fb2690bf8311d7cd3bc5b0d02206ddd9fdec04e67cd41cf5feda77552963c938d48f6075f1f3c226b3d4ce477e001210201973a41bb610e199a1fbb208398fbacc732c3658d132dbf9f3a394bedc9a7b5', 'index': 29, 'prev_out': {'type': 0, 'spent': True, 'value': 2445172904, 'spending_outpoints': [{'tx_index': 3072434988773922, 'n': 29}], 'n': 21, 'tx_index': 7156524992072804, 'script': '76a914adfb8786f19039b78a78a999e04d68348d0571be88ac', 'addr': '1GrwDkr33gT6LuumniYjKEGjTLhsL5kmqC'}}, {'sequence': 4294967295, 'witness': '', 'script': '483045022100b41807d333fa410c09c677cb9dbca3b69497980cdc3015d886627b8d21d4890702203ea034c8892403c5024241dd2cbfaed7bd7fd0120381df2f08b0837e8389ec5d012103f250289afc1604963ad079a60a9654bd83f405fb0293258f405248eb53b4afdb', 'index': 30, 'prev_out': {'type': 0, 'spent': True, 'value': 2420000000, 'spending_outpoints': [{'tx_index': 3072434988773922, 'n': 30}], 'n': 0, 'tx_index': 279231427718757, 'script': '76a914d27e576bc95c7c72078390a6bc3703ebfa9f23ce88ac', 'addr': '1LBzFeQSkU3gju2zQGU9D3mmpixTkFA9gr'}}, {'sequence': 4294967295, 'witness': '', 'script': '483045022100df957294d8a0230da7211efbed8556b2181429c3f9be2c9b021c93096f3d173a02207e05bb07d364c7a3af0b10bb88b48f05f303ffaf70bf36800f3db283db44ca15012103f250289afc1604963ad079a60a9654bd83f405fb0293258f405248eb53b4afdb', 'index': 31, 'prev_out': {'type': 0, 'spent': True, 'value': 2420000000, 'spending_outpoints': [{'tx_index': 3072434988773922, 'n': 31}], 'n': 3, 'tx_index': 287854603310439, 'script': '76a914d27e576bc95c7c72078390a6bc3703ebfa9f23ce88ac', 'addr': '1LBzFeQSkU3gju2zQGU9D3mmpixTkFA9gr'}}, {'sequence': 4294967295, 'witness': '', 'script': '47304402205a7a52f1d571fc960112b6af66b8e74be2995c6a784b9cce7d521dd97eb990f802200479608941a18fb9fab973e5af4175e110196e67afa96eb6cd89d905d0065df101210201973a41bb610e199a1fbb208398fbacc732c3658d132dbf9f3a394bedc9a7b5', 'index': 32, 'prev_out': {'type': 0, 'spent': True, 'value': 2127723109, 'spending_outpoints': [{'tx_index': 3072434988773922, 'n': 32}], 'n': 12, 'tx_index': 3403789348393613, 'script': '76a914adfb8786f19039b78a78a999e04d68348d0571be88ac', 'addr': '1GrwDkr33gT6LuumniYjKEGjTLhsL5kmqC'}}, {'sequence': 4294967295, 'witness': '', 'script': '483045022100fea41d9b70770ad065c3f17405cd3f465acda6923e1abacd6491d1d5c1f87c9102205f1091bd2deed56bb6c84ac27ee332ff8599af6c944957c6c31769ded3a1d1c401210201973a41bb610e199a1fbb208398fbacc732c3658d132dbf9f3a394bedc9a7b5', 'index': 33, 'prev_out': {'type': 0, 'spent': True, 'value': 2000634645, 'spending_outpoints': [{'tx_index': 3072434988773922, 'n': 33}], 'n': 15, 'tx_index': 6430328984946519, 'script': '76a914adfb8786f19039b78a78a999e04d68348d0571be88ac', 'addr': '1GrwDkr33gT6LuumniYjKEGjTLhsL5kmqC'}}, {'sequence': 4294967295, 'witness': '', 'script': '483045022100e2aef590475a8087b87ed59bb6ad80371d54d513cdfe96ac040ce6ce472dec42022068205da9ebf6b5d28b5a5e09f19d35439b60aa4fa95f13b0057432b79b77c8240121020e6965eb8397fcdaac0b323bde6f7d9fc8eb42011b33373df75e8d1c1d31746c', 'index': 34, 'prev_out': {'type': 0, 'spent': True, 'value': 1700000000, 'spending_outpoints': [{'tx_index': 3072434988773922, 'n': 34}], 'n': 1, 'tx_index': 2030553006978528, 'script': '76a9142b362e67196de5a2892712f1e718fe1746d8898488ac', 'addr': '14wUxq4jj7HWkDdAnCf2jakhCMDd79C3f8'}}, {'sequence': 4294967295, 'witness': '', 'script': '47304402207a2adf5d649c3fceb60801998bde3144ad4259a29da4df499ecdaafea5431dab0220030988c0abc52cf588ba9945f6b3e1cd547c96c547307c9cc99aee866372f023012102bda43b7719a0d0d9d34ddb5828f391d2c7b81642ebb2d83f29889c713c3db21f', 'index': 35, 'prev_out': {'type': 0, 'spent': True, 'value': 1634100000, 'spending_outpoints': [{'tx_index': 3072434988773922, 'n': 35}], 'n': 0, 'tx_index': 3795493130355315, 'script': '76a914bc60167d92a59df643d2f088aaf4a44aee778e8088ac', 'addr': '1JB39NBdhYCphGehZax76NLoR9RrPisXgs'}}, {'sequence': 4294967295, 'witness': '', 'script': '4730440220757ccf1be6a6265ed01c04f76f850f1709c83570582c24efff56f2aa112512d6022032d6a101bae34821711cdd6e236771a81d42c2b96975b3db6d8cee4c641e3b38012102bda43b7719a0d0d9d34ddb5828f391d2c7b81642ebb2d83f29889c713c3db21f', 'index': 36, 'prev_out': {'type': 0, 'spent': True, 'value': 1630200000, 'spending_outpoints': [{'tx_index': 3072434988773922, 'n': 36}], 'n': 0, 'tx_index': 4147480086508504, 'script': '76a914bc60167d92a59df643d2f088aaf4a44aee778e8088ac', 'addr': '1JB39NBdhYCphGehZax76NLoR9RrPisXgs'}}, {'sequence': 4294967295, 'witness': '', 'script': '47304402201947c4766d798c79a2b2a7cf2c62ae26c91aeaada6359793c76d0c1b00d35f0202206cd1ac3b9add7eecd55371d5ff843dae999f1e1a0f592acca2316fd4e8d06c6b01210201973a41bb610e199a1fbb208398fbacc732c3658d132dbf9f3a394bedc9a7b5', 'index': 37, 'prev_out': {'type': 0, 'spent': True, 'value': 1621497020, 'spending_outpoints': [{'tx_index': 3072434988773922, 'n': 37}], 'n': 0, 'tx_index': 1627215189344413, 'script': '76a914adfb8786f19039b78a78a999e04d68348d0571be88ac', 'addr': '1GrwDkr33gT6LuumniYjKEGjTLhsL5kmqC'}}, {'sequence': 4294967295, 'witness': '', 'script': '4730440220139d09069b8d58d2ccad83a60110e971dc310fa57d88749adf95f6158620976e022068d681f088269cd8051d28ca691910c867854646da1b793b8a8813a442f4f86b012102b97a1c541dc48b304a30dd21f6c93384cebdd8f2b9ae408bf9bfb3db6613e393', 'index': 38, 'prev_out': {'type': 0, 'spent': True, 'value': 1599998294, 'spending_outpoints': [{'tx_index': 3072434988773922, 'n': 38}], 'n': 0, 'tx_index': 1021158041909138, 'script': '76a91424ac96f794044f6151c0b6c318e2ba3f90836e9f88ac', 'addr': '14Lv5eg3yMDA6obDQpPzVPep3caEh2p85N'}}, {'sequence': 4294967295, 'witness': '', 'script': '483045022100b1c589e559b092896edbfb424b1cde096a782540468349dfdd6007ab1edca1ec02202818db34cb5e92efb437dafcfe770ec73149e52ee31d2286f4e248605bf4dfa701210201973a41bb610e199a1fbb208398fbacc732c3658d132dbf9f3a394bedc9a7b5', 'index': 39, 'prev_out': {'type': 0, 'spent': True, 'value': 1515395454, 'spending_outpoints': [{'tx_index': 3072434988773922, 'n': 39}], 'n': 15, 'tx_index': 7833732866617691, 'script': '76a914adfb8786f19039b78a78a999e04d68348d0571be88ac', 'addr': '1GrwDkr33gT6LuumniYjKEGjTLhsL5kmqC'}}, {'sequence': 4294967295, 'witness': '', 'script': '473044022017c081145ad1d77b66b13e47ae94bf5a3c418d68777943c4f47024504866ffcd0220701852fe044541c89ae927566df41647875448860cceee1c59d62a53f4cc085c01210201973a41bb610e199a1fbb208398fbacc732c3658d132dbf9f3a394bedc9a7b5', 'index': 40, 'prev_out': {'type': 0, 'spent': True, 'value': 1510767005, 'spending_outpoints': [{'tx_index': 3072434988773922, 'n': 40}], 'n': 19, 'tx_index': 3385694399585851, 'script': '76a914adfb8786f19039b78a78a999e04d68348d0571be88ac', 'addr': '1GrwDkr33gT6LuumniYjKEGjTLhsL5kmqC'}}, {'sequence': 4294967295, 'witness': '', 'script': '483045022100e0e4566f8bac4bedbe0e8160f283cd3db0da34278e56c898585f352235897aa602204ab4941934d755380f71da7b341e23efa60880c7e7cc1725f1911f811f11aa02012103bf7a6d80b2237572eaf709b1750a3adc85ca654e22808e5983449ec70e39a995', 'index': 41, 'prev_out': {'type': 0, 'spent': True, 'value': 1500000000, 'spending_outpoints': [{'tx_index': 3072434988773922, 'n': 41}], 'n': 1, 'tx_index': 8655282168362735, 'script': '76a914d5c876a8514c73488cfd82b78971f4b6abc967c788ac', 'addr': '1LVP5JtcXCm6k5nJYdz56XCcJqLhci8Chd'}}, {'sequence': 4294967295, 'witness': '', 'script': '47304402201d3f5607a9de6a7c4290873817853df48411e5fbf00faaaaeb35abf6259faff2022045edd863c94d3ab84dfe0bc02e975766eb828bf7881ded4bcaf7ee822e3dbcbd012102bda43b7719a0d0d9d34ddb5828f391d2c7b81642ebb2d83f29889c713c3db21f', 'index': 42, 'prev_out': {'type': 0, 'spent': True, 'value': 1499997792, 'spending_outpoints': [{'tx_index': 3072434988773922, 'n': 42}], 'n': 3, 'tx_index': 4108503108557768, 'script': '76a914bc60167d92a59df643d2f088aaf4a44aee778e8088ac', 'addr': '1JB39NBdhYCphGehZax76NLoR9RrPisXgs'}}, {'sequence': 4294967295, 'witness': '', 'script': '483045022100c31217052dde9d9c1b97cd5d83a83cc2c04a67e218e49bab2e63aff78d0e7d22022076f86d7c87534598621c5cf443902cc934a3540d7a7878e97c6ce6369596bed9012102bda43b7719a0d0d9d34ddb5828f391d2c7b81642ebb2d83f29889c713c3db21f', 'index': 43, 'prev_out': {'type': 0, 'spent': True, 'value': 1499997792, 'spending_outpoints': [{'tx_index': 3072434988773922, 'n': 43}], 'n': 3, 'tx_index': 4367005026934684, 'script': '76a914bc60167d92a59df643d2f088aaf4a44aee778e8088ac', 'addr': '1JB39NBdhYCphGehZax76NLoR9RrPisXgs'}}, {'sequence': 4294967295, 'witness': '', 'script': '483045022100f7dfa8d4acbede0cb6d44541d29239ac9988c175fd7b815eb537d8423045b19a022069279e4622ba09dbd82a218a93f4867d8577a32f0ce31201264e3e988564d82c0121031fb1a055cab371ee18d66fb65cc5443ac92d3d037fc784013438d1c058371397', 'index': 44, 'prev_out': {'type': 0, 'spent': True, 'value': 1499997514, 'spending_outpoints': [{'tx_index': 3072434988773922, 'n': 44}], 'n': 0, 'tx_index': 5870655932440403, 'script': '76a91433582c90ac0919afa1cd40869aca3a7767486fae88ac', 'addr': '15gV6E7HzjPMtpqAMWkzohZpDUyVUG5KLZ'}}, {'sequence': 4294967295, 'witness': '', 'script': '483045022100bdd4b6f9eee9a94d1a903c3097a608949407932c2b06b59e70262a56050c9bf4022025f2e6e3f67f4d8421f1facedc65581577f38ea7a3fdfbe975acf228748fcc7a01210383d15e7958aa9ace2db1d6fe7e183a27a40747d3e2b889637f1236d6f547c89e', 'index': 45, 'prev_out': {'type': 0, 'spent': True, 'value': 1499990000, 'spending_outpoints': [{'tx_index': 3072434988773922, 'n': 45}], 'n': 7, 'tx_index': 4383828350390495, 'script': '76a91444dab65da4b42897c2d2eb9296cf5f0916bde0ea88ac', 'addr': '17H4xSsfdj5h25dym8cZmd7bSHaaCMxzFG'}}, {'sequence': 4294967295, 'witness': '', 'script': '483045022100aab23e89df52395723869004224f68f4eb77ce662b1178ea0c873f3b3d598ea302206363fb991319027abcebd23af3e26fd15ad9b1d9f254c3b5c541b0eef5477e8c01210383d15e7958aa9ace2db1d6fe7e183a27a40747d3e2b889637f1236d6f547c89e', 'index': 46, 'prev_out': {'type': 0, 'spent': True, 'value': 1499990000, 'spending_outpoints': [{'tx_index': 3072434988773922, 'n': 46}], 'n': 2, 'tx_index': 694233431717253, 'script': '76a91444dab65da4b42897c2d2eb9296cf5f0916bde0ea88ac', 'addr': '17H4xSsfdj5h25dym8cZmd7bSHaaCMxzFG'}}, {'sequence': 4294967295, 'witness': '', 'script': '483045022100dc1c4c0f677e3fba8487b7d6209727a8fcd324bc2cea12d05eb6b5836fbbea3a02207d4fbdab502b6dff4ef77bc35f6892835163b21e73e8843f553bb3269b78b74b0121025015d3d88d9084ebbd468aa50b080e793814400432f6eedbfd1458991a7aeb44', 'index': 47, 'prev_out': {'type': 0, 'spent': True, 'value': 1499990000, 'spending_outpoints': [{'tx_index': 3072434988773922, 'n': 47}], 'n': 4, 'tx_index': 1994834610088041, 'script': '76a9141169989295ed8b9336c38652b96e735faa7aadf488ac', 'addr': '12b4zCY6hCqdUHcNtarLmpkeBMU7N7auoh'}}, {'sequence': 4294967295, 'witness': '', 'script': '473044022061f0f19d4075702fa9b90b7fb40584aada5ccea04f71124f7ce509832c743fab02201375ddb60e019c58da7d82821e11d442c9e3a7074d16b794cc86beb0d2bc3cc4012102bda43b7719a0d0d9d34ddb5828f391d2c7b81642ebb2d83f29889c713c3db21f', 'index': 48, 'prev_out': {'type': 0, 'spent': True, 'value': 1499990000, 'spending_outpoints': [{'tx_index': 3072434988773922, 'n': 48}], 'n': 20, 'tx_index': 735377983636774, 'script': '76a914bc60167d92a59df643d2f088aaf4a44aee778e8088ac', 'addr': '1JB39NBdhYCphGehZax76NLoR9RrPisXgs'}}, {'sequence': 4294967295, 'witness': '', 'script': '483045022100fefd971b856b613a2c2cde71068ca8dc555c58ccb08be8ae9ace59a089faea330220346f52afdff15fc18107f1d109a25ac9dc525f9f088b4b4c13a05b8559d757600121029e0828ee826a4b5bbe34ac19ff180c5d244f55ed6fe3804f489626a6d575e6f8', 'index': 49, 'prev_out': {'type': 0, 'spent': True, 'value': 1497000000, 'spending_outpoints': [{'tx_index': 3072434988773922, 'n': 49}], 'n': 0, 'tx_index': 5371029407176544, 'script': '76a9149a09b90944752537fe829fe6418269f88d7e9fcf88ac', 'addr': '1F3Ui6SEo4i6qDGK79p9n22J4idUcom7JG'}}, {'sequence': 4294967295, 'witness': '', 'script': '483045022100e996c185054da617067d030559290efc7da1bfa623e6a269aa3210aafbe6a3b60220430225203fd6f52ef6b5a0d9869c0d7836c58dad65bc5cd04581fb9d153bbbcb01210201973a41bb610e199a1fbb208398fbacc732c3658d132dbf9f3a394bedc9a7b5', 'index': 50, 'prev_out': {'type': 0, 'spent': True, 'value': 1471952717, 'spending_outpoints': [{'tx_index': 3072434988773922, 'n': 50}], 'n': 16, 'tx_index': 3072819358224917, 'script': '76a914adfb8786f19039b78a78a999e04d68348d0571be88ac', 'addr': '1GrwDkr33gT6LuumniYjKEGjTLhsL5kmqC'}}, {'sequence': 4294967295, 'witness': '', 'script': '483045022100f6aa6be17a57e7dbab1834d5da43c888f81175d98a873d48ecc17a60f3bcf2dd022051df77ed09412377e798ffd05c7109b445a0054aac17e1753286e43a1c2335d101210201973a41bb610e199a1fbb208398fbacc732c3658d132dbf9f3a394bedc9a7b5', 'index': 51, 'prev_out': {'type': 0, 'spent': True, 'value': 1453111631, 'spending_outpoints': [{'tx_index': 3072434988773922, 'n': 51}], 'n': 0, 'tx_index': 4310706676186352, 'script': '76a914adfb8786f19039b78a78a999e04d68348d0571be88ac', 'addr': '1GrwDkr33gT6LuumniYjKEGjTLhsL5kmqC'}}, {'sequence': 4294967295, 'witness': '', 'script': '483045022100fe6da1ae96fa7b83c8d3e949e749ec814b3a096d05778e22682fc76ba3f4387602201d0a0c6d8115a5452d52c263acd3cb286f4f360d40c82fa1c3c8a50324605b0701210201973a41bb610e199a1fbb208398fbacc732c3658d132dbf9f3a394bedc9a7b5', 'index': 52, 'prev_out': {'type': 0, 'spent': True, 'value': 1433430666, 'spending_outpoints': [{'tx_index': 3072434988773922, 'n': 52}], 'n': 0, 'tx_index': 3710320309814900, 'script': '76a914adfb8786f19039b78a78a999e04d68348d0571be88ac', 'addr': '1GrwDkr33gT6LuumniYjKEGjTLhsL5kmqC'}}, {'sequence': 4294967295, 'witness': '', 'script': '47304402200739f8ed6ca2dc8c13661a1e48ec0b077684dc15a11f3682c63c3b841fbb65cc02200e117e5c30aacc12865f861549baf5f4dabf29dc980d36d7ebedf34f36c5e9060121029e0828ee826a4b5bbe34ac19ff180c5d244f55ed6fe3804f489626a6d575e6f8', 'index': 53, 'prev_out': {'type': 0, 'spent': True, 'value': 1425000000, 'spending_outpoints': [{'tx_index': 3072434988773922, 'n': 53}], 'n': 0, 'tx_index': 5152355671591267, 'script': '76a9149a09b90944752537fe829fe6418269f88d7e9fcf88ac', 'addr': '1F3Ui6SEo4i6qDGK79p9n22J4idUcom7JG'}}, {'sequence': 4294967295, 'witness': '', 'script': '483045022100ec1ae6af1e4eef905479df11fac26576ffa58474ae03014ce9e76dabb81174b802206c7ea4b609ae21b9e386000e03859a78f2424fb331392a9eb555e8e5f97ce36d0121020e6965eb8397fcdaac0b323bde6f7d9fc8eb42011b33373df75e8d1c1d31746c', 'index': 54, 'prev_out': {'type': 0, 'spent': True, 'value': 1416720764, 'spending_outpoints': [{'tx_index': 3072434988773922, 'n': 54}], 'n': 0, 'tx_index': 4496977427304222, 'script': '76a9142b362e67196de5a2892712f1e718fe1746d8898488ac', 'addr': '14wUxq4jj7HWkDdAnCf2jakhCMDd79C3f8'}}, {'sequence': 4294967295, 'witness': '', 'script': '483045022100b8989af4d7362f22494e2b4177ef58f9d7a3e1b3d9ccb56940f8fab1b466ec7f022000e742a5887f087623453231e34e73f8dcb3f15ddfa725d94d3018a820238aa601210201973a41bb610e199a1fbb208398fbacc732c3658d132dbf9f3a394bedc9a7b5', 'index': 55, 'prev_out': {'type': 0, 'spent': True, 'value': 1411233885, 'spending_outpoints': [{'tx_index': 3072434988773922, 'n': 55}], 'n': 12, 'tx_index': 228273690109501, 'script': '76a914adfb8786f19039b78a78a999e04d68348d0571be88ac', 'addr': '1GrwDkr33gT6LuumniYjKEGjTLhsL5kmqC'}}]","[{'type': 0, 'spent': False, 'value': 250000000000, 'spending_outpoints': [], 'n': 0, 'tx_index': 3072434988773922, 'script': '0020eab3cd0683f9554a66261793846f509ceaefd2cd4dfc20adf400689eb4addc09', 'addr': 'bc1qa2eu6p5rl9255e3xz7fcgm6snn4wl5kdfh7zpt05qp5fad9dmsys0qjg0e'}, {'type': 0, 'spent': True, 'value': 105382992, 'spending_outpoints': [{'tx_index': 3585747590506469, 'n': 23}], 'n': 1, 'tx_index': 3072434988773922, 'script': '76a914adfb8786f19039b78a78a999e04d68348d0571be88ac', 'addr': '1GrwDkr33gT6LuumniYjKEGjTLhsL5kmqC'}]",250000000000,924597665510
532a33585fb1c8b4203f4a06a27fabbffb8288165baa3ab803f2ed317d217854,2,4,2,677,2708,10050,0.0.0.0,0,2971997909171646,False,1728026429,864083,864083,"[{'sequence': 4294967295, 'witness': '', 'script': '48304502210094be8b57d9fed9933a5e299d714b6f06170fceef87661c642798bad15847015e022055336086411e0b305aa5fa8ee0873ad5fb7786f715a5ba1bb4fb72ce6c2e90e601210201973a41bb610e199a1fbb208398fbacc732c3658d132dbf9f3a394bedc9a7b5', 'index': 0, 'prev_out': {'type': 0, 'spent': True, 'value': 15451052696, 'spending_outpoints': [{'tx_index': 2971997909171646, 'n': 0}], 'n': 6, 'tx_index': 4159455657646525, 'script': '76a914adfb8786f19039b78a78a999e04d68348d0571be88ac', 'addr': '1GrwDkr33gT6LuumniYjKEGjTLhsL5kmqC'}}, {'sequence': 4294967295, 'witness': '', 'script': '473044022004b6bd29d333082246d2d63ec3bd7cf81e45047c89d53b1c8cf2ba5e5e090652022058d9438423a41960c665193741ca62dfdad598bc36fedf33f9e810ee7a8f990301210201973a41bb610e199a1fbb208398fbacc732c3658d132dbf9f3a394bedc9a7b5', 'index': 1, 'prev_out': {'type': 0, 'spent': True, 'value': 15376213652, 'spending_outpoints': [{'tx_index': 2971997909171646, 'n': 1}], 'n': 8, 'tx_index': 3319009576415711, 'script': '76a914adfb8786f19039b78a78a999e04d68348d0571be88ac', 'addr': '1GrwDkr33gT6LuumniYjKEGjTLhsL5kmqC'}}, {'sequence': 4294967295, 'witness': '', 'script': '48304502210094a866f6d84815153904387304c541743409c515f6cbb3507af3e00a51c92183022074bd1e01113462b6d48d7f4f4b58e9a45abe9120365578b2292a2210e2ad728601210201973a41bb610e199a1fbb208398fbacc732c3658d132dbf9f3a394bedc9a7b5', 'index': 2, 'prev_out': {'type': 0, 'spent': True, 'value': 15019273809, 'spending_outpoints': [{'tx_index': 2971997909171646, 'n': 2}], 'n': 9, 'tx_index': 4440362473082350, 'script': '76a914adfb8786f19039b78a78a999e04d68348d0571be88ac', 'addr': '1GrwDkr33gT6LuumniYjKEGjTLhsL5kmqC'}}, {'sequence': 4294967295, 'witness': '', 'script': '4730440220408638b505334799e0523bcadb8c281d733e6339c6af82c14a7a4f9651213d3202204faacd794112b9685b499aff33ad326caaea610df49836a93671a936b6ae699c01210201973a41bb610e199a1fbb208398fbacc732c3658d132dbf9f3a394bedc9a7b5', 'index': 3, 'prev_out': {'type': 0, 'spent': True, 'value': 14413469914, 'spending_outpoints': [{'tx_index': 2971997909171646, 'n': 3}], 'n': 0, 'tx_index': 588649460946908, 'script': '76a914adfb8786f19039b78a78a999e04d68348d0571be88ac', 'addr': '1GrwDkr33gT6LuumniYjKEGjTLhsL5kmqC'}}]","[{'type': 0, 'spent': False, 'value': 50000000000, 'spending_outpoints': [], 'n': 0, 'tx_index': 2971997909171646, 'script': '0020eab3cd0683f9554a66261793846f509ceaefd2cd4dfc20adf400689eb4addc09', 'addr': 'bc1qa2eu6p5rl9255e3xz7fcgm6snn4wl5kdfh7zpt05qp5fad9dmsys0qjg0e'}, {'type': 0, 'spent': True, 'value': 10260000021, 'spending_outpoints': [{'tx_index': 3072434988773922, 'n': 7}], 'n': 1, 'tx_index': 2971997909171646, 'script': '76a914adfb8786f19039b78a78a999e04d68348d0571be88ac', 'addr': '1GrwDkr33gT6LuumniYjKEGjTLhsL5kmqC'}]",50000000000,674597665510
e42160ccc61817c0ef2a20f3b0706fb7a2d81d4480423d523756d90d21c14aba,2,1,2,235,940,3390,0.0.0.0,0,6554567376485162,False,1728020529,864078,864078,"[{'sequence': 4294967295, 'witness': '', 'script': '483045022100b5a9a6d19d7a2c663cf26ec51a58ff8fe7f8cf3a547932e2346e14d3020ee973022042ecd25a57c5188a9931f6c58c165c8ee07f07a975e6882c4a3810be6815fd3901210201973a41bb610e199a1fbb208398fbacc732c3658d132dbf9f3a394bedc9a7b5', 'index': 0, 'prev_out': {'type': 0, 'spent': True, 'value': 16848891922, 'spending_outpoints': [{'tx_index': 6554567376485162, 'n': 0}], 'n': 8, 'tx_index': 5978031685707815, 'script': '76a914adfb8786f19039b78a78a999e04d68348d0571be88ac', 'addr': '1GrwDkr33gT6LuumniYjKEGjTLhsL5kmqC'}}]","[{'type': 0, 'spent': False, 'value': 1000000, 'spending_outpoints': [], 'n': 0, 'tx_index': 6554567376485162, 'script': '0020eab3cd0683f9554a66261793846f509ceaefd2cd4dfc20adf400689eb4addc09', 'addr': 'bc1qa2eu6p5rl9255e3xz7fcgm6snn4wl5kdfh7zpt05qp5fad9dmsys0qjg0e'}, {'type': 0, 'spent': True, 'value': 16847888532, 'spending_outpoints': [{'tx_index': 498813324094929, 'n': 0}], 'n': 1, 'tx_index': 6554567376485162, 'script': '76a914adfb8786f19039b78a78a999e04d68348d0571be88ac', 'addr': '1GrwDkr33gT6LuumniYjKEGjTLhsL5kmqC'}]",1000000,624597665510
edbc32f25c6fe8b3902de46c586b7f21238beec32bbf63a58e535fd37dce3850,2,1,1,523,805,4040,0.0.0.0,851494,2822557207784426,False,1726195501,861092,861092,"[{'sequence': 4294967293, 'witness': '05004730440220637d2f3906141a967bfd597e70189dd3b7a94e8ba512833a62b6e10e49d06fb8022020b850032cbd533daff52f19eac2363c20a4921a3b8cc0f758d22c4d124d04da0147304402200b6c592eb10366bf3a9d24efdaf9f870366e756c9badbcb7ab6e17060ac21ba802200b836d68c27c86a24a582396155615cc04455df2a58f3bc98a329effccb4c4af01483045022100a7f0f2a67aa96a3c42774f8dc03081980faa9a8649096d1b3d0deb2cc0e9c47c02207fb7d9a0574d295326094beebe169194f5716a4ff7154d1eb7722024ebdb116c01cf5321022c5d5e92daa8385ffb21e6e1fd71e469bf5b9119f3ce07f647838c4de909b4a4210276aa4fb293c832ef88662a621c96f26c9aeb758dadeb46e6e010483d6c7d359a21029590ccde66ad5d5427fc33b2758d1dda371ad8a0c90be05e3f5c7ac5b7f2280a2102e072a0e826d9239f77cc880cbba9fa05508eff41f5d6107755cd77d4602bcdc72102ec833fcc4ae61136bdab25be06f6d20924f069d50587b054bfd14b0d1fc272712103ed321a7e5989fc26ce883c063705632e9daa1194af27d51c85b3f4da5876462356ae', 'script': '', 'index': 0, 'prev_out': {'type': 0, 'spent': True, 'value': 615796586840, 'spending_outpoints': [{'tx_index': 2822557207784426, 'n': 0}], 'n': 0, 'tx_index': 7831656610669026, 'script': '00208518d05b901559e0770724ccf62cb21e6cee7026527f4e3425903f180df11451', 'addr': 'bc1qs5vdqkusz4v7qac8ynx0vt9jrekwuupx2fl5udp9jql3sr03z3gsr2mf0f'}}]","[{'type': 0, 'spent': False, 'value': 615796582800, 'spending_outpoints': [], 'n': 0, 'tx_index': 2822557207784426, 'script': '0020eab3cd0683f9554a66261793846f509ceaefd2cd4dfc20adf400689eb4addc09', 'addr': 'bc1qa2eu6p5rl9255e3xz7fcgm6snn4wl5kdfh7zpt05qp5fad9dmsys0qjg0e'}]",615796582800,624596665510
0ece9b1244942c38f97901a5cb5d2c1f0bc52c4be6d8e1ee5b1984e23ef6382f,2,6,2,2909,3935,24747,0.0.0.0,854009,1661494271692931,False,1723642140,856748,856748,"[{'sequence': 4294967293, 'witness': '0500483045022100faffb5adc7d4b2c15a52ff7b51a8adb59b53f3e673e267266070c517331071cb02203dab56d606a0a6d2723364cfe6019e4ef25c0c4f9ad8d11a8edefe4cdadcb55d01483045022100a08cb5238c9165cee9d1aa5826f611b5965b5956f3d951099249b6702549ab4002204dbfbbb16117582071a1ae727e8f73951e2cede9bf7137d3420651ca140fc3e001483045022100bb852078e9ad07546dc35afd69a6d82acf2ff20a32cd483aa29c21b6e20cf04102205a58598d2ebdcab2d85b10fa057d42e46da99ef319baf4b686e42abc65490ebd01cf5321022c5d5e92daa8385ffb21e6e1fd71e469bf5b9119f3ce07f647838c4de909b4a4210276aa4fb293c832ef88662a621c96f26c9aeb758dadeb46e6e010483d6c7d359a21029590ccde66ad5d5427fc33b2758d1dda371ad8a0c90be05e3f5c7ac5b7f2280a2102e072a0e826d9239f77cc880cbba9fa05508eff41f5d6107755cd77d4602bcdc72102ec833fcc4ae61136bdab25be06f6d20924f069d50587b054bfd14b0d1fc272712103ed321a7e5989fc26ce883c063705632e9daa1194af27d51c85b3f4da5876462356ae', 'script': '', 'index': 0, 'prev_out': {'type': 0, 'spent': True, 'value': 83547, 'spending_outpoints': [{'tx_index': 1661494271692931, 'n': 0}], 'n': 0, 'tx_index': 1633162535988349, 'script': '00208518d05b901559e0770724ccf62cb21e6cee7026527f4e3425903f180df11451', 'addr': 'bc1qs5vdqkusz4v7qac8ynx0vt9jrekwuupx2fl5udp9jql3sr03z3gsr2mf0f'}}, {'sequence': 4294967293, 'witness': '0500473044022059a870f01bd196e91cb53bd4153da1b259f2c3559a584711b889ae80e5256ae1022054e22a1284dc8e16c63e837a1276c1d903b979b40b39199bb4d75dfbcf534e4b0147304402202a2fe480c41febc56536479b7812201abb937de954cb8df7fe9eb41407bc6ee502205a36d42226efc2503f4a16eabff4a9bc4b16b1c0d54c013555515f204dcc3db00147304402207f4f509aaddfff731814ba02370bcfb5bbb5bbd001e755df0eea1b90a95a04cd022071d6f1a6ec0f456c941fab3973755621819d011738d803d00ef078fcd68e87ed01cf5321022c5d5e92daa8385ffb21e6e1fd71e469bf5b9119f3ce07f647838c4de909b4a4210276aa4fb293c832ef88662a621c96f26c9aeb758dadeb46e6e010483d6c7d359a21029590ccde66ad5d5427fc33b2758d1dda371ad8a0c90be05e3f5c7ac5b7f2280a2102e072a0e826d9239f77cc880cbba9fa05508eff41f5d6107755cd77d4602bcdc72102ec833fcc4ae61136bdab25be06f6d20924f069d50587b054bfd14b0d1fc272712103ed321a7e5989fc26ce883c063705632e9daa1194af27d51c85b3f4da5876462356ae', 'script': '', 'index': 1, 'prev_out': {'type': 0, 'spent': True, 'value': 50000, 'spending_outpoints': [{'tx_index': 1661494271692931, 'n': 1}], 'n': 0, 'tx_index': 7184972602250287, 'script': '00208518d05b901559e0770724ccf62cb21e6cee7026527f4e3425903f180df11451', 'addr': 'bc1qs5vdqkusz4v7qac8ynx0vt9jrekwuupx2fl5udp9jql3sr03z3gsr2mf0f'}}, {'sequence': 4294967293, 'witness': '050047304402205181baf5a58735cbdef8a18b887553a6edaa811002c42aa388f4e6a68757c6f9022065a4035f434be2c5f8ce6e324a3ee430439497c4119d685429acb17a2c62f86401483045022100c42889b50c41e03bb697f4c874d223c92fdfd50574dd14975b0cf88cbc89b49502205d26ba453d6b8b51db2f0a4a4123ab80fb3b9340cc11cf625b621d0c75eb83cc014730440220228b7c39fe91a1d86d2f4d6379c6bd145caffc12e4871acf1ee06b12afd6484f02200f6ae39aed4205addaf4f6e6bc2202703f20c7cd0770436383731bd625fd5a3801cf5321022c5d5e92daa8385ffb21e6e1fd71e469bf5b9119f3ce07f647838c4de909b4a4210276aa4fb293c832ef88662a621c96f26c9aeb758dadeb46e6e010483d6c7d359a21029590ccde66ad5d5427fc33b2758d1dda371ad8a0c90be05e3f5c7ac5b7f2280a2102e072a0e826d9239f77cc880cbba9fa05508eff41f5d6107755cd77d4602bcdc72102ec833fcc4ae61136bdab25be06f6d20924f069d50587b054bfd14b0d1fc272712103ed321a7e5989fc26ce883c063705632e9daa1194af27d51c85b3f4da5876462356ae', 'script': '', 'index': 2, 'prev_out': {'type': 0, 'spent': True, 'value': 77100, 'spending_outpoints': [{'tx_index': 1661494271692931, 'n': 2}], 'n': 1, 'tx_index': 7495879937295266, 'script': '00208518d05b901559e0770724ccf62cb21e6cee7026527f4e3425903f180df11451', 'addr': 'bc1qs5vdqkusz4v7qac8ynx0vt9jrekwuupx2fl5udp9jql3sr03z3gsr2mf0f'}}, {'sequence': 4294967293, 'witness': '05004830450221008697ed162b79b68b92720d464325398f6ff8a29f11614452a62e407ade6dedc8022038d60dd3de57b26a7890df978922878d226e74c2cc87ea4c137cee502bfd9c060147304402200d3ffcdef57a91c51b865b2b46e99fe1baa41348e6a596992bba287fe632dbb302203e0b9db711ef9bcbb8091cf6ac9a77c968e4b5e1c6fcee4498f5be4db81c859e0147304402205256ba924d2ac887cd90b8f4f6bd01f1fbde698d6838c8c74bc5aade0881d4a7022024e7d5246de0e29ad7b059507ce4e9647dbff8002b90442715cb1fe2c5022e4701cf5321022c5d5e92daa8385ffb21e6e1fd71e469bf5b9119f3ce07f647838c4de909b4a4210276aa4fb293c832ef88662a621c96f26c9aeb758dadeb46e6e010483d6c7d359a21029590ccde66ad5d5427fc33b2758d1dda371ad8a0c90be05e3f5c7ac5b7f2280a2102e072a0e826d9239f77cc880cbba9fa05508eff41f5d6107755cd77d4602bcdc72102ec833fcc4ae61136bdab25be06f6d20924f069d50587b054bfd14b0d1fc272712103ed321a7e5989fc26ce883c063705632e9daa1194af27d51c85b3f4da5876462356ae', 'script': '', 'index': 3, 'prev_out': {'type': 0, 'spent': True, 'value': 100000, 'spending_outpoints': [{'tx_index': 1661494271692931, 'n': 3}], 'n': 0, 'tx_index': 3617517797354741, 'script': '00208518d05b901559e0770724ccf62cb21e6cee7026527f4e3425903f180df11451', 'addr': 'bc1qs5vdqkusz4v7qac8ynx0vt9jrekwuupx2fl5udp9jql3sr03z3gsr2mf0f'}}, {'sequence': 4294967293, 'witness': '05004730440220680cd5987c7ef2df5df4ae84d63b4a6c3784769d802d284973e66b621e30315602207f530d9bb10b4baf3065d3dc83cd110827bc969de545e9aca5d476065e5930b201483045022100c222dba0f676a89f7b0ba1a4ff2fcd18e8aaaa2fad65715f999444e338c6fa0b0220785ad15684c639c0dec727d0ccc61fd56261f1b5bf09f261094881131ffca5e701483045022100952a2917daeaf78bc9b3b75c5a030c3e5bb753dbe8a5f340cf100c1c1f28f37202205ba61f173d205a969263bcb19565f47f822e54742327de15add92b7bb6edd25e01cf5321022c5d5e92daa8385ffb21e6e1fd71e469bf5b9119f3ce07f647838c4de909b4a4210276aa4fb293c832ef88662a621c96f26c9aeb758dadeb46e6e010483d6c7d359a21029590ccde66ad5d5427fc33b2758d1dda371ad8a0c90be05e3f5c7ac5b7f2280a2102e072a0e826d9239f77cc880cbba9fa05508eff41f5d6107755cd77d4602bcdc72102ec833fcc4ae61136bdab25be06f6d20924f069d50587b054bfd14b0d1fc272712103ed321a7e5989fc26ce883c063705632e9daa1194af27d51c85b3f4da5876462356ae', 'script': '', 'index': 4, 'prev_out': {'type': 0, 'spent': True, 'value': 24879688100, 'spending_outpoints': [{'tx_index': 1661494271692931, 'n': 4}], 'n': 0, 'tx_index': 6747257836808099, 'script': '00208518d05b901559e0770724ccf62cb21e6cee7026527f4e3425903f180df11451', 'addr': 'bc1qs5vdqkusz4v7qac8ynx0vt9jrekwuupx2fl5udp9jql3sr03z3gsr2mf0f'}}, {'sequence': 4294967293, 'witness': '0500473044022031dcf99d93c2926c80f6fd9dd577aea10a9b89bb2af3294ac1493ba805b200e102207717aadd267ad5d5380d3ebb82b7d20ed03cab25aef4ede1585564360395317e01483045022100d45d56c2f2656da8b4895e296fcd0216453d1fecd1c5bb14588e7f9d7578041102207e905344228635e9f2df99c983a01ab381e2e8985c0d4d0d578e5e3b85dd03ea01483045022100839dcfd01f7511f409847abf8bb2430427aa113989c4c8c133da24b6094c19480220612a4343fb223472b7b244431b6ae4f7cfa590febf48265c40a3ef0dfd27a8db01cf5321022c5d5e92daa8385ffb21e6e1fd71e469bf5b9119f3ce07f647838c4de909b4a4210276aa4fb293c832ef88662a621c96f26c9aeb758dadeb46e6e010483d6c7d359a21029590ccde66ad5d5427fc33b2758d1dda371ad8a0c90be05e3f5c7ac5b7f2280a2102e072a0e826d9239f77cc880cbba9fa05508eff41f5d6107755cd77d4602bcdc72102ec833fcc4ae61136bdab25be06f6d20924f069d50587b054bfd14b0d1fc272712103ed321a7e5989fc26ce883c063705632e9daa1194af27d51c85b3f4da5876462356ae', 'script': '', 'index': 5, 'prev_out': {'type': 0, 'spent': True, 'value': 60000, 'spending_outpoints': [{'tx_index': 1661494271692931, 'n': 5}], 'n': 0, 'tx_index': 5442489619356992, 'script': '00208518d05b901559e0770724ccf62cb21e6cee7026527f4e3425903f180df11451', 'addr': 'bc1qs5vdqkusz4v7qac8ynx0vt9jrekwuupx2fl5udp9jql3sr03z3gsr2mf0f'}}]","[{'type': 0, 'spent': False, 'value': 8800000000, 'spending_outpoints': [], 'n': 0, 'tx_index': 1661494271692931, 'script': '0020eab3cd0683f9554a66261793846f509ceaefd2cd4dfc20adf400689eb4addc09', 'addr': 'bc1qa2eu6p5rl9255e3xz7fcgm6snn4wl5kdfh7zpt05qp5fad9dmsys0qjg0e'}, {'type': 0, 'spent': False, 'value': 16080034000, 'spending_outpoints': [], 'n': 1, 'tx_index': 1661494271692931, 'script': '00208518d05b901559e0770724ccf62cb21e6cee7026527f4e3425903f180df11451', 'addr': 'bc1qs5vdqkusz4v7qac8ynx0vt9jrekwuupx2fl5udp9jql3sr03z3gsr2mf0f'}]",8800000000,8800082710
76d4363c1c5180b8daadd2001580f9dc299944e5430291be027a3605fe8f48fe,2,1,2,567,978,1990,0.0.0.0,854731,8946803420473039,False,1722443215,854826,854826,"[{'sequence': 4294967293, 'witness': '0500483045022100fc5ea76c8464e00621904f7ff65338df61a56c2cfed45fdfb363ec1563c6fccb02200587ead5a32b6b39bb186964406674b47d78a01c770991c66db4a7ec7e274a3f014830450221008692b40b01b29f7c5580a6cd6c4f71290a91e7ed66ccbb4f0619cd51a59a0aee022069951459845eb5d93f6dae4d65ebb19c20b309f34a3ec563a90fb1d478727cda01473044022032e99ff366c87753f3ce97c4a3842c859127c92cdbf4ec9e142d07b48f32b159022050de8627b4727cc89801516924035f2b9808b8ee347b11a30a37a7ef51ecdb6c01cf5321022c5d5e92daa8385ffb21e6e1fd71e469bf5b9119f3ce07f647838c4de909b4a4210276aa4fb293c832ef88662a621c96f26c9aeb758dadeb46e6e010483d6c7d359a21029590ccde66ad5d5427fc33b2758d1dda371ad8a0c90be05e3f5c7ac5b7f2280a2102cd1dccaf45a9bb3033b4895712e149e81a3754f8b5702252ee1455df4b580e4e2102e072a0e826d9239f77cc880cbba9fa05508eff41f5d6107755cd77d4602bcdc72103ed321a7e5989fc26ce883c063705632e9daa1194af27d51c85b3f4da5876462356ae', 'script': '', 'index': 0, 'prev_out': {'type': 0, 'spent': True, 'value': 84700, 'spending_outpoints': [{'tx_index': 8946803420473039, 'n': 0}], 'n': 1, 'tx_index': 5442489619356992, 'script': '0020eab3cd0683f9554a66261793846f509ceaefd2cd4dfc20adf400689eb4addc09', 'addr': 'bc1qa2eu6p5rl9255e3xz7fcgm6snn4wl5kdfh7zpt05qp5fad9dmsys0qjg0e'}}]","[{'type': 0, 'spent': False, 'value': 19280, 'spending_outpoints': [], 'n': 0, 'tx_index': 8946803420473039, 'script': '0020eab3cd0683f9554a66261793846f509ceaefd2cd4dfc20adf400689eb4addc09', 'addr': 'bc1qa2eu6p5rl9255e3xz7fcgm6snn4wl5kdfh7zpt05qp5fad9dmsys0qjg0e'}, {'type': 0, 'spent': False, 'value': 63430, 'spending_outpoints': [], 'n': 1, 'tx_index': 8946803420473039, 'script': '0020eab3cd0683f9554a66261793846f509ceaefd2cd4dfc20adf400689eb4addc09', 'addr': 'bc1qa2eu6p5rl9255e3xz7fcgm6snn4wl5kdfh7zpt05qp5fad9dmsys0qjg0e'}]",-1990,82710
dfb2da9974a9e3780735d2765c4d1fe89aac664bf83759e83d06eaa4e352af9a,2,1,2,565,976,3000,0.0.0.0,850314,5442489619356992,False,1721052824,852316,852316,"[{'sequence': 4294967293, 'witness': '0500473044022077a2210802f904e304352115ddcdd7961e2985495070cee089e42fe8e1d30ef502206a73d0f54bb2241d1447a640f3f0dd77a00447a87d871d3d00ae90994159ab3801473044022076b8f3d7da7c60653a2967283ececaeade620676f100be5d02d52abd24c70a3402206628bb665e661c5ac7d1927dc085e40f319937ad034fbbeef7087a369edda7470147304402207ca96618747bd07e879e14a33ce7969f8313ba7892c06cef9106bf1171e81dc6022008195724a32d96c71421179467edd258186ca0823cd6479d9632a6aa0074cf8201cf5321022c5d5e92daa8385ffb21e6e1fd71e469bf5b9119f3ce07f647838c4de909b4a4210276aa4fb293c832ef88662a621c96f26c9aeb758dadeb46e6e010483d6c7d359a21029590ccde66ad5d5427fc33b2758d1dda371ad8a0c90be05e3f5c7ac5b7f2280a2102cd1dccaf45a9bb3033b4895712e149e81a3754f8b5702252ee1455df4b580e4e2102e072a0e826d9239f77cc880cbba9fa05508eff41f5d6107755cd77d4602bcdc72103ed321a7e5989fc26ce883c063705632e9daa1194af27d51c85b3f4da5876462356ae', 'script': '', 'index': 0, 'prev_out': {'type': 0, 'spent': True, 'value': 147700, 'spending_outpoints': [{'tx_index': 5442489619356992, 'n': 0}], 'n': 1, 'tx_index': 7184972602250287, 'script': '0020eab3cd0683f9554a66261793846f509ceaefd2cd4dfc20adf400689eb4addc09', 'addr': 'bc1qa2eu6p5rl9255e3xz7fcgm6snn4wl5kdfh7zpt05qp5fad9dmsys0qjg0e'}}]","[{'type': 0, 'spent': True, 'value': 60000, 'spending_outpoints': [{'tx_index': 1661494271692931, 'n': 5}], 'n': 0, 'tx_index': 5442489619356992, 'script': '00208518d05b901559e0770724ccf62cb21e6cee7026527f4e3425903f180df11451', 'addr': 'bc1qs5vdqkusz4v7qac8ynx0vt9jrekwuupx2fl5udp9jql3sr03z3gsr2mf0f'}, {'type': 0, 'spent': True, 'value': 84700, 'spending_outpoints': [{'tx_index': 8946803420473039, 'n': 0}], 'n': 1, 'tx_index': 5442489619356992, 'script': '0020eab3cd0683f9554a66261793846f509ceaefd2cd4dfc20adf400689eb4addc09', 'addr': 'bc1qa2eu6p5rl9255e3xz7fcgm6snn4wl5kdfh7zpt05qp5fad9dmsys0qjg0e'}]",-63000,84700
2ebea1b5f8ebada80be2f1b7b4ab5caa6135b84bbb78e990ed7fa16c5d8e35cc,2,1,2,566,977,2300,0.0.0.0,850181,7184972602250287,False,1719889130,850318,850318,"[{'sequence': 4294967293, 'witness': '0500473044022006a80154b13b7169f8e0596dcac744cf2466dfd19a928678a157e7f2359c2f9c02204f13467606d6411c9f5895a0e9a9ff0af26967543b4ac19947f87081eb9afc8e01483045022100fcb56492081a1449045fbbdf7bc17fdf329968bc294b140d14f1d1f3895380e70220307828272a0051e6be8025a074a4c68c2cdf8b33e08b755d28733b41892cb3f601473044022037c323f168527f482ac775d00917d5c059e4ef90db24bd68f3b32a95097e321e022049db3954a192935c445132fcbdd85afde36f486a93969f01f4d42bd976dc104101cf5321022c5d5e92daa8385ffb21e6e1fd71e469bf5b9119f3ce07f647838c4de909b4a4210276aa4fb293c832ef88662a621c96f26c9aeb758dadeb46e6e010483d6c7d359a21029590ccde66ad5d5427fc33b2758d1dda371ad8a0c90be05e3f5c7ac5b7f2280a2102cd1dccaf45a9bb3033b4895712e149e81a3754f8b5702252ee1455df4b580e4e2102e072a0e826d9239f77cc880cbba9fa05508eff41f5d6107755cd77d4602bcdc72103ed321a7e5989fc26ce883c063705632e9daa1194af27d51c85b3f4da5876462356ae', 'script': '', 'index': 0, 'prev_out': {'type': 0, 'spent': True, 'value': 200000, 'spending_outpoints': [{'tx_index': 7184972602250287, 'n': 0}], 'n': 1, 'tx_index': 7669462920358804, 'script': '0020eab3cd0683f9554a66261793846f509ceaefd2cd4dfc20adf400689eb4addc09', 'addr': 'bc1qa2eu6p5rl9255e3xz7fcgm6snn4wl5kdfh7zpt05qp5fad9dmsys0qjg0e'}}]","[{'type': 0, 'spent': True, 'value': 50000, 'spending_outpoints': [{'tx_index': 1661494271692931, 'n': 1}], 'n': 0, 'tx_index': 7184972602250287, 'script': '00208518d05b901559e0770724ccf62cb21e6cee7026527f4e3425903f180df11451', 'addr': 'bc1qs5vdqkusz4v7qac8ynx0vt9jrekwuupx2fl5udp9jql3sr03z3gsr2mf0f'}, {'type': 0, 'spent': True, 'value': 147700, 'spending_outpoints': [{'tx_index': 5442489619356992, 'n': 0}], 'n': 1, 'tx_index': 7184972602250287, 'script': '0020eab3cd0683f9554a66261793846f509ceaefd2cd4dfc20adf400689eb4addc09', 'addr': 'bc1qa2eu6p5rl9255e3xz7fcgm6snn4wl5kdfh7zpt05qp5fad9dmsys0qjg0e'}]",-52300,147700
ed7a72052edf1ddccbf588f3ecc3e6464115f5fa3bb01359d7a35ce3e7affad9,2,1,2,235,940,2580,0.0.0.0,0,7669462920358804,False,1719728046,850077,850077,"[{'sequence': 4294967295, 'witness': '', 'script': '483045022100c9fbacff063865837da8cb28cd1298068e0f4fa0760943a18617ce5b81f860bf02204f1a76738f267c05895780ebf2893e7a12f38acfbda29da3dbddbca59668601801210284e0edfdeb82a9e1dfdeb11ccbbca54922232cc00693e3cb75b34010cc3f64b0', 'index': 0, 'prev_out': {'type': 0, 'spent': True, 'value': 165384153, 'spending_outpoints': [{'tx_index': 7669462920358804, 'n': 0}], 'n': 0, 'tx_index': 3407261444910762, 'script': '76a914e4245d2bf86ec42894df39feb177efd2355f914288ac', 'addr': '1MoJdMF8Z9PGzvmfRZmwmiEMCkEej4FbAh'}}]","[{'type': 0, 'spent': True, 'value': 165181573, 'spending_outpoints': [{'tx_index': 12501354962284, 'n': 0}], 'n': 0, 'tx_index': 7669462920358804, 'script': '76a914e4245d2bf86ec42894df39feb177efd2355f914288ac', 'addr': '1MoJdMF8Z9PGzvmfRZmwmiEMCkEej4FbAh'}, {'type': 0, 'spent': True, 'value': 200000, 'spending_outpoints': [{'tx_index': 7184972602250287, 'n': 0}], 'n': 1, 'tx_index': 7669462920358804, 'script': '0020eab3cd0683f9554a66261793846f509ceaefd2cd4dfc20adf400689eb4addc09', 'addr': 'bc1qa2eu6p5rl9255e3xz7fcgm6snn4wl5kdfh7zpt05qp5fad9dmsys0qjg0e'}]",200000,200000
