hash,ver,vin_sz,vout_sz,size,weight,fee,relayed_by,lock_time,tx_index,double_spend,time,block_index,block_height,inputs,out,result,balance
531a413112816c57656cd088fdcd02b6adb6d23ef48626e5ff5fb75db4040a85,2,1,1,305,551,276,0.0.0.0,0,4680898403088107,False,1743152323,889850,889850,"[{'sequence': 4294967295, 'witness': '03409f537f363f4ae2a01c613075d96f24ba0e9d93c91881ab696614d24de4365bf3c41982823b6a9021bbb0a6e7b6e10bc27e138371a39063bf9bba31a3032349fb7820017ef1b6aa5ef4461ea85796fcb696b793e98374583ddf6852301928e72b1ae5ac0063036f7264010118746578742f706c61696e3b636861727365743d7574662d3800327b2270223a226272632d3230222c226f70223a226d696e74222c227469636b223a224254c48a222c22616d74223a2231227d6821c0017ef1b6aa5ef4461ea85796fcb696b793e98374583ddf6852301928e72b1ae5', 'script': '', 'index': 0, 'prev_out': {'type': 0, 'spent': True, 'value': 822, 'spending_outpoints': [{'tx_index': 4680898403088107, 'n': 0}], 'n': 26, 'tx_index': 4646964207065573, 'script': '5120a5e9fd9a3441d2e28377181addd6f0a65787c841794e1de215d0b66879414214', 'addr': 'bc1p5h5lmx35g8fw9qmhrqddm4hs5etc0jzp098pmcs46zmxs72pgg2qt8yqku'}}]","[{'type': 0, 'spent': False, 'value': 546, 'spending_outpoints': [], 'n': 0, 'tx_index': 4680898403088107, 'script': '001437d77a5fa3783b0033ab5c24c404ef82d46abd5c', 'addr': 'bc1qxlth5har0qasqvattsjvgp80st2x402u5shuud'}]",546,1050000585651
cf079cde2333b07cc71055e51eb35d07d3e1b0090a0a8a892fbdf575095bc1d5,1,1,1,191,437,113,0.0.0.0,0,7520845848034999,False,1731408168,879852,879852,"[{'sequence': 4294967295, 'witness': '0247304402203f9b90f0909c84c57ea61f9d597fb2f54f7262328895cb29c5dd276f82900af6022071a1ee6392d6606288eea884eeb2d6956064f0c8f6a700859d3a09bf9193e60601210230d01affe9ddfc53a0f2539336187bd3c10903bdf55b8811f87cf3bdeecaf7c7', 'script': '', 'index': 0, 'prev_out': {'type': 0, 'spent': True, 'value': 443, 'spending_outpoints': [{'tx_index': 7520845848034999, 'n': 0}], 'n': 8, 'tx_index': 1641130212132113, 'script': '001437e1577605d9e2c00ff569e065f877a4181a12ec', 'addr': 'bc1qxls4was9m83vqrl4d8sxt7rh5svp5yhvxshuud'}}]","[{'type': 0, 'spent': False, 'value': 330, 'spending_outpoints': [], 'n': 0, 'tx_index': 7520845848034999, 'script': '001437d77a5fa3783b0033ab5c24c404ef82d46abd5c', 'addr': 'bc1qxlth5har0qasqvattsjvgp80st2x402u5shuud'}]",330,1050000585105
096e2723d6a82685cc327deb499b6b3ac46ed5fb79e0f2b0537f75dc4db59bb3,2,1,4,307,904,472,0.0.0.0,0,6319402978610863,False,1735184664,876403,876403,"[{'sequence': 4294967293, 'witness': '02463043022043dcf19041b69a67cd896c55ad0208f5e8aff9076408d7661b4a8f2191694c42021f43705a6234512be4bbcedacfb025451f8bac40f8ef25435d4cc8b248cc7a32012102be559a5a88b3c1c76b9aa691febfd9dde7c3717c42c4111a5c1ff3e18e8f3561', 'script': '', 'index': 0, 'prev_out': {'type': 0, 'spent': True, 'value': 92160, 'spending_outpoints': [{'tx_index': 6319402978610863, 'n': 0}], 'n': 1, 'tx_index': 604886015082771, 'script': '00140712eae76f786a119e0a3727d39e3f256522ac19', 'addr': 'bc1qqufw4em00p4pr8s2xuna883ly4jj9tqer808c5'}}]","[{'type': 0, 'spent': False, 'value': 547, 'spending_outpoints': [], 'n': 0, 'tx_index': 6319402978610863, 'script': '001437d77a5fa3783b0033ab5c24c404ef82d46abd5c', 'addr': 'bc1qxlth5har0qasqvattsjvgp80st2x402u5shuud'}, {'type': 0, 'spent': True, 'value': 90481, 'spending_outpoints': [{'tx_index': 2408231626482592, 'n': 0}], 'n': 1, 'tx_index': 6319402978610863, 'script': '00140712eae76f786a119e0a3727d39e3f256522ac19', 'addr': 'bc1qqufw4em00p4pr8s2xuna883ly4jj9tqer808c5'}, {'type': 0, 'spent': False, 'value': 330, 'spending_outpoints': [], 'n': 2, 'tx_index': 6319402978610863, 'script': '0020003c7374616d703a7b2270223a227372632d3230222c226f70223a227472616e', 'addr': 'bc1qqq78xarpd4cr57ezwq3r5gnnwf3j6v3sygkzymmsygazyarjv9hq0r4hhc'}, {'type': 0, 'spent': False, 'value': 330, 'spending_outpoints': [], 'n': 3, 'tx_index': 6319402978610863, 'script': '002073666572222c227469636b223a227374616d70222c22616d74223a31307d0000', 'addr': 'bc1qwdnx2u3z9s38g6trdv3r5gnnw3sk6upz9s3xzmt5ygarzvraqqqqhx9lkg'}]",547,1050000584775
4f4206cc95ad558b70d4e355c1a72b5d6375f66cf2c2f5b36eac6fe1be5d935a,1,1,11,508,1702,4260,0.0.0.0,0,3186847343455733,False,1727309783,862879,862879,"[{'sequence': 4294967295, 'witness': '02483045022100f8377d96a768b264dc72a1b7c036c0b5065f5126203cba3e9c3c386bd5ed319802200ddab15aeeb9873a62ae16ee7a4fcd88a6e3b29e278e25b4055782b042b81e6e012102174ee672429ff94304321cdae1fc1e487edf658b34bd1d36da03761658a2bb09', 'script': '', 'index': 0, 'prev_out': {'type': 0, 'spent': True, 'value': 18564180, 'spending_outpoints': [{'tx_index': 3186847343455733, 'n': 0}], 'n': 1, 'tx_index': 7715090035050726, 'script': '0014dc6bf86354105de2fcd9868a2b0376d6731cb92f', 'addr': 'bc1qm34lsc65zpw79lxes69zkqmk6ee3ewf0j77s3h'}}]","[{'type': 0, 'spent': True, 'value': 6839266, 'spending_outpoints': [{'tx_index': 1350634044572380, 'n': 0}], 'n': 0, 'tx_index': 3186847343455733, 'script': '001410fd66da34fd2ad13a808f40d0dce051b5a44467', 'addr': 'bc1qzr7kdk35l54dzw5q3aqdph8q2x66g3r82na2d5'}, {'type': 0, 'spent': True, 'value': 632187, 'spending_outpoints': [{'tx_index': 2058081382183768, 'n': 52}], 'n': 1, 'tx_index': 3186847343455733, 'script': '0014dc6bf86354105de2fcd9868a2b0376d6731cb92f', 'addr': 'bc1qm34lsc65zpw79lxes69zkqmk6ee3ewf0j77s3h'}, {'type': 0, 'spent': True, 'value': 122000, 'spending_outpoints': [{'tx_index': 2027846515709112, 'n': 0}], 'n': 2, 'tx_index': 3186847343455733, 'script': '001499829b08094328dade2a2009cd1ce75b2a37b3e3', 'addr': 'bc1qnxpfkzqfgv5d4h32yqyu6888tv4r0vlrq9ej4u'}, {'type': 0, 'spent': True, 'value': 80000, 'spending_outpoints': [{'tx_index': 2631339227093467, 'n': 51}], 'n': 3, 'tx_index': 3186847343455733, 'script': '0014c49770d4ffcc8c3211790b9dc072bb67c16958a9', 'addr': 'bc1qcjthp48lejxryytepwwuqu4mvlqkjk9f4s77rf'}, {'type': 0, 'spent': True, 'value': 6307343, 'spending_outpoints': [{'tx_index': 3978627783721967, 'n': 80}], 'n': 4, 'tx_index': 3186847343455733, 'script': '76a9148377ee477ca434d16e231e4d310e1eeb34ad340288ac', 'addr': '1Cz9C4rCEAWiKWEh9d6UQgcAt6YKr8Ysds'}, {'type': 0, 'spent': False, 'value': 5000, 'spending_outpoints': [], 'n': 5, 'tx_index': 3186847343455733, 'script': '001437d77a5fa3783b0033ab5c24c404ef82d46abd5c', 'addr': 'bc1qxlth5har0qasqvattsjvgp80st2x402u5shuud'}, {'type': 0, 'spent': True, 'value': 684302, 'spending_outpoints': [{'tx_index': 296358827162119, 'n': 26}], 'n': 6, 'tx_index': 3186847343455733, 'script': 'a914796e425b800bfd82fbc9abcb54cc6051cf4a84a687', 'addr': '3Cm5mhWu2UzwhibwakrzffAqZdgPZKUTGt'}, {'type': 0, 'spent': True, 'value': 1243712, 'spending_outpoints': [{'tx_index': 1799440350713762, 'n': 29}], 'n': 7, 'tx_index': 3186847343455733, 'script': '00142398fc3e3ed03f50981ebb7fbb594b60f3ca2155', 'addr': 'bc1qywv0c0376ql4pxq7hdlmkk2tvreu5g246npl2q'}, {'type': 0, 'spent': True, 'value': 172710, 'spending_outpoints': [{'tx_index': 8166960723282814, 'n': 515}], 'n': 8, 'tx_index': 3186847343455733, 'script': '00147a956287f3856934e690a14d069b41cab84f8504', 'addr': 'bc1q022k9plns45nfe5s59xsdx6pe2uylpgy6c4ppc'}, {'type': 0, 'spent': True, 'value': 1483400, 'spending_outpoints': [{'tx_index': 4416385704031367, 'n': 85}], 'n': 9, 'tx_index': 3186847343455733, 'script': 'a914525dd8294f1499891fb86fa77604ab40b744605587', 'addr': '39CXkhJbpMMKMMsALbPaLMZVJqAF3hbMEd'}, {'type': 0, 'spent': True, 'value': 990000, 'spending_outpoints': [{'tx_index': 8731140713374179, 'n': 66}], 'n': 10, 'tx_index': 3186847343455733, 'script': 'a914351c5f365b1c6ec33687d9b896a5a3e88089e51387', 'addr': '36Xqj2VZAv9rB9qY2PaVsmLuc7ww4qT5Dd'}]",5000,1050000584228
dc1402961057fcecbe7c498a32e71ab8d10f28fed83382b6c4a73c5f39dce6bd,1,1,8,410,1313,3290,0.0.0.0,0,6681575516006292,False,1727059476,862463,862463,"[{'sequence': 4294967295, 'witness': '02473044022036aede1b39a3853ed1504ed4f8b44f33eeb61de7599b648b65ce766c0ae030ae02200276d8dd2e961a53ab04643927764ab6211d17fe015f5c2d38f661a7ea41efc8012102174ee672429ff94304321cdae1fc1e487edf658b34bd1d36da03761658a2bb09', 'script': '', 'index': 0, 'prev_out': {'type': 0, 'spent': True, 'value': 28905913, 'spending_outpoints': [{'tx_index': 6681575516006292, 'n': 0}], 'n': 0, 'tx_index': 5203278335589257, 'script': '0014dc6bf86354105de2fcd9868a2b0376d6731cb92f', 'addr': 'bc1qm34lsc65zpw79lxes69zkqmk6ee3ewf0j77s3h'}}]","[{'type': 0, 'spent': False, 'value': 668775, 'spending_outpoints': [], 'n': 0, 'tx_index': 6681575516006292, 'script': '0014018711db84866f14b87834108c11138af95c8354', 'addr': 'bc1qqxr3rkuyseh3fwrcxsggcygn3tu4eq65h3829k'}, {'type': 0, 'spent': True, 'value': 2224549, 'spending_outpoints': [{'tx_index': 5753927587745770, 'n': 73}], 'n': 1, 'tx_index': 6681575516006292, 'script': '0014dc6bf86354105de2fcd9868a2b0376d6731cb92f', 'addr': 'bc1qm34lsc65zpw79lxes69zkqmk6ee3ewf0j77s3h'}, {'type': 0, 'spent': True, 'value': 17990000, 'spending_outpoints': [{'tx_index': 8997436694264115, 'n': 3}], 'n': 2, 'tx_index': 6681575516006292, 'script': 'a91440955c39b5c2fcf9db496aa4eb78ce07ae810c1087', 'addr': '37aW6Z3sBug59V4ozqNVsDDwnei2inyaSd'}, {'type': 0, 'spent': False, 'value': 5000, 'spending_outpoints': [], 'n': 3, 'tx_index': 6681575516006292, 'script': '001437d77a5fa3783b0033ab5c24c404ef82d46abd5c', 'addr': 'bc1qxlth5har0qasqvattsjvgp80st2x402u5shuud'}, {'type': 0, 'spent': True, 'value': 54085, 'spending_outpoints': [{'tx_index': 4658586144079838, 'n': 46}], 'n': 4, 'tx_index': 6681575516006292, 'script': 'a9148db592b4ba2787a6a185dfdceef801e9f3bb246787', 'addr': '3EcJiWXfHEzRgNoBJd96GgTSUsaCHLVQtS'}, {'type': 0, 'spent': True, 'value': 117872, 'spending_outpoints': [{'tx_index': 7964714872766848, 'n': 90}], 'n': 5, 'tx_index': 6681575516006292, 'script': '0014f9283e3a5ea365464c9765353f82c6cccfd70453', 'addr': 'bc1qly5ruwj75dj5vnyhv56nlqkxen8awpznnk5kds'}, {'type': 0, 'spent': True, 'value': 7805743, 'spending_outpoints': [{'tx_index': 4755214674891565, 'n': 52}], 'n': 6, 'tx_index': 6681575516006292, 'script': '0014dd0d48612e7adb590d001610d21a028c7755ab7a', 'addr': 'bc1qm5x5scfw0td4jrgqzcgdyxsz33m4t2m6qqzp4z'}, {'type': 0, 'spent': True, 'value': 36599, 'spending_outpoints': [{'tx_index': 6687091089190988, 'n': 582}], 'n': 7, 'tx_index': 6681575516006292, 'script': '00144f7f53ed9e2040b25848e6553707775c3634d0ec', 'addr': 'bc1qfal48mv7ypqtykzgue2nwpmhtsmrf58vxymr0j'}]",5000,1050000579228
9084502a1e5d890fc6f92c413ee7d13aba18e32b1d9d23eb733167106e610476,1,1,11,520,1750,4818,0.0.0.0,0,4152357969595622,False,1726798289,862043,862043,"[{'sequence': 4294967295, 'witness': '02483045022100e2533208f4c3cd638f1561efbc9eaf92f680edfe663b2c0ee64536d79a5590ed02207e1ce355dcfd2bd0a094712eb629f5d29300bd95956494aef6452a73499b549d012102174ee672429ff94304321cdae1fc1e487edf658b34bd1d36da03761658a2bb09', 'script': '', 'index': 0, 'prev_out': {'type': 0, 'spent': True, 'value': 256384632, 'spending_outpoints': [{'tx_index': 4152357969595622, 'n': 0}], 'n': 0, 'tx_index': 5938604208907739, 'script': '0014dc6bf86354105de2fcd9868a2b0376d6731cb92f', 'addr': 'bc1qm34lsc65zpw79lxes69zkqmk6ee3ewf0j77s3h'}}]","[{'type': 0, 'spent': True, 'value': 71877, 'spending_outpoints': [{'tx_index': 5693349216363484, 'n': 0}], 'n': 0, 'tx_index': 4152357969595622, 'script': '76a914216aeed4d42f349c99128f03c532165f4ee4c4b388ac', 'addr': '143hQALYXmoHq3ykRpeGPd8rzZQRiPnNwD'}, {'type': 0, 'spent': True, 'value': 126160505, 'spending_outpoints': [{'tx_index': 1673573109638701, 'n': 0}], 'n': 1, 'tx_index': 4152357969595622, 'script': '0014dc6bf86354105de2fcd9868a2b0376d6731cb92f', 'addr': 'bc1qm34lsc65zpw79lxes69zkqmk6ee3ewf0j77s3h'}, {'type': 0, 'spent': True, 'value': 810000, 'spending_outpoints': [{'tx_index': 6463134598813275, 'n': 37}], 'n': 2, 'tx_index': 4152357969595622, 'script': '0014b2996ef1cdcab84b8d4d0e060a3cd8f3fb94a95f', 'addr': 'bc1qk2vkauwde2uyhr2dpcrq50xc70aef22l6g73jl'}, {'type': 0, 'spent': True, 'value': 160000, 'spending_outpoints': [{'tx_index': 2972883710566890, 'n': 367}], 'n': 3, 'tx_index': 4152357969595622, 'script': '00140aa1653a608bd651df12a584c990c7cd1a5afb53', 'addr': 'bc1qp2sk2wnq30t9rhcj5kzvnyx8e5d9476ntdrnhl'}, {'type': 0, 'spent': True, 'value': 135239, 'spending_outpoints': [{'tx_index': 7441708650045096, 'n': 15}], 'n': 4, 'tx_index': 4152357969595622, 'script': 'a914d42c8b808f0980e4cb4cb4db71ecc33f1073d86a87', 'addr': '3M2tYFKwcFE4MpGtqBTp1Mq3eRMve4trVu'}, {'type': 0, 'spent': True, 'value': 290000, 'spending_outpoints': [{'tx_index': 8544354864210989, 'n': 0}], 'n': 5, 'tx_index': 4152357969595622, 'script': '51209482ff8d75697453103101cb1d4f57b67766e29301c3c5d16f07eabaec6f2f74', 'addr': 'bc1pjjp0lrt4d969xyp3q8936n6hkemkdc5nq8put5t0ql4t4mr09a6qnyfqum'}, {'type': 0, 'spent': True, 'value': 66803, 'spending_outpoints': [{'tx_index': 2981625249457446, 'n': 194}], 'n': 6, 'tx_index': 4152357969595622, 'script': 'a91420de4c654211bbe70a2ee981a3f650b17e09718287', 'addr': '34gorFJHJVLaFSokEypV6bF53bPCMVEmUX'}, {'type': 0, 'spent': True, 'value': 124990000, 'spending_outpoints': [{'tx_index': 8065215531268104, 'n': 1}], 'n': 7, 'tx_index': 4152357969595622, 'script': 'a9141908f8fcc1b5d828f1e2d24e86256d9b65e380db87', 'addr': '33yPZmSz4mQahj4H4x5VmgupoXyTwn8kRh'}, {'type': 0, 'spent': False, 'value': 7000, 'spending_outpoints': [], 'n': 8, 'tx_index': 4152357969595622, 'script': '001437d77a5fa3783b0033ab5c24c404ef82d46abd5c', 'addr': 'bc1qxlth5har0qasqvattsjvgp80st2x402u5shuud'}, {'type': 0, 'spent': True, 'value': 160000, 'spending_outpoints': [{'tx_index': 1088829606171877, 'n': 0}], 'n': 9, 'tx_index': 4152357969595622, 'script': '00147edb77a9c42e7d26d2a1963def51f5f915f64591', 'addr': 'bc1q0mdh02wy9e7jd54pjc777504ly2lv3v3ae68mv'}, {'type': 0, 'spent': False, 'value': 3528390, 'spending_outpoints': [], 'n': 10, 'tx_index': 4152357969595622, 'script': '0014fc1d58f597c52104bb904924570187fd4243bc30', 'addr': 'bc1qlsw43avhc5ssfwusfyj9wqv8l4py80pskezjt3'}]",7000,1050000574228
8fdc5362585403f6fd51408e8128b26ba2c37cdd3ee0d9a1ea369050287fcbba,1,1,7,385,1210,3030,0.0.0.0,0,6572261583229446,False,1726709502,861913,861913,"[{'sequence': 4294967295, 'witness': '02483045022100d244fca5abf66c352a2bf939addc9df8c0d65f7f8d9d1bff8633ef44e101b29302200c0393ca53507d256777f672ba3099a616e9cab44d55d763f10b8a537e79c942012102174ee672429ff94304321cdae1fc1e487edf658b34bd1d36da03761658a2bb09', 'script': '', 'index': 0, 'prev_out': {'type': 0, 'spent': True, 'value': 2031280210, 'spending_outpoints': [{'tx_index': 6572261583229446, 'n': 0}], 'n': 0, 'tx_index': 6899190783798242, 'script': '0014dc6bf86354105de2fcd9868a2b0376d6731cb92f', 'addr': 'bc1qm34lsc65zpw79lxes69zkqmk6ee3ewf0j77s3h'}}]","[{'type': 0, 'spent': True, 'value': 1999990000, 'spending_outpoints': [{'tx_index': 2479724262579009, 'n': 4}], 'n': 0, 'tx_index': 6572261583229446, 'script': '76a9143c2378b1d43712dec0e578145f8798ed3437e44088ac', 'addr': '16Uz37Q6TfvK2UFTgamn3dyRjnP2Wtf4p2'}, {'type': 0, 'spent': True, 'value': 13863674, 'spending_outpoints': [{'tx_index': 1514390186733243, 'n': 40}], 'n': 1, 'tx_index': 6572261583229446, 'script': '0014dc6bf86354105de2fcd9868a2b0376d6731cb92f', 'addr': 'bc1qm34lsc65zpw79lxes69zkqmk6ee3ewf0j77s3h'}, {'type': 0, 'spent': True, 'value': 151383, 'spending_outpoints': [{'tx_index': 2990710382979297, 'n': 1}], 'n': 2, 'tx_index': 6572261583229446, 'script': '00141d48c4777bcfdf6da423daa945f14fdc9bfea64c', 'addr': 'bc1qr4yvgammel0kmfprm255tu20mjdlafjvs0ru74'}, {'type': 0, 'spent': True, 'value': 148123, 'spending_outpoints': [{'tx_index': 8321145383471438, 'n': 0}], 'n': 3, 'tx_index': 6572261583229446, 'script': 'a91450b5a122cd81282d697932c0bfdd89ea5d6322e087', 'addr': '393mZizFT3EjcmLBsxu2MohGrSFUaAkLNo'}, {'type': 0, 'spent': True, 'value': 15500000, 'spending_outpoints': [{'tx_index': 8919543055653782, 'n': 2}], 'n': 4, 'tx_index': 6572261583229446, 'script': '76a914fff76977145774246c67e36d8e73f5f4d508fe1f88ac', 'addr': '1QLRhQKRaL4mkN64zeVroSysSBtJBffCwJ'}, {'type': 0, 'spent': False, 'value': 7000, 'spending_outpoints': [], 'n': 5, 'tx_index': 6572261583229446, 'script': '001437d77a5fa3783b0033ab5c24c404ef82d46abd5c', 'addr': 'bc1qxlth5har0qasqvattsjvgp80st2x402u5shuud'}, {'type': 0, 'spent': True, 'value': 1617000, 'spending_outpoints': [{'tx_index': 5492138028062716, 'n': 0}], 'n': 6, 'tx_index': 6572261583229446, 'script': '00140d1125c5fb558604a099feac3f3da8a5be2cce9b', 'addr': 'bc1qp5gjt30m2krqfgyel6kr70dg5klzen5mfhvl4k'}]",7000,1050000567228
ae91ac597c0a3acb807741aafc9235b05d287b2afe632aa00f3d3fa519969629,1,1,10,498,1665,4170,0.0.0.0,0,1463255683082215,False,1726382370,861383,861383,"[{'sequence': 4294967295, 'witness': '0247304402204a4ff706752716b1e7868038b7fe078671c25422e59644ac38efd8f74295bd8102205cc29e9e7800adf104e03713aa908109dd8ace4a6dd10ec2856a361ec19e16a3012102174ee672429ff94304321cdae1fc1e487edf658b34bd1d36da03761658a2bb09', 'script': '', 'index': 0, 'prev_out': {'type': 0, 'spent': True, 'value': 110263099, 'spending_outpoints': [{'tx_index': 1463255683082215, 'n': 0}], 'n': 1, 'tx_index': 5922449785963678, 'script': '0014dc6bf86354105de2fcd9868a2b0376d6731cb92f', 'addr': 'bc1qm34lsc65zpw79lxes69zkqmk6ee3ewf0j77s3h'}}]","[{'type': 0, 'spent': True, 'value': 150000, 'spending_outpoints': [{'tx_index': 6753912393920340, 'n': 0}], 'n': 0, 'tx_index': 1463255683082215, 'script': '51208a29d56020622018cf484098fc23e6cca9c49839fe980c36085e19482601a02b', 'addr': 'bc1p3g5a2cpqvgsp3n6ggzv0cglxej5ufxpel6vqcdsgtcv5sfsp5q4su4gtnz'}, {'type': 0, 'spent': True, 'value': 84622109, 'spending_outpoints': [{'tx_index': 7873732979956833, 'n': 0}], 'n': 1, 'tx_index': 1463255683082215, 'script': '0014dc6bf86354105de2fcd9868a2b0376d6731cb92f', 'addr': 'bc1qm34lsc65zpw79lxes69zkqmk6ee3ewf0j77s3h'}, {'type': 0, 'spent': True, 'value': 316846, 'spending_outpoints': [{'tx_index': 4468851440328243, 'n': 29}], 'n': 2, 'tx_index': 1463255683082215, 'script': 'a9147bbe44b639828a182b7c85f176fd507a3bf31ae487', 'addr': '3CyJyDgZsfXrrAMquhV6Uy1fqMmVvR6aQ3'}, {'type': 0, 'spent': True, 'value': 1856052, 'spending_outpoints': [{'tx_index': 1603419514404331, 'n': 15}], 'n': 3, 'tx_index': 1463255683082215, 'script': '0014ea4a530594a323c7cc6a6096e6eda0a99233a560', 'addr': 'bc1qaf99xpv55v3u0nr2vztwdmdq4xfr8ftqj3tm90'}, {'type': 0, 'spent': True, 'value': 45630, 'spending_outpoints': [{'tx_index': 535195692004392, 'n': 0}], 'n': 4, 'tx_index': 1463255683082215, 'script': '001438db42464cbe827d3562374b66f38084a86a0431', 'addr': 'bc1q8rd5y3jvh6p86dtzxa9kduuqsj5x5pp3lc2ead'}, {'type': 0, 'spent': True, 'value': 50000, 'spending_outpoints': [{'tx_index': 7075055576317086, 'n': 0}], 'n': 5, 'tx_index': 1463255683082215, 'script': '5120fc8152ee79bed6adc947cac7e74ffbec8661cfa90ffac367adc8030a726a783a', 'addr': 'bc1pljq49mnehmt2mj28etr7wnlmajrxrnafplavxeadeqps5un20qaqhgm6z3'}, {'type': 0, 'spent': False, 'value': 5000, 'spending_outpoints': [], 'n': 6, 'tx_index': 1463255683082215, 'script': '001437d77a5fa3783b0033ab5c24c404ef82d46abd5c', 'addr': 'bc1qxlth5har0qasqvattsjvgp80st2x402u5shuud'}, {'type': 0, 'spent': True, 'value': 20000000, 'spending_outpoints': [{'tx_index': 6575147043250425, 'n': 50}], 'n': 7, 'tx_index': 1463255683082215, 'script': '76a91481b0f3f2ec7f5079cf903c120b2b2221c8e124f688ac', 'addr': '1Cpk9ekjHkWQr9yePgyLR3pu4jURaejitm'}, {'type': 0, 'spent': True, 'value': 123292, 'spending_outpoints': [{'tx_index': 934598690968533, 'n': 135}], 'n': 8, 'tx_index': 1463255683082215, 'script': '0014529dbed4ea025470fa1711f599808718e1497f88', 'addr': 'bc1q22wma482qf28p7shz86enqy8rrs5jluggy2yd7'}, {'type': 0, 'spent': True, 'value': 3090000, 'spending_outpoints': [{'tx_index': 775423502292735, 'n': 5}], 'n': 9, 'tx_index': 1463255683082215, 'script': '00148d8e68933d2617d9eae339f9e49241d3d1e29b0d', 'addr': 'bc1q3k8x3yeayctan6hr88u7fyjp60g79xcdlaar7x'}]",5000,1050000560228
4169d87d6fd3f485a9250b2c0e648d7108a38fe7c4a316a7c85656a2e18c3199,2,1,2,298,865,6976,0.0.0.0,0,5390019073428170,False,1721940584,853912,853912,"[{'sequence': 4294967295, 'witness': '02473044022005ae19490ac19af12007c9f55d06cdb9f3e0c93022afe5711a9cc42b3bc49fc30220011b033319c9b2f53584fc6ba8c05a060d4f7be9227b361d57c5a88ce399cdab012103141bfd3a7e0f60784b180e7be0b9f456f8b68d6a882a09332971c969cf49f4ca', 'script': '1600145c11976f8150bf08df66f6d3a3bc638fd8382415', 'index': 0, 'prev_out': {'type': 0, 'spent': True, 'value': 69176, 'spending_outpoints': [{'tx_index': 5390019073428170, 'n': 0}], 'n': 734, 'tx_index': 5470658329619689, 'script': 'a91460cbd833e5699796b61ff0eb498a6369d8db173587', 'addr': '3AWpzKtkHfWsiv9RGXKA3Z8951LefsUGXQ'}}]","[{'type': 0, 'spent': False, 'value': 62200, 'spending_outpoints': [], 'n': 0, 'tx_index': 5390019073428170, 'script': '001437d77a5fa3783b0033ab5c24c404ef82d46abd5c', 'addr': 'bc1qxlth5har0qasqvattsjvgp80st2x402u5shuud'}, {'type': 0, 'spent': False, 'value': 0, 'spending_outpoints': [], 'n': 1, 'tx_index': 5390019073428170, 'script': '6a497468726f756768203132323862746340676d61696c2e636f6d20746f2064697363757373207468652072657475726e206f6620617373657420616e6420796f7572207265776172642e'}]",62200,1050000555228
6c2aa746686f35ce5dfc9d2f6a5751c56a6d1287f5564b63f76f4fdd209a735a,1,1,2,297,861,6976,0.0.0.0,853907,3182481714686445,False,1721938646,853908,853908,"[{'sequence': 4294967295, 'witness': '02473044022040bb41175e8949ecccd8aed1bbae83a643e1a24b344abf187d41ad9fc57b800202205c766303ad212a1859b4fc99b84acdcc71bf670b53c2e6818b1f239bc385fb45012103141bfd3a7e0f60784b180e7be0b9f456f8b68d6a882a09332971c969cf49f4ca', 'script': '1600145c11976f8150bf08df66f6d3a3bc638fd8382415', 'index': 0, 'prev_out': {'type': 0, 'spent': True, 'value': 69176, 'spending_outpoints': [{'tx_index': 3182481714686445, 'n': 0}], 'n': 731, 'tx_index': 5470658329619689, 'script': 'a91460cbd833e5699796b61ff0eb498a6369d8db173587', 'addr': '3AWpzKtkHfWsiv9RGXKA3Z8951LefsUGXQ'}}]","[{'type': 0, 'spent': False, 'value': 62200, 'spending_outpoints': [], 'n': 0, 'tx_index': 3182481714686445, 'script': '001437d77a5fa3783b0033ab5c24c404ef82d46abd5c', 'addr': 'bc1qxlth5har0qasqvattsjvgp80st2x402u5shuud'}, {'type': 0, 'spent': False, 'value': 0, 'spending_outpoints': [], 'n': 1, 'tx_index': 3182481714686445, 'script': '6a484d53472066726f6d204c422e20546f207468652077686974656861742077686f20697320736176696e67206f75722061737365742c20796f752063616e20636f6e74616374207573'}]",62200,1050000493028
6fb6c8491525011229f0d3ddf98b1e3d4a061f80ddeb30b2b1c267b66b5e4480,2,21,1,3151,5857,41454,0.0.0.0,848978,4512996167961848,False,1719025032,848979,848979,"[{'sequence': 4294967293, 'witness': '0247304402203cd09b903addbe156736a2ed55cc621e7d915fdc20b5c07017f026fe6adf87b502207aae15684cdbd57890f21b5b6ac43554ae9347a5babaa5935ff21e273e555ecf0121033099b1a2eb0eca2af8b35bf3adcfc88ee25c0b3d05df47c184b552576df6e158', 'script': '', 'index': 0, 'prev_out': {'type': 0, 'spent': True, 'value': 122820, 'spending_outpoints': [{'tx_index': 4512996167961848, 'n': 0}], 'n': 0, 'tx_index': 7976245934819532, 'script': '0014bb5e3a5af1e1777ee3cdcd0e06a86d49ab6b30f5', 'addr': 'bc1qhd0r5kh3u9mhac7de58qd2rdfx4kkv84kpx302'}}, {'sequence': 4294967293, 'witness': '02473044022069fb588f7f5b00ce80414c7eda816f8be9114df7c7af722f98c50dddb258da28022044e4614837ea748320f29eedf9b49978f8b790046ca4ce89902d8849d6984a5f0121033099b1a2eb0eca2af8b35bf3adcfc88ee25c0b3d05df47c184b552576df6e158', 'script': '', 'index': 1, 'prev_out': {'type': 0, 'spent': True, 'value': 600, 'spending_outpoints': [{'tx_index': 4512996167961848, 'n': 1}], 'n': 0, 'tx_index': 8588416478900929, 'script': '0014bb5e3a5af1e1777ee3cdcd0e06a86d49ab6b30f5', 'addr': 'bc1qhd0r5kh3u9mhac7de58qd2rdfx4kkv84kpx302'}}, {'sequence': 4294967293, 'witness': '02473044022050ed066a14e170cd43ad63c08f9db1932d4454789069b08b62cfffc5823874e10220640de432b515929b57de456cf505a298b5a881c09eeaa57de79d70216a773c490121033099b1a2eb0eca2af8b35bf3adcfc88ee25c0b3d05df47c184b552576df6e158', 'script': '', 'index': 2, 'prev_out': {'type': 0, 'spent': True, 'value': 300000, 'spending_outpoints': [{'tx_index': 4512996167961848, 'n': 2}], 'n': 0, 'tx_index': 7133128030022215, 'script': '0014bb5e3a5af1e1777ee3cdcd0e06a86d49ab6b30f5', 'addr': 'bc1qhd0r5kh3u9mhac7de58qd2rdfx4kkv84kpx302'}}, {'sequence': 4294967293, 'witness': '0247304402204208f27a9c48694258f98b9e56a608ba975052bd11cd383bf66aae795633b94102202bf6bbce225236cb0b98d5c6efdc46633bad587c8abc4b9506008a7ef55748590121033099b1a2eb0eca2af8b35bf3adcfc88ee25c0b3d05df47c184b552576df6e158', 'script': '', 'index': 3, 'prev_out': {'type': 0, 'spent': True, 'value': 546, 'spending_outpoints': [{'tx_index': 4512996167961848, 'n': 3}], 'n': 0, 'tx_index': 2008057231219315, 'script': '0014bb5e3a5af1e1777ee3cdcd0e06a86d49ab6b30f5', 'addr': 'bc1qhd0r5kh3u9mhac7de58qd2rdfx4kkv84kpx302'}}, {'sequence': 4294967293, 'witness': '02473044022045bc337de17ec7124efb7e436ddb9cb3092c4e106cd51fd86f246be6acadd803022068954885df7a63d63bb38463b5e990645434fa0c5beee82e6c9a7911de4fb5e50121033099b1a2eb0eca2af8b35bf3adcfc88ee25c0b3d05df47c184b552576df6e158', 'script': '', 'index': 4, 'prev_out': {'type': 0, 'spent': True, 'value': 122820, 'spending_outpoints': [{'tx_index': 4512996167961848, 'n': 4}], 'n': 0, 'tx_index': 1040887141013628, 'script': '0014bb5e3a5af1e1777ee3cdcd0e06a86d49ab6b30f5', 'addr': 'bc1qhd0r5kh3u9mhac7de58qd2rdfx4kkv84kpx302'}}, {'sequence': 4294967293, 'witness': '024730440220746092eb059ff08f34f093628e039ec5e768d840b3300f26c696365c6b54d060022011fb443da368fc338aa77eb187d50d36b2859780f98780774eadb83e40dd44d30121033099b1a2eb0eca2af8b35bf3adcfc88ee25c0b3d05df47c184b552576df6e158', 'script': '', 'index': 5, 'prev_out': {'type': 0, 'spent': True, 'value': 547, 'spending_outpoints': [{'tx_index': 4512996167961848, 'n': 5}], 'n': 98, 'tx_index': 2725275799842907, 'script': '0014bb5e3a5af1e1777ee3cdcd0e06a86d49ab6b30f5', 'addr': 'bc1qhd0r5kh3u9mhac7de58qd2rdfx4kkv84kpx302'}}, {'sequence': 4294967293, 'witness': '0247304402202df800b3a83c32033e7da2dd517c16fa89c05fb35e27d6586d35024ea017ee4c022013b2854facfc983fe9b70c6ee75918533175969364f992767943180047feb2de0121033099b1a2eb0eca2af8b35bf3adcfc88ee25c0b3d05df47c184b552576df6e158', 'script': '', 'index': 6, 'prev_out': {'type': 0, 'spent': True, 'value': 1869, 'spending_outpoints': [{'tx_index': 4512996167961848, 'n': 6}], 'n': 0, 'tx_index': 2731947028889825, 'script': '0014bb5e3a5af1e1777ee3cdcd0e06a86d49ab6b30f5', 'addr': 'bc1qhd0r5kh3u9mhac7de58qd2rdfx4kkv84kpx302'}}, {'sequence': 4294967293, 'witness': '02473044022063ed1075484d94e24b7eb3583fc95d2bfea6478a699644df2ed92cd2f7fe86eb022033e103a100aa54e23ee2c33444f01bccc2aa0d067be8737a3951cf7423aed5890121033099b1a2eb0eca2af8b35bf3adcfc88ee25c0b3d05df47c184b552576df6e158', 'script': '', 'index': 7, 'prev_out': {'type': 0, 'spent': True, 'value': 547, 'spending_outpoints': [{'tx_index': 4512996167961848, 'n': 7}], 'n': 497, 'tx_index': 7611831489589906, 'script': '0014bb5e3a5af1e1777ee3cdcd0e06a86d49ab6b30f5', 'addr': 'bc1qhd0r5kh3u9mhac7de58qd2rdfx4kkv84kpx302'}}, {'sequence': 4294967293, 'witness': '0247304402200ad6f90f661ee4931c333510e92fa80f2043ce0e2e384246e7f644054a453db70220691626839b1fb29f094e8dedce82061255d24abadd22e556b08c625c5c5b81720121033099b1a2eb0eca2af8b35bf3adcfc88ee25c0b3d05df47c184b552576df6e158', 'script': '', 'index': 8, 'prev_out': {'type': 0, 'spent': True, 'value': 547, 'spending_outpoints': [{'tx_index': 4512996167961848, 'n': 8}], 'n': 274, 'tx_index': 2897969703404089, 'script': '0014bb5e3a5af1e1777ee3cdcd0e06a86d49ab6b30f5', 'addr': 'bc1qhd0r5kh3u9mhac7de58qd2rdfx4kkv84kpx302'}}, {'sequence': 4294967293, 'witness': '0247304402204d501c419365f86fea7a9d7bde80bc5567512ede787fd7ad49bad4187e49b93a0220626e8633390f1f59fc1fd728faa42cb46a5b67c2e68169a3be53077431d5b09e0121033099b1a2eb0eca2af8b35bf3adcfc88ee25c0b3d05df47c184b552576df6e158', 'script': '', 'index': 9, 'prev_out': {'type': 0, 'spent': True, 'value': 547, 'spending_outpoints': [{'tx_index': 4512996167961848, 'n': 9}], 'n': 144, 'tx_index': 7823182823832643, 'script': '0014bb5e3a5af1e1777ee3cdcd0e06a86d49ab6b30f5', 'addr': 'bc1qhd0r5kh3u9mhac7de58qd2rdfx4kkv84kpx302'}}, {'sequence': 4294967293, 'witness': '0247304402207ce085b025342cf1ffee089a32d92e05e5a2b147a11b0a248ac8dc0c30c09b630220118679df33d3aa5720f1a2297990dcfbd8c0465aca9266e466f507c17ef765660121033099b1a2eb0eca2af8b35bf3adcfc88ee25c0b3d05df47c184b552576df6e158', 'script': '', 'index': 10, 'prev_out': {'type': 0, 'spent': True, 'value': 547, 'spending_outpoints': [{'tx_index': 4512996167961848, 'n': 10}], 'n': 127, 'tx_index': 7702755145837247, 'script': '0014bb5e3a5af1e1777ee3cdcd0e06a86d49ab6b30f5', 'addr': 'bc1qhd0r5kh3u9mhac7de58qd2rdfx4kkv84kpx302'}}, {'sequence': 4294967293, 'witness': '0247304402201cfeaeb533db109e23fdd7a3f0ded3a13ea00abaca3b00a035ba04942da1fb0d02205d88d40d4730a5a7e318076662e2027f72384519a9861b9c9edd5e1b31686cc70121033099b1a2eb0eca2af8b35bf3adcfc88ee25c0b3d05df47c184b552576df6e158', 'script': '', 'index': 11, 'prev_out': {'type': 0, 'spent': True, 'value': 546, 'spending_outpoints': [{'tx_index': 4512996167961848, 'n': 11}], 'n': 0, 'tx_index': 6553233689341311, 'script': '0014bb5e3a5af1e1777ee3cdcd0e06a86d49ab6b30f5', 'addr': 'bc1qhd0r5kh3u9mhac7de58qd2rdfx4kkv84kpx302'}}, {'sequence': 4294967293, 'witness': '0247304402204f7b377ac54eb7e2fc71bc7dffe3efec1993d088aa60fbf91db289a4f87bbeda022021334a81d80277267ab7e67e09de5e384e6c7a16f6a9aa5127eae517241768600121033099b1a2eb0eca2af8b35bf3adcfc88ee25c0b3d05df47c184b552576df6e158', 'script': '', 'index': 12, 'prev_out': {'type': 0, 'spent': True, 'value': 547, 'spending_outpoints': [{'tx_index': 4512996167961848, 'n': 12}], 'n': 209, 'tx_index': 7957391761384453, 'script': '0014bb5e3a5af1e1777ee3cdcd0e06a86d49ab6b30f5', 'addr': 'bc1qhd0r5kh3u9mhac7de58qd2rdfx4kkv84kpx302'}}, {'sequence': 4294967293, 'witness': '02473044022028a9bc40b5ecb621e707bc82d9bf2f41682114d2636f2405859b184fa7b025e702205ec3e7b9394dac77af67ca3a3bab9450730c76faef7fab1f03d5beaab709fbcf0121033099b1a2eb0eca2af8b35bf3adcfc88ee25c0b3d05df47c184b552576df6e158', 'script': '', 'index': 13, 'prev_out': {'type': 0, 'spent': True, 'value': 546, 'spending_outpoints': [{'tx_index': 4512996167961848, 'n': 13}], 'n': 0, 'tx_index': 5950595176209471, 'script': '0014bb5e3a5af1e1777ee3cdcd0e06a86d49ab6b30f5', 'addr': 'bc1qhd0r5kh3u9mhac7de58qd2rdfx4kkv84kpx302'}}, {'sequence': 4294967293, 'witness': '0247304402201ebd7a2d0bf73333bea8962ce0af7e28fe35e5f74956563191665a957d44e4870220502dcaaf59af5ba67e0015ba9badc18fe2ce243d6e7bcef8e13365c349bd19bd0121033099b1a2eb0eca2af8b35bf3adcfc88ee25c0b3d05df47c184b552576df6e158', 'script': '', 'index': 14, 'prev_out': {'type': 0, 'spent': True, 'value': 1049999906520, 'spending_outpoints': [{'tx_index': 4512996167961848, 'n': 14}], 'n': 0, 'tx_index': 1698802300015904, 'script': '0014bb5e3a5af1e1777ee3cdcd0e06a86d49ab6b30f5', 'addr': 'bc1qhd0r5kh3u9mhac7de58qd2rdfx4kkv84kpx302'}}, {'sequence': 4294967293, 'witness': '02473044022054a8c7cb6a1b44e2d17fb42aaa44f15802c9a1bc4370c796403949cc7840c9ea022034c6a8a85f7f8fdeec5cff3e7ec896202eb1950246eb6667b3d109d2304704810121033099b1a2eb0eca2af8b35bf3adcfc88ee25c0b3d05df47c184b552576df6e158', 'script': '', 'index': 15, 'prev_out': {'type': 0, 'spent': True, 'value': 10000, 'spending_outpoints': [{'tx_index': 4512996167961848, 'n': 15}], 'n': 39, 'tx_index': 7942661268779120, 'script': '0014bb5e3a5af1e1777ee3cdcd0e06a86d49ab6b30f5', 'addr': 'bc1qhd0r5kh3u9mhac7de58qd2rdfx4kkv84kpx302'}}, {'sequence': 4294967293, 'witness': '0247304402207eba31dbb92044d3a509da72cd85426c17bd2a5557ba531d589220c926953e3102202ec3a6cf59e0a1d2aa938b19cb21c1e3782d0eccbc2e904474bab41fc4a34b480121033099b1a2eb0eca2af8b35bf3adcfc88ee25c0b3d05df47c184b552576df6e158', 'script': '', 'index': 16, 'prev_out': {'type': 0, 'spent': True, 'value': 546, 'spending_outpoints': [{'tx_index': 4512996167961848, 'n': 16}], 'n': 100, 'tx_index': 1408385034882235, 'script': '0014bb5e3a5af1e1777ee3cdcd0e06a86d49ab6b30f5', 'addr': 'bc1qhd0r5kh3u9mhac7de58qd2rdfx4kkv84kpx302'}}, {'sequence': 4294967293, 'witness': '0247304402200350264fb293c0e836904506edfae2b90791803c172f967020da4505f739352102201fdb8cf048c1bc7a1624960bbe3c62429dd575ca091c5bd8bdea269ee0e1e25f0121033099b1a2eb0eca2af8b35bf3adcfc88ee25c0b3d05df47c184b552576df6e158', 'script': '', 'index': 17, 'prev_out': {'type': 0, 'spent': True, 'value': 547, 'spending_outpoints': [{'tx_index': 4512996167961848, 'n': 17}], 'n': 263, 'tx_index': 229103650152418, 'script': '0014bb5e3a5af1e1777ee3cdcd0e06a86d49ab6b30f5', 'addr': 'bc1qhd0r5kh3u9mhac7de58qd2rdfx4kkv84kpx302'}}, {'sequence': 4294967293, 'witness': '02473044022037b2f00c55e62898ee35404823f0a0c938e1090c44d68270c1f352ffb12427f80220299949d5eaa853c51e7f65614a3d7e50d86b18171411fe3ea44509c402ea493b0121033099b1a2eb0eca2af8b35bf3adcfc88ee25c0b3d05df47c184b552576df6e158', 'script': '', 'index': 18, 'prev_out': {'type': 0, 'spent': True, 'value': 547, 'spending_outpoints': [{'tx_index': 4512996167961848, 'n': 18}], 'n': 202, 'tx_index': 3264423527876666, 'script': '0014bb5e3a5af1e1777ee3cdcd0e06a86d49ab6b30f5', 'addr': 'bc1qhd0r5kh3u9mhac7de58qd2rdfx4kkv84kpx302'}}, {'sequence': 4294967293, 'witness': '02473044022079b54141d7b516d8dbd7ac0991edb09b664d9c9f598f402dfb3818616497ca49022010b3f6f2dbb29edebdf9ba600ef64dbb05ae107ebcb928fc377bb48838cacd720121033099b1a2eb0eca2af8b35bf3adcfc88ee25c0b3d05df47c184b552576df6e158', 'script': '', 'index': 19, 'prev_out': {'type': 0, 'spent': True, 'value': 546, 'spending_outpoints': [{'tx_index': 4512996167961848, 'n': 19}], 'n': 0, 'tx_index': 7879814885297731, 'script': '0014bb5e3a5af1e1777ee3cdcd0e06a86d49ab6b30f5', 'addr': 'bc1qhd0r5kh3u9mhac7de58qd2rdfx4kkv84kpx302'}}, {'sequence': 4294967293, 'witness': '0247304402206e86a378ab864b4854ad45883164db7b3e94c4d1dcbe25702eb6ff15c2938d3c02204deb725419d76062d31409b3003ffbc6212605fd7fae25149ae8cb1103aeb8950121033099b1a2eb0eca2af8b35bf3adcfc88ee25c0b3d05df47c184b552576df6e158', 'script': '', 'index': 20, 'prev_out': {'type': 0, 'spent': True, 'value': 547, 'spending_outpoints': [{'tx_index': 4512996167961848, 'n': 20}], 'n': 19, 'tx_index': 4361574662021994, 'script': '0014bb5e3a5af1e1777ee3cdcd0e06a86d49ab6b30f5', 'addr': 'bc1qhd0r5kh3u9mhac7de58qd2rdfx4kkv84kpx302'}}]","[{'type': 0, 'spent': False, 'value': 1050000430828, 'spending_outpoints': [], 'n': 0, 'tx_index': 4512996167961848, 'script': '001437d77a5fa3783b0033ab5c24c404ef82d46abd5c', 'addr': 'bc1qxlth5har0qasqvattsjvgp80st2x402u5shuud'}]",1050000430828,1050000430828
