hash,ver,vin_sz,vout_sz,size,weight,fee,relayed_by,lock_time,tx_index,double_spend,time,block_index,block_height,inputs,out,result,balance
a3cd1f31e2747f1850c83063340df1c06311a776c1acb5f3ec65af8c2bcd7101,2,2,2,371,833,624,0.0.0.0,0,50825123698156,False,1731221587,869673,869673,"[{'sequence': 2147483649, 'witness': '02473044022055e8fc0d2d4efbe983a74644ebdec642926ab5eb779df88fb457963f52c511cb02207eea54731d42c7542319567b57d1b8af3598a84e7cdd818d92b8832adf47ad45012102dc771f5ea6797389374d0f5a4c498bc4fd16d86783f6ff0fde1b70a8dbcb558b', 'script': '', 'index': 0, 'prev_out': {'type': 0, 'spent': True, 'value': 330, 'spending_outpoints': [{'tx_index': 50825123698156, 'n': 0}], 'n': 0, 'tx_index': 4907908689241855, 'script': '0014f881d18dfae68fe5daa64f26898e4a0c199becb0', 'addr': 'bc1qlzqarr06u687tk4xfungnrj2psvehm9ske2pyg'}}, {'sequence': 2147483649, 'witness': '02483045022100819a2edc9ca07d4c1ac791c878adde6a5dc9de25019a81e2b14efb0f904505e50220124472b124a3a4f89d313d5da5fc1a43220c8decf7a591f1203317ae5177ee25012102dc771f5ea6797389374d0f5a4c498bc4fd16d86783f6ff0fde1b70a8dbcb558b', 'script': '', 'index': 1, 'prev_out': {'type': 0, 'spent': True, 'value': 55725, 'spending_outpoints': [{'tx_index': 50825123698156, 'n': 1}], 'n': 1, 'tx_index': 2935306039504702, 'script': '0014f881d18dfae68fe5daa64f26898e4a0c199becb0', 'addr': 'bc1qlzqarr06u687tk4xfungnrj2psvehm9ske2pyg'}}]","[{'type': 0, 'spent': False, 'value': 546, 'spending_outpoints': [], 'n': 0, 'tx_index': 50825123698156, 'script': '0014caa7e5d6f5f7e31c744dfa7afb8a145a6d98d1a2', 'addr': 'bc1qe2n7t4h47l33cazdlfa0hzs5tfke35dzj6tzuy'}, {'type': 0, 'spent': True, 'value': 54885, 'spending_outpoints': [{'tx_index': 3003266740954451, 'n': 1}], 'n': 1, 'tx_index': 50825123698156, 'script': '0014f881d18dfae68fe5daa64f26898e4a0c199becb0', 'addr': 'bc1qlzqarr06u687tk4xfungnrj2psvehm9ske2pyg'}]",546,2373282398935
b9fd9dca373bf21b30cbc4ba06bda6a2d8ae92951df5b51815a91227b7f0768a,1,1,1,191,437,792,0.0.0.0,0,4871790377886293,False,1726850197,862144,862144,"[{'sequence': 4294967295, 'witness': '024730440220658da034e8680ae7936b2956393097ca28ea8cdbab99dd9b443929cf51a519e90220127a21b000e8bd863aaca4c4eb38b35c2e83e45f92bc123f8e68e466e681dce101210277ddb33af397fb47a88ea2835087f4d8ab766bcc523cbffba51c46b42a74d824', 'script': '', 'index': 0, 'prev_out': {'type': 0, 'spent': True, 'value': 25020937738, 'spending_outpoints': [{'tx_index': 4871790377886293, 'n': 0}], 'n': 1, 'tx_index': 7638526170158418, 'script': '0014be901ff6f6c8a94e18c06bd95aba6c22e0fa5adc', 'addr': 'bc1qh6gplahkez55uxxqd0v44wnvyts05kkuvagrar'}}]","[{'type': 0, 'spent': False, 'value': 25020936946, 'spending_outpoints': [], 'n': 0, 'tx_index': 4871790377886293, 'script': '0014caa7e5d6f5f7e31c744dfa7afb8a145a6d98d1a2', 'addr': 'bc1qe2n7t4h47l33cazdlfa0hzs5tfke35dzj6tzuy'}]",25020936946,2373282398389
52781230c10ad8c316c68ebdb4db66abdc4db5172c74845f4e8c8caea63390dc,2,5,2,815,1646,2048,0.0.0.0,0,7760380798816657,False,1726655129,861829,861829,"[{'sequence': 0, 'witness': '0247304402201d5e3941fd209a68efdc86bfe0a16d49c44f41b12ee6ad4a9cf642a6edcb9a9a0220660fb41932f43605a67fcc6bd29fc3a9b30daf5603c0d513ec9d7c987202942101210366a7a641a0de84e0eef337281ec55f6fd1be8355345d91b48e97fc1908e3f868', 'script': '', 'index': 0, 'prev_out': {'type': 0, 'spent': True, 'value': 1230000000, 'spending_outpoints': [{'tx_index': 7760380798816657, 'n': 0}], 'n': 0, 'tx_index': 3558236753500299, 'script': '0014c9ed4fcd12708a136cba7b74a38fed88fe63a163', 'addr': 'bc1qe8k5lngjwz9pxm960d628rld3rlx8gtr7wd5t2'}}, {'sequence': 0, 'witness': '024730440220311613d1d27cacc126b8f4f7bb0dd9ca4509b4c5ed14cb1845e6221b85924d4502200c80dc0776af3a9217d7eac01cecf860ef0e9465bcf3abace72187ad5e6dff2c0121026781b95e58c10eac4dc974599b786ab0269e9d5167cf6e3a2553ce3292b5c083', 'script': '', 'index': 1, 'prev_out': {'type': 0, 'spent': True, 'value': 310000, 'spending_outpoints': [{'tx_index': 7760380798816657, 'n': 1}], 'n': 5, 'tx_index': 7794850248755919, 'script': '00140d847cb5b028a33c45572e0ba0ccbd5e2b77f117', 'addr': 'bc1qpkz8edds9z3nc32h9c96pn9atc4h0ughm6ns3m'}}, {'sequence': 0, 'witness': '0247304402207c481745d3a52d126951fa2a7207153d50450ebdfe3aad79f6de324270f2003202203a63e69ae208b4e36f5ff1fc32fb36e597a0b8ae9b488f8e7abdfe77bd684d040121035786a5659221010bf6c4d6508a01f91e56217383627ffdc53ced54638ca3addc', 'script': '', 'index': 2, 'prev_out': {'type': 0, 'spent': True, 'value': 6994875591, 'spending_outpoints': [{'tx_index': 7760380798816657, 'n': 2}], 'n': 1, 'tx_index': 701705427651979, 'script': '0014f15e33bff2b935636f68002c6066384c0814c1e2', 'addr': 'bc1q790r80ljhy6kxmmgqqkxqe3cfsypfs0zsz6z5j'}}, {'sequence': 0, 'witness': '02483045022100f3f61cfefbbdb2d34e08a49e41b6328fc2d0c6281496ec438a1e788df33bf28b022055d050198551cf79589e8f8fff625446842864136c892240d01a9f561b7831f7012102f1294029b52a78a5d9442fe9140f6358a04bc8d65abafa23705e2e97336ab8ec', 'script': '', 'index': 3, 'prev_out': {'type': 0, 'spent': True, 'value': 1829994, 'spending_outpoints': [{'tx_index': 7760380798816657, 'n': 3}], 'n': 1, 'tx_index': 6706446141676310, 'script': '00143cab929875d985bc872d8abc42b6558ef81e9423', 'addr': 'bc1q8j4e9xr4mxzmeped327y9dj43mupa9prfum6c8'}}, {'sequence': 0, 'witness': '0247304402201f7b431abc7f85f621741d3b65329786d5633247fb38aecdc0277be9165fcf4f022049c65b8b805e2a57c89c8ba594664ebdebf3cfa07946362c80cc61465d3988d30121026781b95e58c10eac4dc974599b786ab0269e9d5167cf6e3a2553ce3292b5c083', 'script': '', 'index': 4, 'prev_out': {'type': 0, 'spent': True, 'value': 10513021269, 'spending_outpoints': [{'tx_index': 7760380798816657, 'n': 4}], 'n': 1, 'tx_index': 444340771009332, 'script': '00140d847cb5b028a33c45572e0ba0ccbd5e2b77f117', 'addr': 'bc1qpkz8edds9z3nc32h9c96pn9atc4h0ughm6ns3m'}}]","[{'type': 0, 'spent': False, 'value': 10497239000, 'spending_outpoints': [], 'n': 0, 'tx_index': 7760380798816657, 'script': '0014caa7e5d6f5f7e31c744dfa7afb8a145a6d98d1a2', 'addr': 'bc1qe2n7t4h47l33cazdlfa0hzs5tfke35dzj6tzuy'}, {'type': 0, 'spent': True, 'value': 8242795806, 'spending_outpoints': [{'tx_index': 7086567401320034, 'n': 0}], 'n': 1, 'tx_index': 7760380798816657, 'script': '0014d4ecb20cadb6e2ea3b987126ed1f607dd063808a', 'addr': 'bc1q6nktyr9dkm3w5wucwynw68mq0hgx8qy23tavr3'}]",10497239000,2348261461443
af9797cc0b8a9bd496cc2088b62dd2f16893c72453bc4852adb0d8d65fd19bbe,2,3,2,520,1105,1098,0.0.0.0,0,6706446141676310,False,1726581705,861707,861707,"[{'sequence': 0, 'witness': '02483045022100a472583331e83e35e9c46a6ce0a30f8eaeeb1f501b2599c9684c79e9f0a4edf702207079de9b392d9662d9dfb5a33b62eb4cd2195b44a5371885e1ec8a8a88b5dd910121030d0ab362b48abdcaa659d8f1e2152e0ca4fa418b39b05236c74746762f57c940', 'script': '', 'index': 0, 'prev_out': {'type': 0, 'spent': True, 'value': 546, 'spending_outpoints': [{'tx_index': 6706446141676310, 'n': 0}], 'n': 0, 'tx_index': 8481144476678495, 'script': '0014ec7abc3bf242e7708ad81b82c2b8ac6427ddbb7a', 'addr': 'bc1qa3atcwljgtnhpzkcrwpv9w9vvsnamwm6annd4u'}}, {'sequence': 0, 'witness': '0247304402204a16305f00d80b1b5f92e4e342d222c4eb161394d069dd85e1af31ac6305967d0220098cc81f7e6b0dad750581b1807261cb45e311828b4f1fb8e317baa2461dccb80121030d0ab362b48abdcaa659d8f1e2152e0ca4fa418b39b05236c74746762f57c940', 'script': '', 'index': 1, 'prev_out': {'type': 0, 'spent': True, 'value': 546, 'spending_outpoints': [{'tx_index': 6706446141676310, 'n': 1}], 'n': 0, 'tx_index': 1822470484306666, 'script': '0014ec7abc3bf242e7708ad81b82c2b8ac6427ddbb7a', 'addr': 'bc1qa3atcwljgtnhpzkcrwpv9w9vvsnamwm6annd4u'}}, {'sequence': 0, 'witness': '0248304502210091269a3ca24ab11b0d894095b647355c48565d7568a5e498eb9543a7d708e64202202d14195045f99a95774026f7665ca476c07c52e761395ddc66182d5cec856f5901210366a7a641a0de84e0eef337281ec55f6fd1be8355345d91b48e97fc1908e3f868', 'script': '', 'index': 2, 'prev_out': {'type': 0, 'spent': True, 'value': 2000000, 'spending_outpoints': [{'tx_index': 6706446141676310, 'n': 2}], 'n': 0, 'tx_index': 8371523983881043, 'script': '0014c9ed4fcd12708a136cba7b74a38fed88fe63a163', 'addr': 'bc1qe8k5lngjwz9pxm960d628rld3rlx8gtr7wd5t2'}}]","[{'type': 0, 'spent': False, 'value': 170000, 'spending_outpoints': [], 'n': 0, 'tx_index': 6706446141676310, 'script': '0014caa7e5d6f5f7e31c744dfa7afb8a145a6d98d1a2', 'addr': 'bc1qe2n7t4h47l33cazdlfa0hzs5tfke35dzj6tzuy'}, {'type': 0, 'spent': True, 'value': 1829994, 'spending_outpoints': [{'tx_index': 7760380798816657, 'n': 3}], 'n': 1, 'tx_index': 6706446141676310, 'script': '00143cab929875d985bc872d8abc42b6558ef81e9423', 'addr': 'bc1q8j4e9xr4mxzmeped327y9dj43mupa9prfum6c8'}]",170000,2337764222443
292ee68dcd0f675368d4468dedc5e1e8b8371d977131fca064d163e0538ff863,1,1,2,222,561,1354,0.0.0.0,0,3517414645697658,False,1726511256,861589,861589,"[{'sequence': 4294967295, 'witness': '024730440220346378dd278ca159b39a12e12b3114e3d75aec7b2294fe31a2aed306231189ec022015b9f1069e62809cdad52bfc180e513d918854ed21b9b1671fcadfaee7580b20012103de5909acee75a07907fc20510e52869064092480320f20e29e0ef4c0236dd100', 'script': '', 'index': 0, 'prev_out': {'type': 0, 'spent': True, 'value': 3055883032, 'spending_outpoints': [{'tx_index': 3517414645697658, 'n': 0}], 'n': 1, 'tx_index': 7917974377420131, 'script': '001470ce179f1934956513f77a11dd32b2900dad4223', 'addr': 'bc1qwr8p08cexj2k2ylh0gga6v4jjqx66s3rpkvwfx'}}]","[{'type': 0, 'spent': False, 'value': 2897208039, 'spending_outpoints': [], 'n': 0, 'tx_index': 3517414645697658, 'script': '0014caa7e5d6f5f7e31c744dfa7afb8a145a6d98d1a2', 'addr': 'bc1qe2n7t4h47l33cazdlfa0hzs5tfke35dzj6tzuy'}, {'type': 0, 'spent': True, 'value': 158673639, 'spending_outpoints': [{'tx_index': 5442246035619535, 'n': 0}], 'n': 1, 'tx_index': 3517414645697658, 'script': '001470ce179f1934956513f77a11dd32b2900dad4223', 'addr': 'bc1qwr8p08cexj2k2ylh0gga6v4jjqx66s3rpkvwfx'}]",2897208039,2337764052443
1e18fa67860a654e1ba5ff7e7e447edb34110571e99216b2536b91afe3a539b5,1,1,2,223,562,1015,0.0.0.0,0,6376294429618733,False,1726509854,861588,861588,"[{'sequence': 4294967295, 'witness': '024830450221008c7836df1d9cffdca4ebf74d5bc9b5043426484e82b73c605c4c35fe758cc843022030efab99e545a5c70be6272181cdf3ad3e622db29ea0dd9a02c85d7ae400d68a012103040ab5cf1bba3d5a62cb5b89a0408d8af9274d71bb516496bf94085a59544718', 'script': '', 'index': 0, 'prev_out': {'type': 0, 'spent': True, 'value': 4970050278, 'spending_outpoints': [{'tx_index': 6376294429618733, 'n': 0}], 'n': 1, 'tx_index': 5353556261885966, 'script': '00147efd597ba7c54a9ad757ba65b5c0f7cb22461fff', 'addr': 'bc1q0m74j7a8c49f446hhfjmts8hev3yv8ll8e9smy'}}]","[{'type': 0, 'spent': False, 'value': 10000, 'spending_outpoints': [], 'n': 0, 'tx_index': 6376294429618733, 'script': '0014caa7e5d6f5f7e31c744dfa7afb8a145a6d98d1a2', 'addr': 'bc1qe2n7t4h47l33cazdlfa0hzs5tfke35dzj6tzuy'}, {'type': 0, 'spent': True, 'value': 4970039263, 'spending_outpoints': [{'tx_index': 1254571880538763, 'n': 0}], 'n': 1, 'tx_index': 6376294429618733, 'script': '00147efd597ba7c54a9ad757ba65b5c0f7cb22461fff', 'addr': 'bc1q0m74j7a8c49f446hhfjmts8hev3yv8ll8e9smy'}]",10000,2334866844404
a2dda02b6292c6ce048edc64c7a6e8af78c7662280df15d3bf58927302220bf2,1,1,2,223,562,677,0.0.0.0,0,8516148132737611,False,1726503320,861577,861577,"[{'sequence': 4294967295, 'witness': '02483045022100c839885ef7901adfdabe9b4705eebe60e8b46b2930ad5fdea95a9b209db9a76802201b10c7955a631dc643b79fc2431bb9069312cfd2cc3c60a241ad254a19baa1f8012103de5909acee75a07907fc20510e52869064092480320f20e29e0ef4c0236dd100', 'script': '', 'index': 0, 'prev_out': {'type': 0, 'spent': True, 'value': 8209370984, 'spending_outpoints': [{'tx_index': 8516148132737611, 'n': 0}], 'n': 1, 'tx_index': 3062032902884872, 'script': '001470ce179f1934956513f77a11dd32b2900dad4223', 'addr': 'bc1qwr8p08cexj2k2ylh0gga6v4jjqx66s3rpkvwfx'}}]","[{'type': 0, 'spent': False, 'value': 5149772679, 'spending_outpoints': [], 'n': 0, 'tx_index': 8516148132737611, 'script': '0014caa7e5d6f5f7e31c744dfa7afb8a145a6d98d1a2', 'addr': 'bc1qe2n7t4h47l33cazdlfa0hzs5tfke35dzj6tzuy'}, {'type': 0, 'spent': True, 'value': 3059597628, 'spending_outpoints': [{'tx_index': 4762887356454849, 'n': 0}], 'n': 1, 'tx_index': 8516148132737611, 'script': '001470ce179f1934956513f77a11dd32b2900dad4223', 'addr': 'bc1qwr8p08cexj2k2ylh0gga6v4jjqx66s3rpkvwfx'}]",5149772679,2334866834404
b3ab0a98c051bcada12fceedea98804de15235e171557023d74570bcbb380757,1,1,2,223,562,1015,0.0.0.0,0,3062032902884872,False,1726502873,861575,861575,"[{'sequence': 4294967295, 'witness': '024830450221008b3344d54b0c0edcb9fde0ab8e7268811b418c9682b1a03187bd1585c093d4ac0220410c4b3bed30c6a838bbb4363801f6943403dcb09fcec7f48c10b81962849c71012103de5909acee75a07907fc20510e52869064092480320f20e29e0ef4c0236dd100', 'script': '', 'index': 0, 'prev_out': {'type': 0, 'spent': True, 'value': 8209381999, 'spending_outpoints': [{'tx_index': 3062032902884872, 'n': 0}], 'n': 1, 'tx_index': 2097029198864224, 'script': '001470ce179f1934956513f77a11dd32b2900dad4223', 'addr': 'bc1qwr8p08cexj2k2ylh0gga6v4jjqx66s3rpkvwfx'}}]","[{'type': 0, 'spent': False, 'value': 10000, 'spending_outpoints': [], 'n': 0, 'tx_index': 3062032902884872, 'script': '0014caa7e5d6f5f7e31c744dfa7afb8a145a6d98d1a2', 'addr': 'bc1qe2n7t4h47l33cazdlfa0hzs5tfke35dzj6tzuy'}, {'type': 0, 'spent': True, 'value': 8209370984, 'spending_outpoints': [{'tx_index': 8516148132737611, 'n': 0}], 'n': 1, 'tx_index': 3062032902884872, 'script': '001470ce179f1934956513f77a11dd32b2900dad4223', 'addr': 'bc1qwr8p08cexj2k2ylh0gga6v4jjqx66s3rpkvwfx'}]",10000,2329717061725
f9b266a76024305ea44bbe99e88b5335b948ecc8e40dfb44c7ca0c84c4d816f8,1,1,1,191,437,528,0.0.0.0,0,8728864311247257,False,1726497280,861570,861570,"[{'sequence': 4294967295, 'witness': '0247304402206016fe37e1f399dc312c19c1ffb50becb685d60d23d9fee69225de254bd097ea02203de1e49256613d793249b88bfad0a7213b45b2f799e596a2fb8b4709fc508639012103b69f8c4725b1e306253cbd5a98e7c95e41d1391152e2b8c1bbb07f338a5c5bdd', 'script': '', 'index': 0, 'prev_out': {'type': 0, 'spent': True, 'value': 120556000, 'spending_outpoints': [{'tx_index': 8728864311247257, 'n': 0}], 'n': 0, 'tx_index': 6709270183308720, 'script': '001486fbcfeebcd76e8ae8d25f452dac5619de218060', 'addr': 'bc1qsmaulm4u6ahg46xjtazjmtzkr80zrqrq2kce9h'}}]","[{'type': 0, 'spent': False, 'value': 120555472, 'spending_outpoints': [], 'n': 0, 'tx_index': 8728864311247257, 'script': '0014caa7e5d6f5f7e31c744dfa7afb8a145a6d98d1a2', 'addr': 'bc1qe2n7t4h47l33cazdlfa0hzs5tfke35dzj6tzuy'}]",120555472,2329717051725
82b7583598bb46fe44ecd25a981c722d18ae6a2a52069947d50d33bd3366fbce,1,1,1,192,438,528,0.0.0.0,0,7282532696958561,False,1726497280,861570,861570,"[{'sequence': 4294967295, 'witness': '02483045022100e7ff1f415610952e385db715fe1a97ecc49d052306cb9becedc580a11fcab73e02203d7175a8d80fb7f2cfd9fdc3f19f0604d25dcc31380508c8be00c605a60d3efb012102896c93c272e8c9de3a520eed4bb5a91ed1c462ae9c8250fe2dbe34e8e0d31e93', 'script': '', 'index': 0, 'prev_out': {'type': 0, 'spent': True, 'value': 852508872, 'spending_outpoints': [{'tx_index': 7282532696958561, 'n': 0}], 'n': 0, 'tx_index': 8962223792103272, 'script': '0014343fbc7af26b4862e74e7b85b68e76149fe2ee44', 'addr': 'bc1qxslmc7hjddyx9e6w0wzmdrnkzj079mjy2ppy8c'}}]","[{'type': 0, 'spent': False, 'value': 852508344, 'spending_outpoints': [], 'n': 0, 'tx_index': 7282532696958561, 'script': '0014caa7e5d6f5f7e31c744dfa7afb8a145a6d98d1a2', 'addr': 'bc1qe2n7t4h47l33cazdlfa0hzs5tfke35dzj6tzuy'}]",852508344,2329596496253
07ca57377616a8031901ac6aaf65b373fa68aed7bcef39eeed4a41737fc6c875,1,1,1,192,438,528,0.0.0.0,0,4144165892810793,False,1726497280,861570,861570,"[{'sequence': 4294967295, 'witness': '02483045022100d64289639b68173ac3a9109519542a52b11ae00c6c5e280ca6a40c58171fbe6002203dc02315f77a61e9d377cbc76cdc75be840ccdbcbe3747fe62bd3578f93a3a8c01210286a4ab8eb4208ad462dbe158a32147517db576260b914931645876a4e76ed71a', 'script': '', 'index': 0, 'prev_out': {'type': 0, 'spent': True, 'value': 10000091430, 'spending_outpoints': [{'tx_index': 4144165892810793, 'n': 0}], 'n': 0, 'tx_index': 5392562536563734, 'script': '001426ab6e49aee3a3050e5dcad396dcf76eba4438ba', 'addr': 'bc1qy64kujdwuw3s2rjaetfedh8hd6aygw96r4qz02'}}]","[{'type': 0, 'spent': False, 'value': 10000090902, 'spending_outpoints': [], 'n': 0, 'tx_index': 4144165892810793, 'script': '0014caa7e5d6f5f7e31c744dfa7afb8a145a6d98d1a2', 'addr': 'bc1qe2n7t4h47l33cazdlfa0hzs5tfke35dzj6tzuy'}]",10000090902,2328743987909
7b0925b8e175ab4e9b11cb3141eac66619d2ccd59957f53ac06aa535dfa6c369,1,1,2,223,562,677,0.0.0.0,0,3721249253930157,False,1726494214,861567,861567,"[{'sequence': 4294967295, 'witness': '02483045022100f3e0de1e18c24a0ffe89f66a9c1eee2ebfb54f8ec044e32cef348d4a1b0a3c9202206eefb74f6a1f5adb0794369cba6215be7096a087d278155d8a6353fd8b41307c012103040ab5cf1bba3d5a62cb5b89a0408d8af9274d71bb516496bf94085a59544718', 'script': '', 'index': 0, 'prev_out': {'type': 0, 'spent': True, 'value': 13747967138, 'spending_outpoints': [{'tx_index': 3721249253930157, 'n': 0}], 'n': 1, 'tx_index': 7644665471516870, 'script': '00147efd597ba7c54a9ad757ba65b5c0f7cb22461fff', 'addr': 'bc1q0m74j7a8c49f446hhfjmts8hev3yv8ll8e9smy'}}]","[{'type': 0, 'spent': False, 'value': 300000000, 'spending_outpoints': [], 'n': 0, 'tx_index': 3721249253930157, 'script': '0014caa7e5d6f5f7e31c744dfa7afb8a145a6d98d1a2', 'addr': 'bc1qe2n7t4h47l33cazdlfa0hzs5tfke35dzj6tzuy'}, {'type': 0, 'spent': True, 'value': 13447966461, 'spending_outpoints': [{'tx_index': 5228411528129014, 'n': 0}], 'n': 1, 'tx_index': 3721249253930157, 'script': '00147efd597ba7c54a9ad757ba65b5c0f7cb22461fff', 'addr': 'bc1q0m74j7a8c49f446hhfjmts8hev3yv8ll8e9smy'}]",300000000,2318743897007
1154d3b8474b578171e8027519b0752328c9014076a7541fe9419c63f01057ca,1,3,2,520,1105,1330,0.0.0.0,0,7119209444963208,False,1726494075,861567,861567,"[{'sequence': 4294967295, 'witness': '024730440220634dd4ef8278d29da04f09bfd0b07950a244da870109f8f6e8df13ae8708647a0220738e1530b48c30da76b6affe0314fe41ca8d09e1a8a615ba16a9f77eaf80c38f012103de5909acee75a07907fc20510e52869064092480320f20e29e0ef4c0236dd100', 'script': '', 'index': 0, 'prev_out': {'type': 0, 'spent': True, 'value': 2505549073, 'spending_outpoints': [{'tx_index': 7119209444963208, 'n': 0}], 'n': 1, 'tx_index': 6811601822300781, 'script': '001470ce179f1934956513f77a11dd32b2900dad4223', 'addr': 'bc1qwr8p08cexj2k2ylh0gga6v4jjqx66s3rpkvwfx'}}, {'sequence': 4294967295, 'witness': '024830450221008732e57043039d274938d20d8e8b230902d12a6499d8f3db65006b2bc85f3e9902205a9991ebdb7ac745636926268401c6dbf322316e3916fbf52013e34077543a07012103de5909acee75a07907fc20510e52869064092480320f20e29e0ef4c0236dd100', 'script': '', 'index': 1, 'prev_out': {'type': 0, 'spent': True, 'value': 4999621042, 'spending_outpoints': [{'tx_index': 7119209444963208, 'n': 1}], 'n': 1, 'tx_index': 406471674728931, 'script': '001470ce179f1934956513f77a11dd32b2900dad4223', 'addr': 'bc1qwr8p08cexj2k2ylh0gga6v4jjqx66s3rpkvwfx'}}, {'sequence': 4294967295, 'witness': '02483045022100b8ce0bf60d502f6226a36815ae87b3a0fe0864b78c7955171f8e7f2338ce5e0502204bcea861775975721a205b92923731abccbc20f014c0c64b7bae8e1ab52e7e6f012103de5909acee75a07907fc20510e52869064092480320f20e29e0ef4c0236dd100', 'script': '', 'index': 2, 'prev_out': {'type': 0, 'spent': True, 'value': 9758740771, 'spending_outpoints': [{'tx_index': 7119209444963208, 'n': 2}], 'n': 1, 'tx_index': 5326443332526710, 'script': '001470ce179f1934956513f77a11dd32b2900dad4223', 'addr': 'bc1qwr8p08cexj2k2ylh0gga6v4jjqx66s3rpkvwfx'}}]","[{'type': 0, 'spent': False, 'value': 9049544053, 'spending_outpoints': [], 'n': 0, 'tx_index': 7119209444963208, 'script': '0014caa7e5d6f5f7e31c744dfa7afb8a145a6d98d1a2', 'addr': 'bc1qe2n7t4h47l33cazdlfa0hzs5tfke35dzj6tzuy'}, {'type': 0, 'spent': True, 'value': 8214365503, 'spending_outpoints': [{'tx_index': 8365195223630781, 'n': 0}], 'n': 1, 'tx_index': 7119209444963208, 'script': '001470ce179f1934956513f77a11dd32b2900dad4223', 'addr': 'bc1qwr8p08cexj2k2ylh0gga6v4jjqx66s3rpkvwfx'}]",9049544053,2318443897007
c587f3727379c50efbb37a15e1436b9d68324a9d618c64a749bf3bdcef1d7298,1,1,2,223,562,508,0.0.0.0,0,5363708670478199,False,1726486611,861556,861556,"[{'sequence': 4294967295, 'witness': '02483045022100ae7795e57c7be85f99ce639c927605ad4598c30db6a78282cdec8ab031466de9022031dcb6a7b4e8cb3146f79923b73941358f8d365cde9395c378c2609793df66f0012103de5909acee75a07907fc20510e52869064092480320f20e29e0ef4c0236dd100', 'script': '', 'index': 0, 'prev_out': {'type': 0, 'spent': True, 'value': 3438455973, 'spending_outpoints': [{'tx_index': 5363708670478199, 'n': 0}], 'n': 1, 'tx_index': 4931480118844865, 'script': '001470ce179f1934956513f77a11dd32b2900dad4223', 'addr': 'bc1qwr8p08cexj2k2ylh0gga6v4jjqx66s3rpkvwfx'}}]","[{'type': 0, 'spent': False, 'value': 932003217, 'spending_outpoints': [], 'n': 0, 'tx_index': 5363708670478199, 'script': '0014caa7e5d6f5f7e31c744dfa7afb8a145a6d98d1a2', 'addr': 'bc1qe2n7t4h47l33cazdlfa0hzs5tfke35dzj6tzuy'}, {'type': 0, 'spent': True, 'value': 2506452248, 'spending_outpoints': [{'tx_index': 4048640166100321, 'n': 0}], 'n': 1, 'tx_index': 5363708670478199, 'script': '001470ce179f1934956513f77a11dd32b2900dad4223', 'addr': 'bc1qwr8p08cexj2k2ylh0gga6v4jjqx66s3rpkvwfx'}]",932003217,2309394352954
bee5997ce077cc5e1f8865f8a1a95c1cd83b8883b302d9d205fb1f4f9d0bd384,1,2,2,372,834,1003,0.0.0.0,0,4673342970389503,False,1726254627,861182,861182,"[{'sequence': 4294967295, 'witness': '02483045022100b5e786c01bf4bbad70b3752bf55be3619b91bfbfef3bef79a94d314b57ecadc202202e9c821b9d44352065d943b23d7487c549ee0b07e2a3af25e3b9c6f31760f83c012103de5909acee75a07907fc20510e52869064092480320f20e29e0ef4c0236dd100', 'script': '', 'index': 0, 'prev_out': {'type': 0, 'spent': True, 'value': 3556907508, 'spending_outpoints': [{'tx_index': 4673342970389503, 'n': 0}], 'n': 1, 'tx_index': 6121848861420475, 'script': '001470ce179f1934956513f77a11dd32b2900dad4223', 'addr': 'bc1qwr8p08cexj2k2ylh0gga6v4jjqx66s3rpkvwfx'}}, {'sequence': 4294967295, 'witness': '02483045022100a9d81fb78eaca797575e6fb7e9335ec4100d742481f85dd59a14163f36d761590220201d57dee7589b347cd0645854afa87eef296cefa3442ceab5f072d3c2756a67012103de5909acee75a07907fc20510e52869064092480320f20e29e0ef4c0236dd100', 'script': '', 'index': 1, 'prev_out': {'type': 0, 'spent': True, 'value': 4594713477, 'spending_outpoints': [{'tx_index': 4673342970389503, 'n': 1}], 'n': 1, 'tx_index': 6800806670172894, 'script': '001470ce179f1934956513f77a11dd32b2900dad4223', 'addr': 'bc1qwr8p08cexj2k2ylh0gga6v4jjqx66s3rpkvwfx'}}]","[{'type': 0, 'spent': False, 'value': 4331790998, 'spending_outpoints': [], 'n': 0, 'tx_index': 4673342970389503, 'script': '0014caa7e5d6f5f7e31c744dfa7afb8a145a6d98d1a2', 'addr': 'bc1qe2n7t4h47l33cazdlfa0hzs5tfke35dzj6tzuy'}, {'type': 0, 'spent': True, 'value': 3819828984, 'spending_outpoints': [{'tx_index': 4926869268429448, 'n': 0}], 'n': 1, 'tx_index': 4673342970389503, 'script': '001470ce179f1934956513f77a11dd32b2900dad4223', 'addr': 'bc1qwr8p08cexj2k2ylh0gga6v4jjqx66s3rpkvwfx'}]",4331790998,2308462349737
c1e0cd00f0d5b427300dde9459639f71b0db0ace4728b94204307da0bbe06e62,1,1,2,222,561,677,0.0.0.0,0,3463307402153894,False,1726253979,861180,861180,"[{'sequence': 4294967295, 'witness': '02473044022033d71830be06b8c1267ccd9c82c3c74228af45b25fac47f5a68a4c0ecfab9de1022007fca3fe21a2478dcfee45ef39bec46d97402fa4b98bd61a0750a30c64d21b51012103040ab5cf1bba3d5a62cb5b89a0408d8af9274d71bb516496bf94085a59544718', 'script': '', 'index': 0, 'prev_out': {'type': 0, 'spent': True, 'value': 58358436642, 'spending_outpoints': [{'tx_index': 3463307402153894, 'n': 0}], 'n': 1, 'tx_index': 2931426659509936, 'script': '00147efd597ba7c54a9ad757ba65b5c0f7cb22461fff', 'addr': 'bc1q0m74j7a8c49f446hhfjmts8hev3yv8ll8e9smy'}}]","[{'type': 0, 'spent': False, 'value': 44007063048, 'spending_outpoints': [], 'n': 0, 'tx_index': 3463307402153894, 'script': '0014caa7e5d6f5f7e31c744dfa7afb8a145a6d98d1a2', 'addr': 'bc1qe2n7t4h47l33cazdlfa0hzs5tfke35dzj6tzuy'}, {'type': 0, 'spent': True, 'value': 14351372917, 'spending_outpoints': [{'tx_index': 3922236259944126, 'n': 0}], 'n': 1, 'tx_index': 3463307402153894, 'script': '00147efd597ba7c54a9ad757ba65b5c0f7cb22461fff', 'addr': 'bc1q0m74j7a8c49f446hhfjmts8hev3yv8ll8e9smy'}]",44007063048,2304130558739
9113f74c1596bc08e9d7666c76f837a144349c586d28171e418635cda5ef5053,1,2,2,370,832,2257,0.0.0.0,0,2931426659509936,False,1726252761,861176,861176,"[{'sequence': 4294967295, 'witness': '024730440220444ba08dcc028f48cee0d5ec76bde76ea49917a7f3ef76f49d91b9cad70a20ab022008b0498604f2de694121b64ccc508f5fcce664a02b174529de8f3603ea2326f4012103040ab5cf1bba3d5a62cb5b89a0408d8af9274d71bb516496bf94085a59544718', 'script': '', 'index': 0, 'prev_out': {'type': 0, 'spent': True, 'value': 9758438899, 'spending_outpoints': [{'tx_index': 2931426659509936, 'n': 0}], 'n': 1, 'tx_index': 584893431981435, 'script': '00147efd597ba7c54a9ad757ba65b5c0f7cb22461fff', 'addr': 'bc1q0m74j7a8c49f446hhfjmts8hev3yv8ll8e9smy'}}, {'sequence': 4294967295, 'witness': '02473044022060f14313a23850b7892d4871e1a495ff575950bfd4ce6676cf2c0e6fe441d51102207f2518ec88a8f163c03f7617ea338116c1ba2da3a0e16a93770c6006f31a159d012103040ab5cf1bba3d5a62cb5b89a0408d8af9274d71bb516496bf94085a59544718', 'script': '', 'index': 1, 'prev_out': {'type': 0, 'spent': True, 'value': 58600000000, 'spending_outpoints': [{'tx_index': 2931426659509936, 'n': 1}], 'n': 0, 'tx_index': 4515669446348349, 'script': '00147efd597ba7c54a9ad757ba65b5c0f7cb22461fff', 'addr': 'bc1q0m74j7a8c49f446hhfjmts8hev3yv8ll8e9smy'}}]","[{'type': 0, 'spent': False, 'value': 10000000000, 'spending_outpoints': [], 'n': 0, 'tx_index': 2931426659509936, 'script': '0014caa7e5d6f5f7e31c744dfa7afb8a145a6d98d1a2', 'addr': 'bc1qe2n7t4h47l33cazdlfa0hzs5tfke35dzj6tzuy'}, {'type': 0, 'spent': True, 'value': 58358436642, 'spending_outpoints': [{'tx_index': 3463307402153894, 'n': 0}], 'n': 1, 'tx_index': 2931426659509936, 'script': '00147efd597ba7c54a9ad757ba65b5c0f7cb22461fff', 'addr': 'bc1q0m74j7a8c49f446hhfjmts8hev3yv8ll8e9smy'}]",10000000000,2260123495691
d689fb3ade7f6ebce4ed8e8ff0bc5327189bc7ee2bcf38a51694bb1984471ec2,1,2,1,341,710,1282,0.0.0.0,0,6829929748707186,False,1726248398,861173,861173,"[{'sequence': 4294967295, 'witness': '02483045022100c54bfc49fefeabbb2928a990797bc045aa7a0d6f167d73b2eba42e5085a88dd402201ea9470f15ff89558b9ee7fb0ff7dbfecc354899827f1a3f81504aef612525f7012102896c93c272e8c9de3a520eed4bb5a91ed1c462ae9c8250fe2dbe34e8e0d31e93', 'script': '', 'index': 0, 'prev_out': {'type': 0, 'spent': True, 'value': 1000000, 'spending_outpoints': [{'tx_index': 6829929748707186, 'n': 0}], 'n': 0, 'tx_index': 7691602000747450, 'script': '0014343fbc7af26b4862e74e7b85b68e76149fe2ee44', 'addr': 'bc1qxslmc7hjddyx9e6w0wzmdrnkzj079mjy2ppy8c'}}, {'sequence': 4294967295, 'witness': '02483045022100bc5d4be2df3f8deeda8075d7e5282129c16f9515e9489d264d04119607a7b986022073733a285504c232bef876c5cac00e5f18d3d43b7daab9b779bf76adc71142d9012102896c93c272e8c9de3a520eed4bb5a91ed1c462ae9c8250fe2dbe34e8e0d31e93', 'script': '', 'index': 1, 'prev_out': {'type': 0, 'spent': True, 'value': 154699000000, 'spending_outpoints': [{'tx_index': 6829929748707186, 'n': 1}], 'n': 0, 'tx_index': 3983274391557894, 'script': '0014343fbc7af26b4862e74e7b85b68e76149fe2ee44', 'addr': 'bc1qxslmc7hjddyx9e6w0wzmdrnkzj079mjy2ppy8c'}}]","[{'type': 0, 'spent': False, 'value': 154699998718, 'spending_outpoints': [], 'n': 0, 'tx_index': 6829929748707186, 'script': '0014caa7e5d6f5f7e31c744dfa7afb8a145a6d98d1a2', 'addr': 'bc1qe2n7t4h47l33cazdlfa0hzs5tfke35dzj6tzuy'}]",154699998718,2250123495691
717eec18f2b656f5115db2f2499d3e962404face614d0fb3d8111179953135a7,1,1,1,192,438,924,0.0.0.0,0,5883101023511074,False,1726248530,861173,861173,"[{'sequence': 4294967295, 'witness': '024830450221008ae935f5e95b3c6a4c50512a588c6f33fd1947c3f3f29b820317737dc8fbe90d022048ccbd5452ef1cde386d8d3ff7e05a289b6e74c4ba0887eba887b4c765d6f89c01210286a4ab8eb4208ad462dbe158a32147517db576260b914931645876a4e76ed71a', 'script': '', 'index': 0, 'prev_out': {'type': 0, 'spent': True, 'value': 2148100000, 'spending_outpoints': [{'tx_index': 5883101023511074, 'n': 0}], 'n': 0, 'tx_index': 7636146921854454, 'script': '001426ab6e49aee3a3050e5dcad396dcf76eba4438ba', 'addr': 'bc1qy64kujdwuw3s2rjaetfedh8hd6aygw96r4qz02'}}]","[{'type': 0, 'spent': False, 'value': 2148099076, 'spending_outpoints': [], 'n': 0, 'tx_index': 5883101023511074, 'script': '0014caa7e5d6f5f7e31c744dfa7afb8a145a6d98d1a2', 'addr': 'bc1qe2n7t4h47l33cazdlfa0hzs5tfke35dzj6tzuy'}]",2148099076,2095423496973
1794a391bc3c8733beb50e4a653e60a950f6806a20576cef50f016188e614ac1,1,1,2,223,562,1692,0.0.0.0,0,6800806670172894,False,1726248934,861173,861173,"[{'sequence': 4294967295, 'witness': '02483045022100fd2cce5d1f55f1f5ecc5a66c955b873e851fe79605644fa6ed496f6166746de40220102b900affd98ff640107422d257103392ba85f5aa1a17721b112a7c6f1cb414012103de5909acee75a07907fc20510e52869064092480320f20e29e0ef4c0236dd100', 'script': '', 'index': 0, 'prev_out': {'type': 0, 'spent': True, 'value': 4594815169, 'spending_outpoints': [{'tx_index': 6800806670172894, 'n': 0}], 'n': 1, 'tx_index': 186581338506529, 'script': '001470ce179f1934956513f77a11dd32b2900dad4223', 'addr': 'bc1qwr8p08cexj2k2ylh0gga6v4jjqx66s3rpkvwfx'}}]","[{'type': 0, 'spent': False, 'value': 100000, 'spending_outpoints': [], 'n': 0, 'tx_index': 6800806670172894, 'script': '0014caa7e5d6f5f7e31c744dfa7afb8a145a6d98d1a2', 'addr': 'bc1qe2n7t4h47l33cazdlfa0hzs5tfke35dzj6tzuy'}, {'type': 0, 'spent': True, 'value': 4594713477, 'spending_outpoints': [{'tx_index': 4673342970389503, 'n': 1}], 'n': 1, 'tx_index': 6800806670172894, 'script': '001470ce179f1934956513f77a11dd32b2900dad4223', 'addr': 'bc1qwr8p08cexj2k2ylh0gga6v4jjqx66s3rpkvwfx'}]",100000,2093275397897
0d917a8614749970e2888b1e8eb4d65a9321d3596b5837d56a136646691d7bb1,1,1,2,223,562,1523,0.0.0.0,0,6244554641034434,False,1726242808,861156,861156,"[{'sequence': 4294967295, 'witness': '02483045022100bd4093f800c50141970b6ff44fec9776305364a5a7cbb2e1a80a5582cebcc22602201dbce8cd752be6f2494db4ef5bc5eeeb51085e118761d091245f2ad80f46951f012103040ab5cf1bba3d5a62cb5b89a0408d8af9274d71bb516496bf94085a59544718', 'script': '', 'index': 0, 'prev_out': {'type': 0, 'spent': True, 'value': 9771517466, 'spending_outpoints': [{'tx_index': 6244554641034434, 'n': 0}], 'n': 1, 'tx_index': 839715454975986, 'script': '00147efd597ba7c54a9ad757ba65b5c0f7cb22461fff', 'addr': 'bc1q0m74j7a8c49f446hhfjmts8hev3yv8ll8e9smy'}}]","[{'type': 0, 'spent': False, 'value': 10000, 'spending_outpoints': [], 'n': 0, 'tx_index': 6244554641034434, 'script': '0014caa7e5d6f5f7e31c744dfa7afb8a145a6d98d1a2', 'addr': 'bc1qe2n7t4h47l33cazdlfa0hzs5tfke35dzj6tzuy'}, {'type': 0, 'spent': True, 'value': 9771505943, 'spending_outpoints': [{'tx_index': 7678066171038872, 'n': 0}], 'n': 1, 'tx_index': 6244554641034434, 'script': '00147efd597ba7c54a9ad757ba65b5c0f7cb22461fff', 'addr': 'bc1q0m74j7a8c49f446hhfjmts8hev3yv8ll8e9smy'}]",10000,2093275297897
d5acee4de383cf8dbd8e2881375a1ca42dd0ca77585ab1f2891c18e3d8aaeebe,1,1,1,192,438,660,0.0.0.0,0,6717832890704643,False,1726231984,861144,861144,"[{'sequence': 4294967295, 'witness': '0248304502210097b166bca971bf31afbb652c7d9715abb69dd9fcbb916993c72c871b1b7470a502202566520914156482caf92358cdbe6dbca6df7396a2ec941b69b78766aa675663012102896c93c272e8c9de3a520eed4bb5a91ed1c462ae9c8250fe2dbe34e8e0d31e93', 'script': '', 'index': 0, 'prev_out': {'type': 0, 'spent': True, 'value': 860622744, 'spending_outpoints': [{'tx_index': 6717832890704643, 'n': 0}], 'n': 0, 'tx_index': 51059274228071, 'script': '0014343fbc7af26b4862e74e7b85b68e76149fe2ee44', 'addr': 'bc1qxslmc7hjddyx9e6w0wzmdrnkzj079mjy2ppy8c'}}]","[{'type': 0, 'spent': False, 'value': 860622084, 'spending_outpoints': [], 'n': 0, 'tx_index': 6717832890704643, 'script': '0014caa7e5d6f5f7e31c744dfa7afb8a145a6d98d1a2', 'addr': 'bc1qe2n7t4h47l33cazdlfa0hzs5tfke35dzj6tzuy'}]",860622084,2093275287897
f198aa46226b1490e8a33032afd3398fa0959302a9cee13e25805ef7a40bc922,1,1,1,192,438,660,0.0.0.0,0,1223900132207568,False,1726231987,861144,861144,"[{'sequence': 4294967295, 'witness': '024830450221008760e079b6571c16a257012d56d451080158cd9783801606d22a7699d30611a00220568e95f5e9626503df20c5da1ecf365e6f88858555b74b2d3ed98e3120cd353b01210286a4ab8eb4208ad462dbe158a32147517db576260b914931645876a4e76ed71a', 'script': '', 'index': 0, 'prev_out': {'type': 0, 'spent': True, 'value': 11435100000, 'spending_outpoints': [{'tx_index': 1223900132207568, 'n': 0}], 'n': 0, 'tx_index': 8701719180158942, 'script': '001426ab6e49aee3a3050e5dcad396dcf76eba4438ba', 'addr': 'bc1qy64kujdwuw3s2rjaetfedh8hd6aygw96r4qz02'}}]","[{'type': 0, 'spent': False, 'value': 11435099340, 'spending_outpoints': [], 'n': 0, 'tx_index': 1223900132207568, 'script': '0014caa7e5d6f5f7e31c744dfa7afb8a145a6d98d1a2', 'addr': 'bc1qe2n7t4h47l33cazdlfa0hzs5tfke35dzj6tzuy'}]",11435099340,2092414665813
2ce47ff7d4c070fa1b1d9a78389293fcefc7fbc47739a78d3c842b3a7bd160a9,1,5,1,784,1522,1379,0.0.0.0,0,5959465486992752,False,1726155651,861027,861027,"[{'sequence': 4294967295, 'witness': '02473044022020a880897df327ac694796d8d2df5330e8dded0be2922124fc22d175918cc6da022033534e6dade470d9f4fc5e7b93182044e2cb660960a01b9a37118b5c960edb8e012102896c93c272e8c9de3a520eed4bb5a91ed1c462ae9c8250fe2dbe34e8e0d31e93', 'script': '', 'index': 0, 'prev_out': {'type': 0, 'spent': True, 'value': 1715, 'spending_outpoints': [{'tx_index': 5959465486992752, 'n': 0}], 'n': 8, 'tx_index': 7007634624319802, 'script': '0014343fbc7af26b4862e74e7b85b68e76149fe2ee44', 'addr': 'bc1qxslmc7hjddyx9e6w0wzmdrnkzj079mjy2ppy8c'}}, {'sequence': 4294967295, 'witness': '02473044022036f8d23bc2d8f063dcc901f49e88c0eb9393746cc7e84b14eee9fe31d57ce2c0022019979daa8ad00a11549476dd6ce7ff15799bed51346ab356f7814751120a8de1012102896c93c272e8c9de3a520eed4bb5a91ed1c462ae9c8250fe2dbe34e8e0d31e93', 'script': '', 'index': 1, 'prev_out': {'type': 0, 'spent': True, 'value': 861319024, 'spending_outpoints': [{'tx_index': 5959465486992752, 'n': 1}], 'n': 0, 'tx_index': 6909951801263409, 'script': '0014343fbc7af26b4862e74e7b85b68e76149fe2ee44', 'addr': 'bc1qxslmc7hjddyx9e6w0wzmdrnkzj079mjy2ppy8c'}}, {'sequence': 4294967295, 'witness': '02483045022100e13c5bd65d13467df951c99efcebcbdb5ab30a3936fcbbdea968c017469299da02204dae4a0270aac1b2080dfd40c1ff214dc8a6ebd7ddb69aa9e59f0f1ef18e098f012102896c93c272e8c9de3a520eed4bb5a91ed1c462ae9c8250fe2dbe34e8e0d31e93', 'script': '', 'index': 2, 'prev_out': {'type': 0, 'spent': True, 'value': 867265832, 'spending_outpoints': [{'tx_index': 5959465486992752, 'n': 2}], 'n': 0, 'tx_index': 1468502410044483, 'script': '0014343fbc7af26b4862e74e7b85b68e76149fe2ee44', 'addr': 'bc1qxslmc7hjddyx9e6w0wzmdrnkzj079mjy2ppy8c'}}, {'sequence': 4294967295, 'witness': '0247304402201cafd277a36a6332d8443fca6491a13620a40d9350548e3a5d12ab6979dd468c022077b33eaf10829ec6434cf0024e35aa815e13c8afca9cf14b23321f6384ac7ee5012102896c93c272e8c9de3a520eed4bb5a91ed1c462ae9c8250fe2dbe34e8e0d31e93', 'script': '', 'index': 3, 'prev_out': {'type': 0, 'spent': True, 'value': 881676851, 'spending_outpoints': [{'tx_index': 5959465486992752, 'n': 3}], 'n': 0, 'tx_index': 6381485772461710, 'script': '0014343fbc7af26b4862e74e7b85b68e76149fe2ee44', 'addr': 'bc1qxslmc7hjddyx9e6w0wzmdrnkzj079mjy2ppy8c'}}, {'sequence': 4294967295, 'witness': '0247304402204e23eec41d993faa7cc8f5262f5d28dc0905cf8b369edd80dc0073eedfdf995c02203a0b124e1fe2d26d4a286cbdb74aa786dc5a7d8a2fb4cb43d3f3da9cce1d553a012102896c93c272e8c9de3a520eed4bb5a91ed1c462ae9c8250fe2dbe34e8e0d31e93', 'script': '', 'index': 4, 'prev_out': {'type': 0, 'spent': True, 'value': 885067756, 'spending_outpoints': [{'tx_index': 5959465486992752, 'n': 4}], 'n': 0, 'tx_index': 6212409397145975, 'script': '0014343fbc7af26b4862e74e7b85b68e76149fe2ee44', 'addr': 'bc1qxslmc7hjddyx9e6w0wzmdrnkzj079mjy2ppy8c'}}]","[{'type': 0, 'spent': False, 'value': 3495329799, 'spending_outpoints': [], 'n': 0, 'tx_index': 5959465486992752, 'script': '0014caa7e5d6f5f7e31c744dfa7afb8a145a6d98d1a2', 'addr': 'bc1qe2n7t4h47l33cazdlfa0hzs5tfke35dzj6tzuy'}]",3495329799,2080979566473
83c488a08616eaed443639541404f7318b073205b5f8f441b9df053b5e1176eb,1,2,1,339,708,641,0.0.0.0,0,8284554561806523,False,1726155651,861027,861027,"[{'sequence': 4294967295, 'witness': '0247304402203398bebbb94b6f3ed87eaef3d3a032da6df3575057ccd28ae0a4ad8eb1fb8fe702203523665a324140e495219ffe1ecc35e58883d19262d9c470853a6d3236b5aec201210286a4ab8eb4208ad462dbe158a32147517db576260b914931645876a4e76ed71a', 'script': '', 'index': 0, 'prev_out': {'type': 0, 'spent': True, 'value': 10000, 'spending_outpoints': [{'tx_index': 8284554561806523, 'n': 0}], 'n': 0, 'tx_index': 557398956634318, 'script': '001426ab6e49aee3a3050e5dcad396dcf76eba4438ba', 'addr': 'bc1qy64kujdwuw3s2rjaetfedh8hd6aygw96r4qz02'}}, {'sequence': 4294967295, 'witness': '02473044022003945951fb837b672b13435ec05668f6b7230b3800151b7bdc12f67049e397c102201e58eed869b4c19605a3294423d8bd329ba1316f015d3e8e30eb37d8667a7f3801210286a4ab8eb4208ad462dbe158a32147517db576260b914931645876a4e76ed71a', 'script': '', 'index': 1, 'prev_out': {'type': 0, 'spent': True, 'value': 93666000000, 'spending_outpoints': [{'tx_index': 8284554561806523, 'n': 1}], 'n': 1, 'tx_index': 1144351314667256, 'script': '001426ab6e49aee3a3050e5dcad396dcf76eba4438ba', 'addr': 'bc1qy64kujdwuw3s2rjaetfedh8hd6aygw96r4qz02'}}]","[{'type': 0, 'spent': False, 'value': 93666009359, 'spending_outpoints': [], 'n': 0, 'tx_index': 8284554561806523, 'script': '0014caa7e5d6f5f7e31c744dfa7afb8a145a6d98d1a2', 'addr': 'bc1qe2n7t4h47l33cazdlfa0hzs5tfke35dzj6tzuy'}]",93666009359,2077484236674
faa4f1fb7d118a141950d269fd11312bdf0311243d531bdbed91aad6b79719d9,1,2,2,371,833,1003,0.0.0.0,0,7638526170158418,False,1725979253,860763,860763,"[{'sequence': 4294967295, 'witness': '0248304502210096adece25b7ba12c28ccd704b18746400b8382930396c8ef97bd1d22ae6f6575022046eff20c5e5541a1dc21fac5e2f1e1a2cf0ac063addf700e19a4725438c1decc01210277ddb33af397fb47a88ea2835087f4d8ab766bcc523cbffba51c46b42a74d824', 'script': '', 'index': 0, 'prev_out': {'type': 0, 'spent': True, 'value': 11985995000, 'spending_outpoints': [{'tx_index': 7638526170158418, 'n': 0}], 'n': 0, 'tx_index': 4946401743127849, 'script': '0014be901ff6f6c8a94e18c06bd95aba6c22e0fa5adc', 'addr': 'bc1qh6gplahkez55uxxqd0v44wnvyts05kkuvagrar'}}, {'sequence': 4294967295, 'witness': '0247304402202b32a8d162cd5d672ad22a5559079e68d008a78ce8a20ecc9d41b416d12d698f02205b7830d6b6fff9067c08c7e36e04c26810df1bd076ccbbc03b318de2c22bcc4d01210277ddb33af397fb47a88ea2835087f4d8ab766bcc523cbffba51c46b42a74d824', 'script': '', 'index': 1, 'prev_out': {'type': 0, 'spent': True, 'value': 89034943741, 'spending_outpoints': [{'tx_index': 7638526170158418, 'n': 1}], 'n': 1, 'tx_index': 1945391908274488, 'script': '0014be901ff6f6c8a94e18c06bd95aba6c22e0fa5adc', 'addr': 'bc1qh6gplahkez55uxxqd0v44wnvyts05kkuvagrar'}}]","[{'type': 0, 'spent': False, 'value': 76000000000, 'spending_outpoints': [], 'n': 0, 'tx_index': 7638526170158418, 'script': '0014caa7e5d6f5f7e31c744dfa7afb8a145a6d98d1a2', 'addr': 'bc1qe2n7t4h47l33cazdlfa0hzs5tfke35dzj6tzuy'}, {'type': 0, 'spent': True, 'value': 25020937738, 'spending_outpoints': [{'tx_index': 4871790377886293, 'n': 0}], 'n': 1, 'tx_index': 7638526170158418, 'script': '0014be901ff6f6c8a94e18c06bd95aba6c22e0fa5adc', 'addr': 'bc1qh6gplahkez55uxxqd0v44wnvyts05kkuvagrar'}]",76000000000,1983818227315
6fc89a3eca55962c9a309520155c6b05563ab6efce5206fee9a16382365dee87,1,29,1,4346,8036,9701,0.0.0.0,0,4782650746227828,False,1725979253,860763,860763,"[{'sequence': 4294967295, 'witness': '0247304402202c84e9ea4bf14af57b3d403084d76062c167f849dfd031d0c60818d31db57bc902202a4fa7516bdb2cd47a8519f8a2507ebdc5c5cb312035fc9682663058682b1461012103b69f8c4725b1e306253cbd5a98e7c95e41d1391152e2b8c1bbb07f338a5c5bdd', 'script': '', 'index': 0, 'prev_out': {'type': 0, 'spent': True, 'value': 1990, 'spending_outpoints': [{'tx_index': 4782650746227828, 'n': 0}], 'n': 1, 'tx_index': 4581415834192827, 'script': '001486fbcfeebcd76e8ae8d25f452dac5619de218060', 'addr': 'bc1qsmaulm4u6ahg46xjtazjmtzkr80zrqrq2kce9h'}}, {'sequence': 4294967295, 'witness': '024730440220288ee7f90d184fcf3bf2254e5e02f98c21209ec631891741a9c1192cc64eebbf02202dd5587ab01f9012cb6e5d5793c750de260dfa58aa375ef9420991fd2cb6c061012103b69f8c4725b1e306253cbd5a98e7c95e41d1391152e2b8c1bbb07f338a5c5bdd', 'script': '', 'index': 1, 'prev_out': {'type': 0, 'spent': True, 'value': 10000, 'spending_outpoints': [{'tx_index': 4782650746227828, 'n': 1}], 'n': 0, 'tx_index': 762679992237088, 'script': '001486fbcfeebcd76e8ae8d25f452dac5619de218060', 'addr': 'bc1qsmaulm4u6ahg46xjtazjmtzkr80zrqrq2kce9h'}}, {'sequence': 4294967295, 'witness': '0247304402202228915c27780f7568e2e54b7c822497909e0a07649455928c0488cf095783fd02201de6fda1a53e9c11d5afef2faf01643002cff89a1baf1ce8846f7ec972865c89012103b69f8c4725b1e306253cbd5a98e7c95e41d1391152e2b8c1bbb07f338a5c5bdd', 'script': '', 'index': 2, 'prev_out': {'type': 0, 'spent': True, 'value': 50000, 'spending_outpoints': [{'tx_index': 4782650746227828, 'n': 2}], 'n': 0, 'tx_index': 7924809010542053, 'script': '001486fbcfeebcd76e8ae8d25f452dac5619de218060', 'addr': 'bc1qsmaulm4u6ahg46xjtazjmtzkr80zrqrq2kce9h'}}, {'sequence': 4294967295, 'witness': '02483045022100e7a71b520ef401403a974b78227f96b7cc0a2308d989a5db0383a9d8c01bd1de02201d6e34e99d1b31e9d3831db17d6250fec6edd0abfb1f11c236935d61278ab301012103b69f8c4725b1e306253cbd5a98e7c95e41d1391152e2b8c1bbb07f338a5c5bdd', 'script': '', 'index': 3, 'prev_out': {'type': 0, 'spent': True, 'value': 99208, 'spending_outpoints': [{'tx_index': 4782650746227828, 'n': 3}], 'n': 0, 'tx_index': 7151821511561615, 'script': '001486fbcfeebcd76e8ae8d25f452dac5619de218060', 'addr': 'bc1qsmaulm4u6ahg46xjtazjmtzkr80zrqrq2kce9h'}}, {'sequence': 4294967295, 'witness': '0247304402206dae67211c89ab99059d26050e7385b00a3d8f3dc4fc8ed61fa891f8a4f2efc502207e53aa3c3345f97ee1bb933bac82858b15dab2a2f6fe844537e1e11b45863d28012103b69f8c4725b1e306253cbd5a98e7c95e41d1391152e2b8c1bbb07f338a5c5bdd', 'script': '', 'index': 4, 'prev_out': {'type': 0, 'spent': True, 'value': 100000, 'spending_outpoints': [{'tx_index': 4782650746227828, 'n': 4}], 'n': 0, 'tx_index': 7552660218135179, 'script': '001486fbcfeebcd76e8ae8d25f452dac5619de218060', 'addr': 'bc1qsmaulm4u6ahg46xjtazjmtzkr80zrqrq2kce9h'}}, {'sequence': 4294967295, 'witness': '02483045022100f9e0231adc98b67c9d4cbcedfb2344ac410afc6f81882fef3c14fecf57387158022028a122e3a2d444bb969f46b513bd6a4440837d2e6c3ed566d39f67c19ff1d241012103b69f8c4725b1e306253cbd5a98e7c95e41d1391152e2b8c1bbb07f338a5c5bdd', 'script': '', 'index': 5, 'prev_out': {'type': 0, 'spent': True, 'value': 100000, 'spending_outpoints': [{'tx_index': 4782650746227828, 'n': 5}], 'n': 0, 'tx_index': 3599272900460668, 'script': '001486fbcfeebcd76e8ae8d25f452dac5619de218060', 'addr': 'bc1qsmaulm4u6ahg46xjtazjmtzkr80zrqrq2kce9h'}}, {'sequence': 4294967295, 'witness': '0247304402200bfa352c70be9a74a978dc03d78813447576c7014d2db60efc0fef3f0f77135c0220792ca5da1630e6307106d732db5a627eed72ef34d8e25214fdbd9b5711242339012103b69f8c4725b1e306253cbd5a98e7c95e41d1391152e2b8c1bbb07f338a5c5bdd', 'script': '', 'index': 6, 'prev_out': {'type': 0, 'spent': True, 'value': 15228000, 'spending_outpoints': [{'tx_index': 4782650746227828, 'n': 6}], 'n': 0, 'tx_index': 702038333554266, 'script': '001486fbcfeebcd76e8ae8d25f452dac5619de218060', 'addr': 'bc1qsmaulm4u6ahg46xjtazjmtzkr80zrqrq2kce9h'}}, {'sequence': 4294967295, 'witness': '0247304402206cb134b4f8ade354cd929029d72f6e3bdd98f14ed068c343dd94c53639205f51022033004a2bd42ebfb76e773bfb0dda404d0bec0c953d76bb90a6225db23fedc319012103b69f8c4725b1e306253cbd5a98e7c95e41d1391152e2b8c1bbb07f338a5c5bdd', 'script': '', 'index': 7, 'prev_out': {'type': 0, 'spent': True, 'value': 18750000, 'spending_outpoints': [{'tx_index': 4782650746227828, 'n': 7}], 'n': 0, 'tx_index': 5061275760998486, 'script': '001486fbcfeebcd76e8ae8d25f452dac5619de218060', 'addr': 'bc1qsmaulm4u6ahg46xjtazjmtzkr80zrqrq2kce9h'}}, {'sequence': 4294967295, 'witness': '02483045022100dd6dbc1390bd1322c4045eee9ac5ba2c4bf62858b1abfe5369fc25347336433c02200a22d9b9f15f945efec2b874f830ed6c25ca3cdb951567c350adf43d36298c2a012103b69f8c4725b1e306253cbd5a98e7c95e41d1391152e2b8c1bbb07f338a5c5bdd', 'script': '', 'index': 8, 'prev_out': {'type': 0, 'spent': True, 'value': 29166666, 'spending_outpoints': [{'tx_index': 4782650746227828, 'n': 8}], 'n': 0, 'tx_index': 6900441485058763, 'script': '001486fbcfeebcd76e8ae8d25f452dac5619de218060', 'addr': 'bc1qsmaulm4u6ahg46xjtazjmtzkr80zrqrq2kce9h'}}, {'sequence': 4294967295, 'witness': '0248304502210093897af0af491a5c2154b780e9a80a360d773cea5c3c8f204b699b057ba0e88e0220525dba0b63d490067f87e34661152733cbb047f3b44ddc0c284836cda37e7553012103b69f8c4725b1e306253cbd5a98e7c95e41d1391152e2b8c1bbb07f338a5c5bdd', 'script': '', 'index': 9, 'prev_out': {'type': 0, 'spent': True, 'value': 35606438, 'spending_outpoints': [{'tx_index': 4782650746227828, 'n': 9}], 'n': 0, 'tx_index': 4367035433730671, 'script': '001486fbcfeebcd76e8ae8d25f452dac5619de218060', 'addr': 'bc1qsmaulm4u6ahg46xjtazjmtzkr80zrqrq2kce9h'}}, {'sequence': 4294967295, 'witness': '02483045022100df114a7d4281c388f9e733925235d07743bcf2b00f8be7061ca792bbf2e57c6702207d39a2f5451dc098ec2e6a55fa27535de03dda5eaab12d23e7f081af2846bea4012103b69f8c4725b1e306253cbd5a98e7c95e41d1391152e2b8c1bbb07f338a5c5bdd', 'script': '', 'index': 10, 'prev_out': {'type': 0, 'spent': True, 'value': 37397260, 'spending_outpoints': [{'tx_index': 4782650746227828, 'n': 10}], 'n': 0, 'tx_index': 4593922246605383, 'script': '001486fbcfeebcd76e8ae8d25f452dac5619de218060', 'addr': 'bc1qsmaulm4u6ahg46xjtazjmtzkr80zrqrq2kce9h'}}, {'sequence': 4294967295, 'witness': '0247304402203b0ad54808445d329e242c5006cdc319425da070cbe2a3b52263b3a8573c47710220340aa47611784706f497d7d4ba2c2118ebb318a11db610ab8c03014bf48eaa9f012103b69f8c4725b1e306253cbd5a98e7c95e41d1391152e2b8c1bbb07f338a5c5bdd', 'script': '', 'index': 11, 'prev_out': {'type': 0, 'spent': True, 'value': 58233000, 'spending_outpoints': [{'tx_index': 4782650746227828, 'n': 11}], 'n': 0, 'tx_index': 2994170058899255, 'script': '001486fbcfeebcd76e8ae8d25f452dac5619de218060', 'addr': 'bc1qsmaulm4u6ahg46xjtazjmtzkr80zrqrq2kce9h'}}, {'sequence': 4294967295, 'witness': '0247304402206094cc91887e1bd0a59139899b71c2af14b84a6d20984f94b6663d2c026392f702206aa6346a196b68c84d95f0906a6a620a46ebf0eb9d7a04bfee121ad129b866e2012103b69f8c4725b1e306253cbd5a98e7c95e41d1391152e2b8c1bbb07f338a5c5bdd', 'script': '', 'index': 12, 'prev_out': {'type': 0, 'spent': True, 'value': 81666666, 'spending_outpoints': [{'tx_index': 4782650746227828, 'n': 12}], 'n': 0, 'tx_index': 2419824226036934, 'script': '001486fbcfeebcd76e8ae8d25f452dac5619de218060', 'addr': 'bc1qsmaulm4u6ahg46xjtazjmtzkr80zrqrq2kce9h'}}, {'sequence': 4294967295, 'witness': '0247304402206eaa153f37f739c790a5cd53e21cd9ac51df0457dcf26bd6d04931730d4518c0022077bc6bcaf781a5578471afb6b74bb615a6d3fc431c55f72084942c36c378617f012103b69f8c4725b1e306253cbd5a98e7c95e41d1391152e2b8c1bbb07f338a5c5bdd', 'script': '', 'index': 13, 'prev_out': {'type': 0, 'spent': True, 'value': 82602740, 'spending_outpoints': [{'tx_index': 4782650746227828, 'n': 13}], 'n': 0, 'tx_index': 6315533695345651, 'script': '001486fbcfeebcd76e8ae8d25f452dac5619de218060', 'addr': 'bc1qsmaulm4u6ahg46xjtazjmtzkr80zrqrq2kce9h'}}, {'sequence': 4294967295, 'witness': '0247304402204db85bfd3057150be2c825847ecc6b83e4da28e9d9a6f7903bac119f27456efc02202400758710ffa41be3a7ea420889d472eb18961b35453c129960be9e6ec4ba71012103b69f8c4725b1e306253cbd5a98e7c95e41d1391152e2b8c1bbb07f338a5c5bdd', 'script': '', 'index': 14, 'prev_out': {'type': 0, 'spent': True, 'value': 86301370, 'spending_outpoints': [{'tx_index': 4782650746227828, 'n': 14}], 'n': 0, 'tx_index': 3894410249247530, 'script': '001486fbcfeebcd76e8ae8d25f452dac5619de218060', 'addr': 'bc1qsmaulm4u6ahg46xjtazjmtzkr80zrqrq2kce9h'}}, {'sequence': 4294967295, 'witness': '02483045022100847ca077ddc39ceb88869abde4e73b2214e0914ec1bac55ac02aeb8050c29ad4022040ea5b4aaf4c811ba49a35f212291a574f854660bdaf8361e41601e34840531c012103b69f8c4725b1e306253cbd5a98e7c95e41d1391152e2b8c1bbb07f338a5c5bdd', 'script': '', 'index': 15, 'prev_out': {'type': 0, 'spent': True, 'value': 89178082, 'spending_outpoints': [{'tx_index': 4782650746227828, 'n': 15}], 'n': 0, 'tx_index': 2283379289301636, 'script': '001486fbcfeebcd76e8ae8d25f452dac5619de218060', 'addr': 'bc1qsmaulm4u6ahg46xjtazjmtzkr80zrqrq2kce9h'}}, {'sequence': 4294967295, 'witness': '024830450221008e7d9b36ac5b123788de06a7e41659299926cdfdd9a0bfb5bf3a25028475bb6d0220415815f7716a4f917742ae1319f79d0f28bbce10943fb29401d1fc46a4a5460f012103b69f8c4725b1e306253cbd5a98e7c95e41d1391152e2b8c1bbb07f338a5c5bdd', 'script': '', 'index': 16, 'prev_out': {'type': 0, 'spent': True, 'value': 111361528, 'spending_outpoints': [{'tx_index': 4782650746227828, 'n': 16}], 'n': 0, 'tx_index': 235570821767828, 'script': '001486fbcfeebcd76e8ae8d25f452dac5619de218060', 'addr': 'bc1qsmaulm4u6ahg46xjtazjmtzkr80zrqrq2kce9h'}}, {'sequence': 4294967295, 'witness': '024730440220153b2015e02e6157649c3891c995fcf201b6d7a38caac3043b86b4ffbeae0bd2022063135d05edcc04c2ec543fa8a0aeab735774ae720d45bd61cd4fd329fe200596012103b69f8c4725b1e306253cbd5a98e7c95e41d1391152e2b8c1bbb07f338a5c5bdd', 'script': '', 'index': 17, 'prev_out': {'type': 0, 'spent': True, 'value': 120556000, 'spending_outpoints': [{'tx_index': 4782650746227828, 'n': 17}], 'n': 0, 'tx_index': 3854092706052724, 'script': '001486fbcfeebcd76e8ae8d25f452dac5619de218060', 'addr': 'bc1qsmaulm4u6ahg46xjtazjmtzkr80zrqrq2kce9h'}}, {'sequence': 4294967295, 'witness': '02473044022001a8f9d56d126f6d5ca5236b0a64ee1f1ccece5aea733fab8c6dd6286ceabb4f02207e9999ffa02c464d10164172c3d1e04c268826a943fd41bd3fdc189ebac33f22012103b69f8c4725b1e306253cbd5a98e7c95e41d1391152e2b8c1bbb07f338a5c5bdd', 'script': '', 'index': 18, 'prev_out': {'type': 0, 'spent': True, 'value': 125000000, 'spending_outpoints': [{'tx_index': 4782650746227828, 'n': 18}], 'n': 0, 'tx_index': 6655348806515837, 'script': '001486fbcfeebcd76e8ae8d25f452dac5619de218060', 'addr': 'bc1qsmaulm4u6ahg46xjtazjmtzkr80zrqrq2kce9h'}}, {'sequence': 4294967295, 'witness': '0247304402202797b1ae73779386e943662669ea36ae8ad18fb4eea4c76afa1272657c1a920702205017607e68968bc2a6b9a076f8a270de1ac3bf62d56f8825fe50a07af1d09af3012103b69f8c4725b1e306253cbd5a98e7c95e41d1391152e2b8c1bbb07f338a5c5bdd', 'script': '', 'index': 19, 'prev_out': {'type': 0, 'spent': True, 'value': 125000000, 'spending_outpoints': [{'tx_index': 4782650746227828, 'n': 19}], 'n': 0, 'tx_index': 2121360531008814, 'script': '001486fbcfeebcd76e8ae8d25f452dac5619de218060', 'addr': 'bc1qsmaulm4u6ahg46xjtazjmtzkr80zrqrq2kce9h'}}, {'sequence': 4294967295, 'witness': '0247304402203879c5f8323b938b58e1a35496e01ef1f17ab888a5dc0dc51baf4915dd9a76b8022044cd6799b9a0d4d74bdc2c7e1f8688cf600fe97f20f70b51876784ea9fd142e3012103b69f8c4725b1e306253cbd5a98e7c95e41d1391152e2b8c1bbb07f338a5c5bdd', 'script': '', 'index': 20, 'prev_out': {'type': 0, 'spent': True, 'value': 129166667, 'spending_outpoints': [{'tx_index': 4782650746227828, 'n': 20}], 'n': 0, 'tx_index': 2161202176883938, 'script': '001486fbcfeebcd76e8ae8d25f452dac5619de218060', 'addr': 'bc1qsmaulm4u6ahg46xjtazjmtzkr80zrqrq2kce9h'}}, {'sequence': 4294967295, 'witness': '02483045022100ce72c015eefe55d30d8e95017154a20fecccac1a7878afb72967907d72c5e846022062aa157b3cef1d4e44eb08a38e9b992422ecb48658f22b69918b0bb5c1861d3f012103b69f8c4725b1e306253cbd5a98e7c95e41d1391152e2b8c1bbb07f338a5c5bdd', 'script': '', 'index': 21, 'prev_out': {'type': 0, 'spent': True, 'value': 129166667, 'spending_outpoints': [{'tx_index': 4782650746227828, 'n': 21}], 'n': 0, 'tx_index': 6914150648950850, 'script': '001486fbcfeebcd76e8ae8d25f452dac5619de218060', 'addr': 'bc1qsmaulm4u6ahg46xjtazjmtzkr80zrqrq2kce9h'}}, {'sequence': 4294967295, 'witness': '0247304402206cce06447d820639cac2dabd2c6726e63b435ac9a8b36d275a8e5dfa5c00fd9f02200471f7afa826def68d355d484064d2b393ec27de8acdb2ef0c7d6bc33e21eb6c012103b69f8c4725b1e306253cbd5a98e7c95e41d1391152e2b8c1bbb07f338a5c5bdd', 'script': '', 'index': 22, 'prev_out': {'type': 0, 'spent': True, 'value': 129166667, 'spending_outpoints': [{'tx_index': 4782650746227828, 'n': 22}], 'n': 0, 'tx_index': 6706956719569420, 'script': '001486fbcfeebcd76e8ae8d25f452dac5619de218060', 'addr': 'bc1qsmaulm4u6ahg46xjtazjmtzkr80zrqrq2kce9h'}}, {'sequence': 4294967295, 'witness': '02483045022100f41197ceac2448132cde8a97bafa71f315e9aeea0293a29b1d6c046fbda0198502205148bcb6ca367c27ccf0bdf0f988f027086bd4bffe06e970755e9d5a5846046e012103b69f8c4725b1e306253cbd5a98e7c95e41d1391152e2b8c1bbb07f338a5c5bdd', 'script': '', 'index': 23, 'prev_out': {'type': 0, 'spent': True, 'value': 215277000, 'spending_outpoints': [{'tx_index': 4782650746227828, 'n': 23}], 'n': 0, 'tx_index': 2016377116791630, 'script': '001486fbcfeebcd76e8ae8d25f452dac5619de218060', 'addr': 'bc1qsmaulm4u6ahg46xjtazjmtzkr80zrqrq2kce9h'}}, {'sequence': 4294967295, 'witness': '02473044022025f910df71da0f43d87b89d4168d7e03feb6b5b5460fd11243a7db801ba70f74022003d6a64b1de1339438ea97051b28220d72e76c61898009e7cdd28e87298cc0d4012103b69f8c4725b1e306253cbd5a98e7c95e41d1391152e2b8c1bbb07f338a5c5bdd', 'script': '', 'index': 24, 'prev_out': {'type': 0, 'spent': True, 'value': 308130000, 'spending_outpoints': [{'tx_index': 4782650746227828, 'n': 24}], 'n': 0, 'tx_index': 7619265109509504, 'script': '001486fbcfeebcd76e8ae8d25f452dac5619de218060', 'addr': 'bc1qsmaulm4u6ahg46xjtazjmtzkr80zrqrq2kce9h'}}, {'sequence': 4294967295, 'witness': '0247304402203b05d210f8a3cf44ee5e7e237585ef3c09ff1215d42b6a0ab258ef7236332cb6022046c163db7a1351e1b6c2599d9ba571be9af6daf1ef2017f18ab159af0eba65e9012103b69f8c4725b1e306253cbd5a98e7c95e41d1391152e2b8c1bbb07f338a5c5bdd', 'script': '', 'index': 25, 'prev_out': {'type': 0, 'spent': True, 'value': 430733300, 'spending_outpoints': [{'tx_index': 4782650746227828, 'n': 25}], 'n': 0, 'tx_index': 4120165828539187, 'script': '001486fbcfeebcd76e8ae8d25f452dac5619de218060', 'addr': 'bc1qsmaulm4u6ahg46xjtazjmtzkr80zrqrq2kce9h'}}, {'sequence': 4294967295, 'witness': '02473044022015250381dc32eb84a1db810550e1fa871c7735691e48071d3f197372c3ee9ce90220666ca1213dc3777d1163e09c7d4d9f802702f8e1dab1d196767fd20aceb80b17012103b69f8c4725b1e306253cbd5a98e7c95e41d1391152e2b8c1bbb07f338a5c5bdd', 'script': '', 'index': 26, 'prev_out': {'type': 0, 'spent': True, 'value': 473611000, 'spending_outpoints': [{'tx_index': 4782650746227828, 'n': 26}], 'n': 0, 'tx_index': 353177183621819, 'script': '001486fbcfeebcd76e8ae8d25f452dac5619de218060', 'addr': 'bc1qsmaulm4u6ahg46xjtazjmtzkr80zrqrq2kce9h'}}, {'sequence': 4294967295, 'witness': '02483045022100cea58815fee7c1df6da644c2665429fa051f2ac686dab3a9e71bb2e577e9096102204613557ec426d5dc075b2be818dd32f6427852630801435751e3813c4055216c012103b69f8c4725b1e306253cbd5a98e7c95e41d1391152e2b8c1bbb07f338a5c5bdd', 'script': '', 'index': 27, 'prev_out': {'type': 0, 'spent': True, 'value': 679500000, 'spending_outpoints': [{'tx_index': 4782650746227828, 'n': 27}], 'n': 0, 'tx_index': 697223691860597, 'script': '001486fbcfeebcd76e8ae8d25f452dac5619de218060', 'addr': 'bc1qsmaulm4u6ahg46xjtazjmtzkr80zrqrq2kce9h'}}, {'sequence': 4294967295, 'witness': '02483045022100975523d0c248df485fd519a96bbcd2e19cb99b9db07eb89590cc7864786365e20220767c839aebd9cc6affebd37cb96d21db7f151b4cf95ccf1dc2ef39e0cbfb32bd012103b69f8c4725b1e306253cbd5a98e7c95e41d1391152e2b8c1bbb07f338a5c5bdd', 'script': '', 'index': 28, 'prev_out': {'type': 0, 'spent': True, 'value': 727983300, 'spending_outpoints': [{'tx_index': 4782650746227828, 'n': 28}], 'n': 0, 'tx_index': 4943402345014056, 'script': '001486fbcfeebcd76e8ae8d25f452dac5619de218060', 'addr': 'bc1qsmaulm4u6ahg46xjtazjmtzkr80zrqrq2kce9h'}}]","[{'type': 0, 'spent': False, 'value': 4239133848, 'spending_outpoints': [], 'n': 0, 'tx_index': 4782650746227828, 'script': '0014caa7e5d6f5f7e31c744dfa7afb8a145a6d98d1a2', 'addr': 'bc1qe2n7t4h47l33cazdlfa0hzs5tfke35dzj6tzuy'}]",4239133848,1907818227315
b7ee86e77a9242be5599b629393df7a57b56601c8abe46544c43005078e58865,1,3,1,489,981,1771,0.0.0.0,0,3572436474396680,False,1725979253,860763,860763,"[{'sequence': 4294967295, 'witness': '02473044022057c5c4d6c5420e2772167571e863d0f4bb8e10930e019b4f429fee0d64adfcd702205a91d050a67e1e085e277722c2b161dca9d3a95ddcb5a441041960718395a239012102896c93c272e8c9de3a520eed4bb5a91ed1c462ae9c8250fe2dbe34e8e0d31e93', 'script': '', 'index': 0, 'prev_out': {'type': 0, 'spent': True, 'value': 441297152, 'spending_outpoints': [{'tx_index': 3572436474396680, 'n': 0}], 'n': 0, 'tx_index': 4742208385129254, 'script': '0014343fbc7af26b4862e74e7b85b68e76149fe2ee44', 'addr': 'bc1qxslmc7hjddyx9e6w0wzmdrnkzj079mjy2ppy8c'}}, {'sequence': 4294967295, 'witness': '02483045022100eb2edceeb3a4496e26e7589a7546634f961d235e98377cbf670e9d6ed466aa6302204d9eae0280ca0c231379ecda45eec348894b354f9d222c00852970bebe637e99012102896c93c272e8c9de3a520eed4bb5a91ed1c462ae9c8250fe2dbe34e8e0d31e93', 'script': '', 'index': 1, 'prev_out': {'type': 0, 'spent': True, 'value': 870737066, 'spending_outpoints': [{'tx_index': 3572436474396680, 'n': 1}], 'n': 0, 'tx_index': 1872160818816799, 'script': '0014343fbc7af26b4862e74e7b85b68e76149fe2ee44', 'addr': 'bc1qxslmc7hjddyx9e6w0wzmdrnkzj079mjy2ppy8c'}}, {'sequence': 4294967295, 'witness': '02483045022100993414ac353dd6436f4966fd35ca6f6038eb5afdaa107beaea075a8c1cbbe913022003030e8434184c3e7156ac90ffc518c6baa80cec93bad417350f6e918f2d26b0012102896c93c272e8c9de3a520eed4bb5a91ed1c462ae9c8250fe2dbe34e8e0d31e93', 'script': '', 'index': 2, 'prev_out': {'type': 0, 'spent': True, 'value': 1751385910, 'spending_outpoints': [{'tx_index': 3572436474396680, 'n': 2}], 'n': 0, 'tx_index': 7937283255484912, 'script': '0014343fbc7af26b4862e74e7b85b68e76149fe2ee44', 'addr': 'bc1qxslmc7hjddyx9e6w0wzmdrnkzj079mjy2ppy8c'}}]","[{'type': 0, 'spent': False, 'value': 3063418357, 'spending_outpoints': [], 'n': 0, 'tx_index': 3572436474396680, 'script': '0014caa7e5d6f5f7e31c744dfa7afb8a145a6d98d1a2', 'addr': 'bc1qe2n7t4h47l33cazdlfa0hzs5tfke35dzj6tzuy'}]",3063418357,1903579093467
8873a4ac600221de9aac84f9abf063f298431b24f3db6db538c8c53f45d94978,1,3,1,489,981,1771,0.0.0.0,0,4232274340477113,False,1725978815,860762,860762,"[{'sequence': 4294967295, 'witness': '0247304402207757a0adef3e71a8fb7e7b13485e106ead008499acbe34a9c1175994eeafff840220223ed6c6421b9f1ce4dd5568714f9d9a2a1dca1ccd156139d1cb42e47b46927c01210286a4ab8eb4208ad462dbe158a32147517db576260b914931645876a4e76ed71a', 'script': '', 'index': 0, 'prev_out': {'type': 0, 'spent': True, 'value': 12512337016, 'spending_outpoints': [{'tx_index': 4232274340477113, 'n': 0}], 'n': 1, 'tx_index': 7865470851265531, 'script': '001426ab6e49aee3a3050e5dcad396dcf76eba4438ba', 'addr': 'bc1qy64kujdwuw3s2rjaetfedh8hd6aygw96r4qz02'}}, {'sequence': 4294967295, 'witness': '02483045022100cf47d4e6d46dc271e8957296faf8ee7a32d065727ed458ba857b2049aa94a6f902206ea223c42e2242d9cfece03e4dc08f3467f27bc4090817857d00e67de48b3c3e01210286a4ab8eb4208ad462dbe158a32147517db576260b914931645876a4e76ed71a', 'script': '', 'index': 1, 'prev_out': {'type': 0, 'spent': True, 'value': 133500000000, 'spending_outpoints': [{'tx_index': 4232274340477113, 'n': 1}], 'n': 1, 'tx_index': 1976913294274876, 'script': '001426ab6e49aee3a3050e5dcad396dcf76eba4438ba', 'addr': 'bc1qy64kujdwuw3s2rjaetfedh8hd6aygw96r4qz02'}}, {'sequence': 4294967295, 'witness': '02483045022100cbf17711af4be684c7999ec183a295bdbf5bc37877909fc232d56b553a11161e02206e622f86a66d644a8323dc5b84610c583e6dcfb5859032dada0d0ca028014e5c01210286a4ab8eb4208ad462dbe158a32147517db576260b914931645876a4e76ed71a', 'script': '', 'index': 2, 'prev_out': {'type': 0, 'spent': True, 'value': 245500000000, 'spending_outpoints': [{'tx_index': 4232274340477113, 'n': 2}], 'n': 1, 'tx_index': 4466019599785989, 'script': '001426ab6e49aee3a3050e5dcad396dcf76eba4438ba', 'addr': 'bc1qy64kujdwuw3s2rjaetfedh8hd6aygw96r4qz02'}}]","[{'type': 0, 'spent': False, 'value': 391512335245, 'spending_outpoints': [], 'n': 0, 'tx_index': 4232274340477113, 'script': '0014caa7e5d6f5f7e31c744dfa7afb8a145a6d98d1a2', 'addr': 'bc1qe2n7t4h47l33cazdlfa0hzs5tfke35dzj6tzuy'}]",391512335245,1900515675110
b6a75c7f4a95690d85d82bde4ed0e130f4d2d84847b998bf16888e80426ed9ab,1,3,1,487,979,1476,0.0.0.0,0,6046411075359185,False,1725902349,860643,860643,"[{'sequence': 4294967295, 'witness': '0247304402207021e69b482eba79c2fd199585a3fb05ebb582f68470b299342cad6744bc012102205176fcb47b6edb2254c9b8af60c1e900b0b0848828d235910bd011c5092068a6012102896c93c272e8c9de3a520eed4bb5a91ed1c462ae9c8250fe2dbe34e8e0d31e93', 'script': '', 'index': 0, 'prev_out': {'type': 0, 'spent': True, 'value': 2215, 'spending_outpoints': [{'tx_index': 6046411075359185, 'n': 0}], 'n': 1, 'tx_index': 2853662978573608, 'script': '0014343fbc7af26b4862e74e7b85b68e76149fe2ee44', 'addr': 'bc1qxslmc7hjddyx9e6w0wzmdrnkzj079mjy2ppy8c'}}, {'sequence': 4294967295, 'witness': '0247304402207562c006f055426a6ba2b759f91b51948036a157e3e30e15025998e15834b72f022075cf5feb24272b98695e7be61faad86d6c13138e88dfeb04ecfcb9f7b79e8e10012102896c93c272e8c9de3a520eed4bb5a91ed1c462ae9c8250fe2dbe34e8e0d31e93', 'script': '', 'index': 1, 'prev_out': {'type': 0, 'spent': True, 'value': 10000, 'spending_outpoints': [{'tx_index': 6046411075359185, 'n': 1}], 'n': 0, 'tx_index': 1242627419985908, 'script': '0014343fbc7af26b4862e74e7b85b68e76149fe2ee44', 'addr': 'bc1qxslmc7hjddyx9e6w0wzmdrnkzj079mjy2ppy8c'}}, {'sequence': 4294967295, 'witness': '02473044022077fb2fe40a81abb20fa5231a650ddb784462e8f04c0225581ceba3c863466571022037f6efbacdafd320c8b094e7d1e729ae4abb858e6c00e80de43e474ecb25c5e0012102896c93c272e8c9de3a520eed4bb5a91ed1c462ae9c8250fe2dbe34e8e0d31e93', 'script': '', 'index': 2, 'prev_out': {'type': 0, 'spent': True, 'value': 2281836756, 'spending_outpoints': [{'tx_index': 6046411075359185, 'n': 2}], 'n': 0, 'tx_index': 571356329916972, 'script': '0014343fbc7af26b4862e74e7b85b68e76149fe2ee44', 'addr': 'bc1qxslmc7hjddyx9e6w0wzmdrnkzj079mjy2ppy8c'}}]","[{'type': 0, 'spent': False, 'value': 2281847495, 'spending_outpoints': [], 'n': 0, 'tx_index': 6046411075359185, 'script': '0014caa7e5d6f5f7e31c744dfa7afb8a145a6d98d1a2', 'addr': 'bc1qe2n7t4h47l33cazdlfa0hzs5tfke35dzj6tzuy'}]",2281847495,1509003339865
ee1c90678e9a354c6bb08aff4e83e8d67dc2384643cdf347432672e9edc3b1ec,1,3,1,489,981,886,0.0.0.0,0,8327943696494148,False,1725893095,860625,860625,"[{'sequence': 4294967295, 'witness': '02483045022100c41370db3ea335fefdc2f60bde87fb6a46a93df8c729452a335f64e720684f850220079cca2075481687c72ecb7729ea65df2ff98dc868e6b88fdc36c74b26845ba801210306a2f89cde0b3e88c056d8495405ac8b3c4e617a05df4757e9fdbbbd7567ccd2', 'script': '', 'index': 0, 'prev_out': {'type': 0, 'spent': True, 'value': 13966522852, 'spending_outpoints': [{'tx_index': 8327943696494148, 'n': 0}], 'n': 1, 'tx_index': 5550545640831724, 'script': '0014d32e4c7627e06d4be1c27b20606f4eb1094e2b98', 'addr': 'bc1q6vhyca38upk5hcwz0vsxqm6wkyy5u2ucrx4enc'}}, {'sequence': 4294967295, 'witness': '024830450221008df98b91bf620e813e757f82498eb886f2e2e46b662cabbc1604606e424abca402202455fd26f97d13988a270bc82c5bc676ce94749e4711fcddc78da7260f546de501210306a2f89cde0b3e88c056d8495405ac8b3c4e617a05df4757e9fdbbbd7567ccd2', 'script': '', 'index': 1, 'prev_out': {'type': 0, 'spent': True, 'value': 26041694774, 'spending_outpoints': [{'tx_index': 8327943696494148, 'n': 1}], 'n': 1, 'tx_index': 8261039536293864, 'script': '0014d32e4c7627e06d4be1c27b20606f4eb1094e2b98', 'addr': 'bc1q6vhyca38upk5hcwz0vsxqm6wkyy5u2ucrx4enc'}}, {'sequence': 4294967295, 'witness': '02473044022074777edf53a485d6dda2b4928cc2a9c85da1c46e9f3bc190cfa3b4abeec0e7980220243d6128e7e47cb2c894a9f8a6433e44e9bd647b5cb36fe7dadc83b2b5d804f401210306a2f89cde0b3e88c056d8495405ac8b3c4e617a05df4757e9fdbbbd7567ccd2', 'script': '', 'index': 2, 'prev_out': {'type': 0, 'spent': True, 'value': 39989977352, 'spending_outpoints': [{'tx_index': 8327943696494148, 'n': 2}], 'n': 1, 'tx_index': 3058142441330572, 'script': '0014d32e4c7627e06d4be1c27b20606f4eb1094e2b98', 'addr': 'bc1q6vhyca38upk5hcwz0vsxqm6wkyy5u2ucrx4enc'}}]","[{'type': 0, 'spent': False, 'value': 79998194092, 'spending_outpoints': [], 'n': 0, 'tx_index': 8327943696494148, 'script': '0014caa7e5d6f5f7e31c744dfa7afb8a145a6d98d1a2', 'addr': 'bc1qe2n7t4h47l33cazdlfa0hzs5tfke35dzj6tzuy'}]",79998194092,1506721492370
eb04a1a2ba80dc3841df14fe5d42204b9312abffd639dd76979bbacbdfd46ada,1,7,1,1084,2068,1868,0.0.0.0,0,7684875930400595,False,1725893095,860625,860625,"[{'sequence': 4294967295, 'witness': '0247304402201ca2054a492b6102c4556a4b6555feca8af1ae9de78f14dda40ca5ed7219eaea0220756c94ee7a7acb82f27e4993a5cfe7906107bc231226bfb6f86214c5982f9e870121027336f7fff165fbd015246f96a9453d456c4ec96ab406814d7f50e2b0e6033080', 'script': '', 'index': 0, 'prev_out': {'type': 0, 'spent': True, 'value': 35000000000, 'spending_outpoints': [{'tx_index': 7684875930400595, 'n': 0}], 'n': 0, 'tx_index': 3569032254898157, 'script': '001487d3d73112913d62824d0437ba120328d0a0c204', 'addr': 'bc1qslfawvgjjy7k9qjdqsmm5ysr9rg2pssya6ehfe'}}, {'sequence': 4294967295, 'witness': '0247304402207c1c4f2d2c205fb13c89f59d6298d83af27cf0924ecfe15594f388c5bec76c3202206e748d0741294bb331d64a7956011e9bcf2512774bdca4e9ce311e87299c3b880121028cb99d9d871967cdb227fef9cd552e3a8abd158bfd41b0d322fdbec8c54c857f', 'script': '', 'index': 1, 'prev_out': {'type': 0, 'spent': True, 'value': 40000000000, 'spending_outpoints': [{'tx_index': 7684875930400595, 'n': 1}], 'n': 1, 'tx_index': 7438527536988359, 'script': '00145867e5a0bfc29eb1b00b1e9534ff1fa624bac925', 'addr': 'bc1qtpn7tg9lc20trvqtr62nflcl5cjt4jf9slq5w2'}}, {'sequence': 4294967295, 'witness': '02483045022100e534e0d45d70496920aed3ea91069e59479a74a8afb9fc7a2e5f181d0438c33202201e69694d7ee05d8bc86efe0d8f6fa2d51c2f70c1b08a94c5f6b34f07aef175d1012103927019085f1b8a11ca64b0b6e17fd0211a4389dd221b7093f86d3ad2226e5c36', 'script': '', 'index': 2, 'prev_out': {'type': 0, 'spent': True, 'value': 3600, 'spending_outpoints': [{'tx_index': 7684875930400595, 'n': 2}], 'n': 0, 'tx_index': 8903524532782928, 'script': '0014860ea146ea068fc7f76d42f8142df6a904fb937f', 'addr': 'bc1qsc82z3h2q68u0amdgtupgt0k4yz0hymlauf9lk'}}, {'sequence': 4294967295, 'witness': '02483045022100b537dc858f77a92b9f6fc371807249d4aa9468902f3c6dfbc1eefc8f05ce8a9702201aab76651f9439e64ef0c27a10df3874fbec464827b44e4ff67fbe195e93dd4d012103927019085f1b8a11ca64b0b6e17fd0211a4389dd221b7093f86d3ad2226e5c36', 'script': '', 'index': 3, 'prev_out': {'type': 0, 'spent': True, 'value': 10000, 'spending_outpoints': [{'tx_index': 7684875930400595, 'n': 3}], 'n': 0, 'tx_index': 3609452241781770, 'script': '0014860ea146ea068fc7f76d42f8142df6a904fb937f', 'addr': 'bc1qsc82z3h2q68u0amdgtupgt0k4yz0hymlauf9lk'}}, {'sequence': 4294967295, 'witness': '02483045022100c097502deadb401319e92c7c95848a76d9a1cb620335c7082ddbc5daa17cc22e02200f4b889b1fb58b468f191f2e80c339aa460762f7f1cb57950ea355f0172c7a22012103927019085f1b8a11ca64b0b6e17fd0211a4389dd221b7093f86d3ad2226e5c36', 'script': '', 'index': 4, 'prev_out': {'type': 0, 'spent': True, 'value': 100000000, 'spending_outpoints': [{'tx_index': 7684875930400595, 'n': 4}], 'n': 0, 'tx_index': 8503011281741159, 'script': '0014860ea146ea068fc7f76d42f8142df6a904fb937f', 'addr': 'bc1qsc82z3h2q68u0amdgtupgt0k4yz0hymlauf9lk'}}, {'sequence': 4294967295, 'witness': '02483045022100f18073157755592e8013daed7856eec1de89502ec1c828f32cf3342efc63cfb9022024098e672eb5d5a9d60959f5997f670dce2989a53abf9ed1e1b1f0b5aa2ed00c012103927019085f1b8a11ca64b0b6e17fd0211a4389dd221b7093f86d3ad2226e5c36', 'script': '', 'index': 5, 'prev_out': {'type': 0, 'spent': True, 'value': 29099717393, 'spending_outpoints': [{'tx_index': 7684875930400595, 'n': 5}], 'n': 1, 'tx_index': 3052989507161731, 'script': '0014860ea146ea068fc7f76d42f8142df6a904fb937f', 'addr': 'bc1qsc82z3h2q68u0amdgtupgt0k4yz0hymlauf9lk'}}, {'sequence': 4294967295, 'witness': '02483045022100c87955c4a9bdf08586d932110e43a5d61683e6599b542fb02a7957a36e435981022025efd2fa5eb15b02a122eeaf7f6251af5322e230bd921f60a280be62833c9343012103927019085f1b8a11ca64b0b6e17fd0211a4389dd221b7093f86d3ad2226e5c36', 'script': '', 'index': 6, 'prev_out': {'type': 0, 'spent': True, 'value': 29999990000, 'spending_outpoints': [{'tx_index': 7684875930400595, 'n': 6}], 'n': 0, 'tx_index': 7977781240033669, 'script': '0014860ea146ea068fc7f76d42f8142df6a904fb937f', 'addr': 'bc1qsc82z3h2q68u0amdgtupgt0k4yz0hymlauf9lk'}}]","[{'type': 0, 'spent': False, 'value': 134199719125, 'spending_outpoints': [], 'n': 0, 'tx_index': 7684875930400595, 'script': '0014caa7e5d6f5f7e31c744dfa7afb8a145a6d98d1a2', 'addr': 'bc1qe2n7t4h47l33cazdlfa0hzs5tfke35dzj6tzuy'}]",134199719125,1426723298278
08ea0f88ed84650a1e08d66598bf776832ebded72259d1d5aad1a62dd52ce18b,1,9,1,1379,2609,2362,0.0.0.0,0,4921575554266330,False,1725892696,860625,860625,"[{'sequence': 4294967295, 'witness': '02473044022027db1bba2e324cb5e130e4a4cdc5f693f9f3b08dc2125aeccc6185839aa3023e022014c5aa125dd17506d9c2687cbe316571b89a7337074d8a85a8700aa80cc5174401210368e0b26296fa0bf21f146c90afadffdbd6958359ab820c956a3dc409ff3403ad', 'script': '', 'index': 0, 'prev_out': {'type': 0, 'spent': True, 'value': 445643971, 'spending_outpoints': [{'tx_index': 4921575554266330, 'n': 0}], 'n': 0, 'tx_index': 5499391964163827, 'script': '00140cebe66a64fc247126de992f1743f76d709c5d07', 'addr': 'bc1qpn47v6nylsj8zfk7nyh3wslhd4cfchg8h46nvf'}}, {'sequence': 4294967295, 'witness': '0247304402203f40865931a4b411e7e0f6c299211889ddc5ed50c1bd450da5aa99f9900dde6802200b297001bff945ddfdc46c83469daebdec1e3fb509ed7a713bddb1d4b79cf4ae0121028682e5b8b55a50c0ae6e245838e2f71f41fc8ae0c14753d544d4f010e694ffd4', 'script': '', 'index': 1, 'prev_out': {'type': 0, 'spent': True, 'value': 29077610420, 'spending_outpoints': [{'tx_index': 4921575554266330, 'n': 1}], 'n': 1, 'tx_index': 862798772358119, 'script': '0014f33934ff89baf3485aea80531a49e31757141615', 'addr': 'bc1q7vunflufhte5skh2spf35j0rzat3g9s45rnut7'}}, {'sequence': 4294967295, 'witness': '024730440220705ea155280420cb93f021cda2a1b7f76469ca2df9559ac11703b73b8af45fcc022068c3cdd0f8feda25ca64e58bc15308238a8cb68118d85f43d3f02f6fa587b80e012102fe068e9ef9dcb564256e5b540a1c67f41f294f7f5365773ad1f41d21e433ed96', 'script': '', 'index': 2, 'prev_out': {'type': 0, 'spent': True, 'value': 29077635775, 'spending_outpoints': [{'tx_index': 4921575554266330, 'n': 2}], 'n': 0, 'tx_index': 955230390114446, 'script': '001426c9d19f24ab1c3e34a1ea0aeef26a5f3b8ffdf7', 'addr': 'bc1qymyar8ey4vwrud9pag9waun2tuacll0hr9am7d'}}, {'sequence': 4294967295, 'witness': '02483045022100dd14cf2a75bb17a4d29162d131f7f68fb43012e499099eb922199e55e8f462480220752d43f5afc386b225f5a4a482222d346032aea4eb3c320920de99c0b4b1aa8d012102a98a52c845ab4a52b7c9975c33e02ca6dc7338befb1904ef58b6edbb5f4d1460', 'script': '', 'index': 3, 'prev_out': {'type': 0, 'spent': True, 'value': 40000000000, 'spending_outpoints': [{'tx_index': 4921575554266330, 'n': 3}], 'n': 1, 'tx_index': 7244590739387730, 'script': '0014f2c9aed1dd08ced96fb2c3d05761c4e17f720ab9', 'addr': 'bc1q7ty6a5wapr8djmajc0g9wcwyu9lhyz4e6pa9ry'}}, {'sequence': 4294967295, 'witness': '02483045022100852f368eaa90cb104815145aeb2dafb58dfb034232f30662dc276d53f35f8c100220596ca8cc97a1ae8dce768ccef2c943ebf501df1d731af4fadc8c3c611101d047012103051557376a57d2d28696f2531ff1065f13b6ae4c5983bfa238f185176dec57c4', 'script': '', 'index': 4, 'prev_out': {'type': 0, 'spent': True, 'value': 40700000000, 'spending_outpoints': [{'tx_index': 4921575554266330, 'n': 4}], 'n': 0, 'tx_index': 4541602665983646, 'script': '0014a9e5c518e9863e1129cc6cf07387ba0df368a15e', 'addr': 'bc1q48ju2x8fsclpz2wvdnc88pa6phek3g27h9heay'}}, {'sequence': 4294967295, 'witness': '024830450221008b151972944927719f02577ee6589326911ff048ea14e00a63aa0a3735df38a1022003c035b129dc78a8003b53028899eb8dfb1e80860d11cdee79f3b3df186eb2eb0121030707b2e2b8214d86fe59a1fd78b60e4e9f4bedd8109ab98167c8c04672d7c55b', 'script': '', 'index': 5, 'prev_out': {'type': 0, 'spent': True, 'value': 45000000000, 'spending_outpoints': [{'tx_index': 4921575554266330, 'n': 5}], 'n': 0, 'tx_index': 2486067366363387, 'script': '0014945600560250fddf01431a583edee130fe83dc97', 'addr': 'bc1qj3tqq4sz2r7a7q2rrfvrahhpxrlg8hyhjpxhvj'}}, {'sequence': 4294967295, 'witness': '02483045022100bcdc8d11f1970b69ee1b1c8bd949eef8a1bfed272f3aa945046fcad359da24c5022041d626e3db2cf948a33d6122ed3c152f2f52984572a4e308f9678380e75735f301210368e0b26296fa0bf21f146c90afadffdbd6958359ab820c956a3dc409ff3403ad', 'script': '', 'index': 6, 'prev_out': {'type': 0, 'spent': True, 'value': 45000000000, 'spending_outpoints': [{'tx_index': 4921575554266330, 'n': 6}], 'n': 1, 'tx_index': 3626210525155673, 'script': '00140cebe66a64fc247126de992f1743f76d709c5d07', 'addr': 'bc1qpn47v6nylsj8zfk7nyh3wslhd4cfchg8h46nvf'}}, {'sequence': 4294967295, 'witness': '0247304402200e5aece376b9ac5fe213104387da87d242213018d9378bd185d171fa36d63c7802202c0a5a0e3fec2e4a656af60689e9c3afbcb64ef0f2fb228cfb3c7f5872a463bd012103051557376a57d2d28696f2531ff1065f13b6ae4c5983bfa238f185176dec57c4', 'script': '', 'index': 7, 'prev_out': {'type': 0, 'spent': True, 'value': 50000000000, 'spending_outpoints': [{'tx_index': 4921575554266330, 'n': 7}], 'n': 1, 'tx_index': 4988195228202449, 'script': '0014a9e5c518e9863e1129cc6cf07387ba0df368a15e', 'addr': 'bc1q48ju2x8fsclpz2wvdnc88pa6phek3g27h9heay'}}, {'sequence': 4294967295, 'witness': '02473044022070440ab570ec58100b18a7e7095d1c56f03d5d3c8f6041a22b0df8dbd91f9b3e02202400cfa5900dd3a055a839975c749e3950dc3a7dcf0286a31c374a1e4635f544012102fe068e9ef9dcb564256e5b540a1c67f41f294f7f5365773ad1f41d21e433ed96', 'script': '', 'index': 8, 'prev_out': {'type': 0, 'spent': True, 'value': 50700000000, 'spending_outpoints': [{'tx_index': 4921575554266330, 'n': 8}], 'n': 0, 'tx_index': 8457768236648685, 'script': '001426c9d19f24ab1c3e34a1ea0aeef26a5f3b8ffdf7', 'addr': 'bc1qymyar8ey4vwrud9pag9waun2tuacll0hr9am7d'}}]","[{'type': 0, 'spent': False, 'value': 330000887804, 'spending_outpoints': [], 'n': 0, 'tx_index': 4921575554266330, 'script': '0014caa7e5d6f5f7e31c744dfa7afb8a145a6d98d1a2', 'addr': 'bc1qe2n7t4h47l33cazdlfa0hzs5tfke35dzj6tzuy'}]",330000887804,1292523579153
1977a6ba7871f00dd3ff2f1c00cb876f92b646a52d032bce786fe46f2298b8e6,1,12,1,1824,3423,3100,0.0.0.0,0,8117776024468621,False,1725893095,860625,860625,"[{'sequence': 4294967295, 'witness': '02483045022100d61e471322424d7976a77779a1614e98439ca579c94842eb93ab869d951607120220083656447a60b2c478613cb142ad25f8b39e5cdd9876282ea381724d5857a24e012103869c0e8849d484bbefad18f69a1e582f832d199fd968181ce3306eef097c52f7', 'script': '', 'index': 0, 'prev_out': {'type': 0, 'spent': True, 'value': 40000000000, 'spending_outpoints': [{'tx_index': 8117776024468621, 'n': 0}], 'n': 1, 'tx_index': 2062129758531935, 'script': '001437940d44ab6f05d4e76afb447018733ff2f67fa4', 'addr': 'bc1qx72q639tduzafem2ldz8qxrn8le0vlayz4x49n'}}, {'sequence': 4294967295, 'witness': '02473044022058e3f3f7d8073bdab45006a9e218595c4f24a4e95e1483f2e6453ebbaaaf5db302203876a58cbaf4588af155c84117498329e4d5c0d7605f07ee6259f778ea7d5df70121037a09374df35ab0490a4f08f76cc24d0649bb28c0a51ebf064f3f6021c5a5b38a', 'script': '', 'index': 1, 'prev_out': {'type': 0, 'spent': True, 'value': 40000000000, 'spending_outpoints': [{'tx_index': 8117776024468621, 'n': 1}], 'n': 1, 'tx_index': 1527366072734021, 'script': '0014260be36860eb23e189a2e43bfbb97c0bedd6a2c8', 'addr': 'bc1qyc97x6rqav37rzdzusalhwtup0kadgkgm2d0j4'}}, {'sequence': 4294967295, 'witness': '0247304402207edc864cdd048ec90b5e024f314b2c59c467dab3458422060bc60239a88a4bbc0220263ffe6ad8bffe9a052905f461420f77909467bc5c8677e3a4d468b813ffbf18012102d8eb3e550917f49e8bc6936d13c7e672deb4957c80b40e8052468b37e8afc483', 'script': '', 'index': 2, 'prev_out': {'type': 0, 'spent': True, 'value': 40200000000, 'spending_outpoints': [{'tx_index': 8117776024468621, 'n': 2}], 'n': 0, 'tx_index': 8764271517080258, 'script': '001437d7a09e8775094ca5a4150141728bbf3cbed1fc', 'addr': 'bc1qxlt6p858w5y5efdyz5q5zu5thu7ta50uuhujc2'}}, {'sequence': 4294967295, 'witness': '02483045022100eac9cc4469a88125a0595cbf40a9ba9f391c5716048d39251c43f76f78992626022043d5fdad65a6068a589ce73c5497df4a2282ae649dff440d4553f0243954dbec012102d8eb3e550917f49e8bc6936d13c7e672deb4957c80b40e8052468b37e8afc483', 'script': '', 'index': 3, 'prev_out': {'type': 0, 'spent': True, 'value': 45000000000, 'spending_outpoints': [{'tx_index': 8117776024468621, 'n': 3}], 'n': 1, 'tx_index': 3498477809479229, 'script': '001437d7a09e8775094ca5a4150141728bbf3cbed1fc', 'addr': 'bc1qxlt6p858w5y5efdyz5q5zu5thu7ta50uuhujc2'}}, {'sequence': 4294967295, 'witness': '0248304502210088a304e73180b5578464b1d9836c827432a1b9c2d21fb72d02ba71ed7b7dd74802207a1d4243445426b20fff9cb04bed86170c99eda016641083ee5e7823c21d75db012103869c0e8849d484bbefad18f69a1e582f832d199fd968181ce3306eef097c52f7', 'script': '', 'index': 4, 'prev_out': {'type': 0, 'spent': True, 'value': 45200000000, 'spending_outpoints': [{'tx_index': 8117776024468621, 'n': 4}], 'n': 0, 'tx_index': 8091630765293910, 'script': '001437940d44ab6f05d4e76afb447018733ff2f67fa4', 'addr': 'bc1qx72q639tduzafem2ldz8qxrn8le0vlayz4x49n'}}, {'sequence': 4294967295, 'witness': '0247304402207c14d39f167de2f2a2a1f2aa81ede01c0eba5071c2dbaaf36ee405b41d43179402202d64477ff1336801e53b5960124c0b5d9a0b334514ff2763fd3bb7e3281f079d0121037a09374df35ab0490a4f08f76cc24d0649bb28c0a51ebf064f3f6021c5a5b38a', 'script': '', 'index': 5, 'prev_out': {'type': 0, 'spent': True, 'value': 50000000000, 'spending_outpoints': [{'tx_index': 8117776024468621, 'n': 5}], 'n': 0, 'tx_index': 4444896447952805, 'script': '0014260be36860eb23e189a2e43bfbb97c0bedd6a2c8', 'addr': 'bc1qyc97x6rqav37rzdzusalhwtup0kadgkgm2d0j4'}}, {'sequence': 4294967295, 'witness': '02473044022046e6c18b7434f1af3304f992ad1930fcbd95892f8d370f7f6d6dbd3054e0682002203dfc58f95743e601aa8dfad08e51c1f6d555591d3dc6e2e7c430e22760467d030121024b6946ac5d32ab9fe91e5aa8930b5e89b325f2c4da6259ba7383299a29f91fbe', 'script': '', 'index': 6, 'prev_out': {'type': 0, 'spent': True, 'value': 50000000000, 'spending_outpoints': [{'tx_index': 8117776024468621, 'n': 6}], 'n': 1, 'tx_index': 8827975908805395, 'script': '00148b5d55a99b9beebd8a067caa388b9f61639bacfa', 'addr': 'bc1q3dw4t2vmn0htmzsx0j4r3zulv93eht86t6vrdl'}}, {'sequence': 4294967295, 'witness': '02483045022100c4ed9f0c5e7253ddfe3bf4fcfa12596ab0ee1ba66ba8f021a7d668fe43aec92f0220168e57457782e465a0270e7b840ec68cf0cd5edf57a400c89e7e4658865d499e012103dea65b7a7682217456cf212c59ba9c57a90a1599d297bee984fb43249aaa964c', 'script': '', 'index': 7, 'prev_out': {'type': 0, 'spent': True, 'value': 50200000000, 'spending_outpoints': [{'tx_index': 8117776024468621, 'n': 7}], 'n': 0, 'tx_index': 389210860954275, 'script': '001453df4a1cbbc21b838217492e2e416acced9a3ce2', 'addr': 'bc1q2005589mcgdc8qshfyhzust2enke508z6xpttu'}}, {'sequence': 4294967295, 'witness': '0247304402200f3bb0f8a1f6891708edaea6a9333997d21c3d4075bbb6050b770d722159b8e1022056d6f7c80c706bfa20be38f8c45311a5d62955732f66293cbed9bb11b29392950121024b6946ac5d32ab9fe91e5aa8930b5e89b325f2c4da6259ba7383299a29f91fbe', 'script': '', 'index': 8, 'prev_out': {'type': 0, 'spent': True, 'value': 60000000000, 'spending_outpoints': [{'tx_index': 8117776024468621, 'n': 8}], 'n': 0, 'tx_index': 5762930016735747, 'script': '00148b5d55a99b9beebd8a067caa388b9f61639bacfa', 'addr': 'bc1q3dw4t2vmn0htmzsx0j4r3zulv93eht86t6vrdl'}}, {'sequence': 4294967295, 'witness': '0247304402202080981075eb8b9d1367a0518a7cc65c36f524b8a7d533e340326b6de1d5792c02207bafacd9bae20253befb29aab0fdfbc617d1c4e29274290e72d808d703b310200121036433cd7cf9bf55d42a5ac11f2b828c0bc5a2fa94df9bcfe79d0270ea2264a062', 'script': '', 'index': 9, 'prev_out': {'type': 0, 'spent': True, 'value': 871780, 'spending_outpoints': [{'tx_index': 8117776024468621, 'n': 9}], 'n': 1, 'tx_index': 8903524532782928, 'script': '001472b1854f6b091a082eed8f0a4191b73de36c5a84', 'addr': 'bc1qw2cc2nmtpydqsthd3u9yrydh8h3kck5y3p2kpk'}}, {'sequence': 4294967295, 'witness': '0247304402205b40f949395ffeee306fa2d543bf23344ad80f8e9e6276c00d1e449e3026fc0b02207cba90c3e92671292ee458726ace63e2e2f257567e4368112cedbaf1bc4602500121036433cd7cf9bf55d42a5ac11f2b828c0bc5a2fa94df9bcfe79d0270ea2264a062', 'script': '', 'index': 10, 'prev_out': {'type': 0, 'spent': True, 'value': 20014432721, 'spending_outpoints': [{'tx_index': 8117776024468621, 'n': 10}], 'n': 1, 'tx_index': 4509199645915452, 'script': '001472b1854f6b091a082eed8f0a4191b73de36c5a84', 'addr': 'bc1qw2cc2nmtpydqsthd3u9yrydh8h3kck5y3p2kpk'}}, {'sequence': 4294967295, 'witness': '02483045022100cbf5a04c2f240823f9928b0031ab5a2c7e0f5c01d62aa9082a34086d7fc2ec9602207cf9ed6face3142a2d1771e9e068e0c66047e2f938d36fac2dbb220dd2d480a90121036433cd7cf9bf55d42a5ac11f2b828c0bc5a2fa94df9bcfe79d0270ea2264a062', 'script': '', 'index': 11, 'prev_out': {'type': 0, 'spent': True, 'value': 29384447681, 'spending_outpoints': [{'tx_index': 8117776024468621, 'n': 11}], 'n': 1, 'tx_index': 5806423783516112, 'script': '001472b1854f6b091a082eed8f0a4191b73de36c5a84', 'addr': 'bc1qw2cc2nmtpydqsthd3u9yrydh8h3kck5y3p2kpk'}}]","[{'type': 0, 'spent': False, 'value': 469999749082, 'spending_outpoints': [], 'n': 0, 'tx_index': 8117776024468621, 'script': '0014caa7e5d6f5f7e31c744dfa7afb8a145a6d98d1a2', 'addr': 'bc1qe2n7t4h47l33cazdlfa0hzs5tfke35dzj6tzuy'}]",469999749082,962522691349
cda0bcbc19c7c6784345154a72a88e8986d4454b0f8a55a541463f4a38f9caea,1,1,2,222,561,508,0.0.0.0,0,8261039536293864,False,1725643856,860178,860178,"[{'sequence': 4294967295, 'witness': '0247304402204ef4927a85482b51306c01302b043fe272df65e79a1f227454728c29e6bba84d02204ed990109636d5194c1f236e5f1f80cc0a2829b08bfbe80bc4f49ffcb0a460f701210306a2f89cde0b3e88c056d8495405ac8b3c4e617a05df4757e9fdbbbd7567ccd2', 'script': '', 'index': 0, 'prev_out': {'type': 0, 'spent': True, 'value': 56041695282, 'spending_outpoints': [{'tx_index': 8261039536293864, 'n': 0}], 'n': 1, 'tx_index': 5979655193037693, 'script': '0014d32e4c7627e06d4be1c27b20606f4eb1094e2b98', 'addr': 'bc1q6vhyca38upk5hcwz0vsxqm6wkyy5u2ucrx4enc'}}]","[{'type': 0, 'spent': False, 'value': 30000000000, 'spending_outpoints': [], 'n': 0, 'tx_index': 8261039536293864, 'script': '0014caa7e5d6f5f7e31c744dfa7afb8a145a6d98d1a2', 'addr': 'bc1qe2n7t4h47l33cazdlfa0hzs5tfke35dzj6tzuy'}, {'type': 0, 'spent': True, 'value': 26041694774, 'spending_outpoints': [{'tx_index': 8327943696494148, 'n': 1}], 'n': 1, 'tx_index': 8261039536293864, 'script': '0014d32e4c7627e06d4be1c27b20606f4eb1094e2b98', 'addr': 'bc1q6vhyca38upk5hcwz0vsxqm6wkyy5u2ucrx4enc'}]",30000000000,492522942267
7e62ce8638e860d12dbd8bb1f664d421f221be6495c334a38362bc1a2feaea56,1,4,2,669,1377,1246,0.0.0.0,0,3058142441330572,False,1725643856,860178,860178,"[{'sequence': 4294967295, 'witness': '02483045022100f19abe66bb792ed2948d76af6490d7c0e9a08a9484059154ea7c10c09781ba030220428b7e3b83376d08851b2c07a81d2d87484ce57a67ee358a805ba2d4e4bfef0c01210306a2f89cde0b3e88c056d8495405ac8b3c4e617a05df4757e9fdbbbd7567ccd2', 'script': '', 'index': 0, 'prev_out': {'type': 0, 'spent': True, 'value': 29999995956, 'spending_outpoints': [{'tx_index': 3058142441330572, 'n': 0}], 'n': 1, 'tx_index': 2246580436966400, 'script': '0014d32e4c7627e06d4be1c27b20606f4eb1094e2b98', 'addr': 'bc1q6vhyca38upk5hcwz0vsxqm6wkyy5u2ucrx4enc'}}, {'sequence': 4294967295, 'witness': '02483045022100baeadf1fafeccbc36bfc08ec72aa84c3c80cb394fe9ac96a63c41f42d5d0f4a902201f40b2683ee39dd158ae7ca4c736281e81bf4bddb96aa8aa82bbbd3cec6a745301210306a2f89cde0b3e88c056d8495405ac8b3c4e617a05df4757e9fdbbbd7567ccd2', 'script': '', 'index': 1, 'prev_out': {'type': 0, 'spent': True, 'value': 29999996211, 'spending_outpoints': [{'tx_index': 3058142441330572, 'n': 1}], 'n': 1, 'tx_index': 3263981872326067, 'script': '0014d32e4c7627e06d4be1c27b20606f4eb1094e2b98', 'addr': 'bc1q6vhyca38upk5hcwz0vsxqm6wkyy5u2ucrx4enc'}}, {'sequence': 4294967295, 'witness': '02473044022053aebcf847ccc38bc4f1a81a10b0bed01a9e08c7b08e53c46edc292d1a9ee418022005d5b52c46ab893848e198ba2035b67ce0654df19af795ce57795df0cd24d29f01210306a2f89cde0b3e88c056d8495405ac8b3c4e617a05df4757e9fdbbbd7567ccd2', 'script': '', 'index': 2, 'prev_out': {'type': 0, 'spent': True, 'value': 39989997140, 'spending_outpoints': [{'tx_index': 3058142441330572, 'n': 2}], 'n': 1, 'tx_index': 5223990380804840, 'script': '0014d32e4c7627e06d4be1c27b20606f4eb1094e2b98', 'addr': 'bc1q6vhyca38upk5hcwz0vsxqm6wkyy5u2ucrx4enc'}}, {'sequence': 4294967295, 'witness': '02483045022100c3697726ec607d13afc8cbe8c742ef8e583ec6296463908f548411aca1b67579022031f049c34c20a2baa7241b82358060b57abe41cf83706e84589f2c1d7e3955f801210306a2f89cde0b3e88c056d8495405ac8b3c4e617a05df4757e9fdbbbd7567ccd2', 'script': '', 'index': 3, 'prev_out': {'type': 0, 'spent': True, 'value': 39999989291, 'spending_outpoints': [{'tx_index': 3058142441330572, 'n': 3}], 'n': 1, 'tx_index': 6563210133475731, 'script': '0014d32e4c7627e06d4be1c27b20606f4eb1094e2b98', 'addr': 'bc1q6vhyca38upk5hcwz0vsxqm6wkyy5u2ucrx4enc'}}]","[{'type': 0, 'spent': False, 'value': 100000000000, 'spending_outpoints': [], 'n': 0, 'tx_index': 3058142441330572, 'script': '0014caa7e5d6f5f7e31c744dfa7afb8a145a6d98d1a2', 'addr': 'bc1qe2n7t4h47l33cazdlfa0hzs5tfke35dzj6tzuy'}, {'type': 0, 'spent': True, 'value': 39989977352, 'spending_outpoints': [{'tx_index': 8327943696494148, 'n': 2}], 'n': 1, 'tx_index': 3058142441330572, 'script': '0014d32e4c7627e06d4be1c27b20606f4eb1094e2b98', 'addr': 'bc1q6vhyca38upk5hcwz0vsxqm6wkyy5u2ucrx4enc'}]",100000000000,462522942267
3ec856432ca3ba6583d309d046b082959d7734f4f27418855062d7d9e988c19d,1,9,2,1409,2732,2473,0.0.0.0,0,5550545640831724,False,1725643483,860177,860177,"[{'sequence': 4294967295, 'witness': '02483045022100902507574d74bd7f6d603678ca5e2de90541fa5cced0d6e1ebc1b231844e928d0220692da668a9afdeee2c13a5a13259259a8847477486258668ee58d424de9e975101210306a2f89cde0b3e88c056d8495405ac8b3c4e617a05df4757e9fdbbbd7567ccd2', 'script': '', 'index': 0, 'prev_out': {'type': 0, 'spent': True, 'value': 1500000, 'spending_outpoints': [{'tx_index': 5550545640831724, 'n': 0}], 'n': 0, 'tx_index': 4648400349416487, 'script': '0014d32e4c7627e06d4be1c27b20606f4eb1094e2b98', 'addr': 'bc1q6vhyca38upk5hcwz0vsxqm6wkyy5u2ucrx4enc'}}, {'sequence': 4294967295, 'witness': '024730440220585766b7de6236b71673e8bbef82ec649f4dd1493142ce6dd17d3a9503a9560302200261e5d90f14b129717d47968be76e2e7c8c2bac2101edcdcb63808619253a4a01210306a2f89cde0b3e88c056d8495405ac8b3c4e617a05df4757e9fdbbbd7567ccd2', 'script': '', 'index': 1, 'prev_out': {'type': 0, 'spent': True, 'value': 4999992874, 'spending_outpoints': [{'tx_index': 5550545640831724, 'n': 1}], 'n': 1, 'tx_index': 259832937273363, 'script': '0014d32e4c7627e06d4be1c27b20606f4eb1094e2b98', 'addr': 'bc1q6vhyca38upk5hcwz0vsxqm6wkyy5u2ucrx4enc'}}, {'sequence': 4294967295, 'witness': '02473044022004de66a12cd4916947bd69165106f29cd8185b336a4d434fe0f4a6df0a7d6d4102204cdb50628f497e52b00e663742f8883683519446d7619c42d55e36d5988870b001210306a2f89cde0b3e88c056d8495405ac8b3c4e617a05df4757e9fdbbbd7567ccd2', 'script': '', 'index': 2, 'prev_out': {'type': 0, 'spent': True, 'value': 5009995245, 'spending_outpoints': [{'tx_index': 5550545640831724, 'n': 2}], 'n': 1, 'tx_index': 182630734745059, 'script': '0014d32e4c7627e06d4be1c27b20606f4eb1094e2b98', 'addr': 'bc1q6vhyca38upk5hcwz0vsxqm6wkyy5u2ucrx4enc'}}, {'sequence': 4294967295, 'witness': '02483045022100dd46f6aac6e4f799043131090260c72f01f735e81a5669625b4d154eb976be6402201ee06cd4e106c365ef7a1d6f78864457f98c38159c037c3ac9f4d68579ccfd5601210306a2f89cde0b3e88c056d8495405ac8b3c4e617a05df4757e9fdbbbd7567ccd2', 'script': '', 'index': 3, 'prev_out': {'type': 0, 'spent': True, 'value': 9834161713, 'spending_outpoints': [{'tx_index': 5550545640831724, 'n': 3}], 'n': 1, 'tx_index': 884480463818340, 'script': '0014d32e4c7627e06d4be1c27b20606f4eb1094e2b98', 'addr': 'bc1q6vhyca38upk5hcwz0vsxqm6wkyy5u2ucrx4enc'}}, {'sequence': 4294967295, 'witness': '0247304402202a85182e8a3c45dc56677f69fa0923343a0fdb413f03aa8cb632d289ae860f22022016c06465dbffded77f37cd5662eb5f7cced4b4acbeb95f0e5e9f9c37101e23f701210306a2f89cde0b3e88c056d8495405ac8b3c4e617a05df4757e9fdbbbd7567ccd2', 'script': '', 'index': 4, 'prev_out': {'type': 0, 'spent': True, 'value': 9999996948, 'spending_outpoints': [{'tx_index': 5550545640831724, 'n': 4}], 'n': 1, 'tx_index': 7037758921726889, 'script': '0014d32e4c7627e06d4be1c27b20606f4eb1094e2b98', 'addr': 'bc1q6vhyca38upk5hcwz0vsxqm6wkyy5u2ucrx4enc'}}, {'sequence': 4294967295, 'witness': '02483045022100ca09b0a446c802ee2368b108d853aa3fb1e77c1fdc25f2abcc6d500bb792baa7022031f72de4c656174409b34f3078d08e42430338bb9fb004e67015aeb1253e02ed01210306a2f89cde0b3e88c056d8495405ac8b3c4e617a05df4757e9fdbbbd7567ccd2', 'script': '', 'index': 5, 'prev_out': {'type': 0, 'spent': True, 'value': 14824166854, 'spending_outpoints': [{'tx_index': 5550545640831724, 'n': 5}], 'n': 1, 'tx_index': 5702522941328592, 'script': '0014d32e4c7627e06d4be1c27b20606f4eb1094e2b98', 'addr': 'bc1q6vhyca38upk5hcwz0vsxqm6wkyy5u2ucrx4enc'}}, {'sequence': 4294967295, 'witness': '0247304402202b81fbb6b1bbf79d3b420d79d81af58ecb60d74fb2abea9a6d3436bf51fbd29f0220196ea6673a448d03a9c649f0636e7687d76f6bb19aa168892b381ae322aa675a01210306a2f89cde0b3e88c056d8495405ac8b3c4e617a05df4757e9fdbbbd7567ccd2', 'script': '', 'index': 6, 'prev_out': {'type': 0, 'spent': True, 'value': 19648340775, 'spending_outpoints': [{'tx_index': 5550545640831724, 'n': 6}], 'n': 1, 'tx_index': 8363869959413933, 'script': '0014d32e4c7627e06d4be1c27b20606f4eb1094e2b98', 'addr': 'bc1q6vhyca38upk5hcwz0vsxqm6wkyy5u2ucrx4enc'}}, {'sequence': 4294967295, 'witness': '02473044022036b9ea57e872af0ffaa55cd3e9c9123ccc95265ee224769fe1dd11bd78e15f6a02201f47cdf34df3c114b733f7591ebb9faa2d226d852e339d4dc02b289915e2ea3901210306a2f89cde0b3e88c056d8495405ac8b3c4e617a05df4757e9fdbbbd7567ccd2', 'script': '', 'index': 7, 'prev_out': {'type': 0, 'spent': True, 'value': 24824168768, 'spending_outpoints': [{'tx_index': 5550545640831724, 'n': 7}], 'n': 1, 'tx_index': 5711124017639073, 'script': '0014d32e4c7627e06d4be1c27b20606f4eb1094e2b98', 'addr': 'bc1q6vhyca38upk5hcwz0vsxqm6wkyy5u2ucrx4enc'}}, {'sequence': 4294967295, 'witness': '024730440220737fa81782f19a4472c6451c47ca7daef88b2eb13d2f281c35e50a0ba999d94402202aa78afa24e6cc5ea14f87da894e24e4da9711420293f406d19b2a33d74cf54a01210306a2f89cde0b3e88c056d8495405ac8b3c4e617a05df4757e9fdbbbd7567ccd2', 'script': '', 'index': 8, 'prev_out': {'type': 0, 'spent': True, 'value': 24824202148, 'spending_outpoints': [{'tx_index': 5550545640831724, 'n': 8}], 'n': 1, 'tx_index': 3224274703315254, 'script': '0014d32e4c7627e06d4be1c27b20606f4eb1094e2b98', 'addr': 'bc1q6vhyca38upk5hcwz0vsxqm6wkyy5u2ucrx4enc'}}]","[{'type': 0, 'spent': False, 'value': 100000000000, 'spending_outpoints': [], 'n': 0, 'tx_index': 5550545640831724, 'script': '0014caa7e5d6f5f7e31c744dfa7afb8a145a6d98d1a2', 'addr': 'bc1qe2n7t4h47l33cazdlfa0hzs5tfke35dzj6tzuy'}, {'type': 0, 'spent': True, 'value': 13966522852, 'spending_outpoints': [{'tx_index': 8327943696494148, 'n': 0}], 'n': 1, 'tx_index': 5550545640831724, 'script': '0014d32e4c7627e06d4be1c27b20606f4eb1094e2b98', 'addr': 'bc1q6vhyca38upk5hcwz0vsxqm6wkyy5u2ucrx4enc'}]",100000000000,362522942267
c1a26e87abf0a549913ca7f0009c6c1f650294ec62a1c0884345292c81211b51,1,2,2,372,834,1003,0.0.0.0,0,2853662978573608,False,1725643449,860176,860176,"[{'sequence': 4294967295, 'witness': '02483045022100ac66da529f46c91ba30148710990aa5391279b97044c6fc300d981cb4fa906f3022048c2ed52024bf05b437352fc6c1c0869ade195427f134de2b332d63ef4350407012102896c93c272e8c9de3a520eed4bb5a91ed1c462ae9c8250fe2dbe34e8e0d31e93', 'script': '', 'index': 0, 'prev_out': {'type': 0, 'spent': True, 'value': 12522882306, 'spending_outpoints': [{'tx_index': 2853662978573608, 'n': 0}], 'n': 1, 'tx_index': 4876512023732578, 'script': '0014343fbc7af26b4862e74e7b85b68e76149fe2ee44', 'addr': 'bc1qxslmc7hjddyx9e6w0wzmdrnkzj079mjy2ppy8c'}}, {'sequence': 4294967295, 'witness': '02483045022100d8e8c63f87db4baebc412379303c5b8bba67d9eb4302a78a886843b0538086bc02206fcb374a82f3bb031ba03a77673612bf9cf7075cb797619ce952331262360aeb012102896c93c272e8c9de3a520eed4bb5a91ed1c462ae9c8250fe2dbe34e8e0d31e93', 'script': '', 'index': 1, 'prev_out': {'type': 0, 'spent': True, 'value': 49999963179, 'spending_outpoints': [{'tx_index': 2853662978573608, 'n': 1}], 'n': 1, 'tx_index': 6267625532598063, 'script': '0014343fbc7af26b4862e74e7b85b68e76149fe2ee44', 'addr': 'bc1qxslmc7hjddyx9e6w0wzmdrnkzj079mjy2ppy8c'}}]","[{'type': 0, 'spent': False, 'value': 62522842267, 'spending_outpoints': [], 'n': 0, 'tx_index': 2853662978573608, 'script': '0014caa7e5d6f5f7e31c744dfa7afb8a145a6d98d1a2', 'addr': 'bc1qe2n7t4h47l33cazdlfa0hzs5tfke35dzj6tzuy'}, {'type': 0, 'spent': True, 'value': 2215, 'spending_outpoints': [{'tx_index': 6046411075359185, 'n': 0}], 'n': 1, 'tx_index': 2853662978573608, 'script': '0014343fbc7af26b4862e74e7b85b68e76149fe2ee44', 'addr': 'bc1qxslmc7hjddyx9e6w0wzmdrnkzj079mjy2ppy8c'}]",62522842267,262522942267
2a7b5e736f9895a39bdf295e6f2b649ad28440169d1f0cb43e170b57774b998a,1,1,2,223,562,677,0.0.0.0,0,4876512023732578,False,1725643449,860176,860176,"[{'sequence': 4294967295, 'witness': '02483045022100e57497ce4f766605447ac5b55d51584575332fa60c456bf8097fb5e6aa21dbf70220134659b9f75017d4961c3278a906a934414c28198f42399c5cf87d3cf893187b012102896c93c272e8c9de3a520eed4bb5a91ed1c462ae9c8250fe2dbe34e8e0d31e93', 'script': '', 'index': 0, 'prev_out': {'type': 0, 'spent': True, 'value': 112522882983, 'spending_outpoints': [{'tx_index': 4876512023732578, 'n': 0}], 'n': 1, 'tx_index': 8361433791305998, 'script': '0014343fbc7af26b4862e74e7b85b68e76149fe2ee44', 'addr': 'bc1qxslmc7hjddyx9e6w0wzmdrnkzj079mjy2ppy8c'}}]","[{'type': 0, 'spent': False, 'value': 100000000000, 'spending_outpoints': [], 'n': 0, 'tx_index': 4876512023732578, 'script': '0014caa7e5d6f5f7e31c744dfa7afb8a145a6d98d1a2', 'addr': 'bc1qe2n7t4h47l33cazdlfa0hzs5tfke35dzj6tzuy'}, {'type': 0, 'spent': True, 'value': 12522882306, 'spending_outpoints': [{'tx_index': 2853662978573608, 'n': 0}], 'n': 1, 'tx_index': 4876512023732578, 'script': '0014343fbc7af26b4862e74e7b85b68e76149fe2ee44', 'addr': 'bc1qxslmc7hjddyx9e6w0wzmdrnkzj079mjy2ppy8c'}]",100000000000,200000100000
44d2d762d88153a0849855955e7ce8c488d36f99617a153ad77f39a54bfa22b2,1,6,2,967,1921,2892,0.0.0.0,0,6267625532598063,False,1725643449,860176,860176,"[{'sequence': 4294967295, 'witness': '02483045022100e6871e3832a00d29edc55e472cba3c9bb196c7958ca91894a647c3e0d2f669750220074ea00db9db603cb0c699deb3e4560ac8f80cbe0d1430684919aac9723f8b12012102896c93c272e8c9de3a520eed4bb5a91ed1c462ae9c8250fe2dbe34e8e0d31e93', 'script': '', 'index': 0, 'prev_out': {'type': 0, 'spent': True, 'value': 100001723, 'spending_outpoints': [{'tx_index': 6267625532598063, 'n': 0}], 'n': 1, 'tx_index': 6799527178785786, 'script': '0014343fbc7af26b4862e74e7b85b68e76149fe2ee44', 'addr': 'bc1qxslmc7hjddyx9e6w0wzmdrnkzj079mjy2ppy8c'}}, {'sequence': 4294967295, 'witness': '02483045022100c7ef4a375834a602dacbbcce778e11df910ae3dfa7247a7f685673236d1e0d230220603ceb51b3971fec474f4df41608f3e88acd921dd185a39d3b367a684861918d012102896c93c272e8c9de3a520eed4bb5a91ed1c462ae9c8250fe2dbe34e8e0d31e93', 'script': '', 'index': 1, 'prev_out': {'type': 0, 'spent': True, 'value': 8400064348, 'spending_outpoints': [{'tx_index': 6267625532598063, 'n': 1}], 'n': 1, 'tx_index': 8503011281741159, 'script': '0014343fbc7af26b4862e74e7b85b68e76149fe2ee44', 'addr': 'bc1qxslmc7hjddyx9e6w0wzmdrnkzj079mjy2ppy8c'}}, {'sequence': 4294967295, 'witness': '024830450221008a08422f11d83bf1d5df69ffd292d0f0ab1adae42dcc0586e877b2eadf543ac102204ab0f43e745a958d76555ce1126805fa5fa0c8d014bb21c32fd33d8ba54c9bd2012102896c93c272e8c9de3a520eed4bb5a91ed1c462ae9c8250fe2dbe34e8e0d31e93', 'script': '', 'index': 2, 'prev_out': {'type': 0, 'spent': True, 'value': 30000000000, 'spending_outpoints': [{'tx_index': 6267625532598063, 'n': 2}], 'n': 0, 'tx_index': 7227864269032405, 'script': '0014343fbc7af26b4862e74e7b85b68e76149fe2ee44', 'addr': 'bc1qxslmc7hjddyx9e6w0wzmdrnkzj079mjy2ppy8c'}}, {'sequence': 4294967295, 'witness': '02483045022100d517f9e3db5efb7d38090b584c6a56a0d76a1f10e51003d60b6102f644636ed602205ceaebfc02270b4ee3262e14e344459b5a576609cea5f28f663d8694d6516c93012102896c93c272e8c9de3a520eed4bb5a91ed1c462ae9c8250fe2dbe34e8e0d31e93', 'script': '', 'index': 3, 'prev_out': {'type': 0, 'spent': True, 'value': 30499900000, 'spending_outpoints': [{'tx_index': 6267625532598063, 'n': 3}], 'n': 0, 'tx_index': 2496544063975154, 'script': '0014343fbc7af26b4862e74e7b85b68e76149fe2ee44', 'addr': 'bc1qxslmc7hjddyx9e6w0wzmdrnkzj079mjy2ppy8c'}}, {'sequence': 4294967295, 'witness': '024730440220425396cc68767cc526e5fd37ec8efecc162a3d3d970d1d16ce73cb42daf371ef02204659e96c20e12cff8df6c6f159cc8da3a15727e6a62e4a5696a22a70b6746e29012102896c93c272e8c9de3a520eed4bb5a91ed1c462ae9c8250fe2dbe34e8e0d31e93', 'script': '', 'index': 4, 'prev_out': {'type': 0, 'spent': True, 'value': 31000000000, 'spending_outpoints': [{'tx_index': 6267625532598063, 'n': 4}], 'n': 0, 'tx_index': 2591557041532218, 'script': '0014343fbc7af26b4862e74e7b85b68e76149fe2ee44', 'addr': 'bc1qxslmc7hjddyx9e6w0wzmdrnkzj079mjy2ppy8c'}}, {'sequence': 4294967295, 'witness': '02483045022100bbc3774c87038f5a892259c12156dd2363bea30839c276f82265e46a6da1032502207d90fbce78ca061152529bbcbb2ab1c4ba92f225662d7727085f37fa69efc6a3012102896c93c272e8c9de3a520eed4bb5a91ed1c462ae9c8250fe2dbe34e8e0d31e93', 'script': '', 'index': 5, 'prev_out': {'type': 0, 'spent': True, 'value': 50000000000, 'spending_outpoints': [{'tx_index': 6267625532598063, 'n': 5}], 'n': 0, 'tx_index': 7038180165727073, 'script': '0014343fbc7af26b4862e74e7b85b68e76149fe2ee44', 'addr': 'bc1qxslmc7hjddyx9e6w0wzmdrnkzj079mjy2ppy8c'}}]","[{'type': 0, 'spent': False, 'value': 100000000000, 'spending_outpoints': [], 'n': 0, 'tx_index': 6267625532598063, 'script': '0014caa7e5d6f5f7e31c744dfa7afb8a145a6d98d1a2', 'addr': 'bc1qe2n7t4h47l33cazdlfa0hzs5tfke35dzj6tzuy'}, {'type': 0, 'spent': True, 'value': 49999963179, 'spending_outpoints': [{'tx_index': 2853662978573608, 'n': 1}], 'n': 1, 'tx_index': 6267625532598063, 'script': '0014343fbc7af26b4862e74e7b85b68e76149fe2ee44', 'addr': 'bc1qxslmc7hjddyx9e6w0wzmdrnkzj079mjy2ppy8c'}]",100000000000,100000100000
ae1a0f5531521d728f438863842ea385898977297b5c129804d19f0e511241c1,1,1,2,222,561,846,0.0.0.0,0,6799527178785786,False,1725643102,860173,860173,"[{'sequence': 4294967295, 'witness': '02473044022051e77071b213b83ef7d6914eb7fdc0c88a0aff365d471b11c26db6a2b55643eb02206192a96e905b1bdd67d4bea33af99fcebb253157c0771290fbd7260317a9f983012102896c93c272e8c9de3a520eed4bb5a91ed1c462ae9c8250fe2dbe34e8e0d31e93', 'script': '', 'index': 0, 'prev_out': {'type': 0, 'spent': True, 'value': 100102569, 'spending_outpoints': [{'tx_index': 6799527178785786, 'n': 0}], 'n': 1, 'tx_index': 2032510488879204, 'script': '0014343fbc7af26b4862e74e7b85b68e76149fe2ee44', 'addr': 'bc1qxslmc7hjddyx9e6w0wzmdrnkzj079mjy2ppy8c'}}]","[{'type': 0, 'spent': False, 'value': 100000, 'spending_outpoints': [], 'n': 0, 'tx_index': 6799527178785786, 'script': '0014caa7e5d6f5f7e31c744dfa7afb8a145a6d98d1a2', 'addr': 'bc1qe2n7t4h47l33cazdlfa0hzs5tfke35dzj6tzuy'}, {'type': 0, 'spent': True, 'value': 100001723, 'spending_outpoints': [{'tx_index': 6267625532598063, 'n': 0}], 'n': 1, 'tx_index': 6799527178785786, 'script': '0014343fbc7af26b4862e74e7b85b68e76149fe2ee44', 'addr': 'bc1qxslmc7hjddyx9e6w0wzmdrnkzj079mjy2ppy8c'}]",100000,100000
