hash,ver,vin_sz,vout_sz,size,weight,fee,relayed_by,lock_time,tx_index,double_spend,time,block_index,block_height,inputs,out,result,balance
27ba11331d970c3dd626a8cecf035c310d520660ac1215e21357055d17fa8cfd,1,1,2,247,658,263,0.0.0.0,0,8921021858685098,False,1739181846,883158,883158,"[{'sequence': 4294967295, 'witness': '02483045022100b77e10ce561b2655194624f1cadb9fff8a5575f6321164e214f9f16ebe9253a602205dd3014a1ba6470b5ee4e90e8171acfd1af1c8b3fd0040d05ac392b651e696f30121027b6a263a0890b5f715dade1e7e8af73510889204f89606f4e356be05e2d2e382', 'script': '16001408060e550c9a412f166b369206868a1e0ebf9c35', 'index': 0, 'prev_out': {'type': 0, 'spent': True, 'value': 20200, 'spending_outpoints': [{'tx_index': 8921021858685098, 'n': 0}], 'n': 0, 'tx_index': 3050039726954376, 'script': 'a914e374f3f697b46d0de9b7e9b3da20a1822ebc1afe87', 'addr': '3NRhR8CKCDbMmANLNmPaFqbu8UHAjAEXWU'}}]","[{'type': 0, 'spent': False, 'value': 657, 'spending_outpoints': [], 'n': 0, 'tx_index': 8921021858685098, 'script': '00143924fbe46da8ea43404e8cec962e91ac62bbd9e9', 'addr': 'bc1q8yj0herd4r4yxszw3nkfvt53433thk0f5qst4g'}, {'type': 0, 'spent': False, 'value': 19280, 'spending_outpoints': [], 'n': 1, 'tx_index': 8921021858685098, 'script': 'a914e374f3f697b46d0de9b7e9b3da20a1822ebc1afe87', 'addr': '3NRhR8CKCDbMmANLNmPaFqbu8UHAjAEXWU'}]",657,7831703536460
81d865fe5c4c803a779607db421c105be9f6fac768e8d50d7ecf77a0598a9770,1,1,1,215,530,669,0.0.0.0,0,3961477232070393,False,1738930207,882706,882706,"[{'sequence': 4294967295, 'witness': '0248304502210085700315ced0e73fe988531edea41da9631badbb5b22c38703b6e7cd08c8e2fb0220156acabe2e27b79115821fed47660bc84fed6ae55e8184d1af939b9977ea54580121027b6a263a0890b5f715dade1e7e8af73510889204f89606f4e356be05e2d2e382', 'script': '16001408060e550c9a412f166b369206868a1e0ebf9c35', 'index': 0, 'prev_out': {'type': 0, 'spent': True, 'value': 1091, 'spending_outpoints': [{'tx_index': 3961477232070393, 'n': 0}], 'n': 1, 'tx_index': 1764813235814707, 'script': 'a914e374f3f697b46d0de9b7e9b3da20a1822ebc1afe87', 'addr': '3NRhR8CKCDbMmANLNmPaFqbu8UHAjAEXWU'}}]","[{'type': 0, 'spent': False, 'value': 422, 'spending_outpoints': [], 'n': 0, 'tx_index': 3961477232070393, 'script': '00143924fbe46da8ea43404e8cec962e91ac62bbd9e9', 'addr': 'bc1q8yj0herd4r4yxszw3nkfvt53433thk0f5qst4g'}]",422,7831703535803
485ea80a299ff8c4ce8f451d72e3b0d36679f6f67b42ce98373ef6ca609a56b9,2,1,1,320,566,284,0.0.0.0,0,6521011467542215,False,1736331399,878427,878427,"[{'sequence': 4294967295, 'witness': '034021da25c46aa08815bd14f254382c359106cea063dd70c74c083326d548232045dc5ca265ff7c0ea6f4fa8d964d2a6f7cbc6a0e575ad23930d5b1bfea049267ec87209a48022bbff208a02c1934ea083cf6ac31f02dde49724252e585dac91318c3b7ac0063036f7264010118746578742f706c61696e3b636861727365743d7574662d3800417b2270223a226272632d3230222c226f70223a226d696e74222c227469636b223a22f096b999222c22616d74223a223134393539393635303137302e373639227d6821c19a48022bbff208a02c1934ea083cf6ac31f02dde49724252e585dac91318c3b7', 'script': '', 'index': 0, 'prev_out': {'type': 0, 'spent': True, 'value': 830, 'spending_outpoints': [{'tx_index': 6521011467542215, 'n': 0}], 'n': 106, 'tx_index': 2214167251729481, 'script': '5120d9a4b75a25f90015fbbcfb4d197671c1bb00f11f922279fa098fa0291de3b413', 'addr': 'bc1pmxjtwk39lyqpt7auldx3jan3cxaspugljg38n7sf37szj80rksfs0ctmu3'}}]","[{'type': 0, 'spent': False, 'value': 546, 'spending_outpoints': [], 'n': 0, 'tx_index': 6521011467542215, 'script': '00143924fbe46da8ea43404e8cec962e91ac62bbd9e9', 'addr': 'bc1q8yj0herd4r4yxszw3nkfvt53433thk0f5qst4g'}]",546,7831703535381
b139d9b6c7d271195d9263f419625c2d6e15b6c479b0afc6f1f7b5dd46633838,2,1,1,305,551,276,0.0.0.0,0,1978074717206206,False,1735544525,877015,877015,"[{'sequence': 4294967295, 'witness': '03402522abbc56effb7bf6be8b53a55dc48a151e4d06df1a260086fc138891332f20a0e153eeb1ad66fcecd1e3a7f1f98e5382173ba0b2c5a9a10dbe9b55fd0bc50878208ff1f0ab031026719a012c362970de636ab0efc27790bc4428bc8e52d511f551ac0063036f7264010118746578742f706c61696e3b636861727365743d7574662d3800327b2270223a226272632d3230222c226f70223a226d696e74222c227469636b223a22f096a591222c22616d74223a2231227d6821c18ff1f0ab031026719a012c362970de636ab0efc27790bc4428bc8e52d511f551', 'script': '', 'index': 0, 'prev_out': {'type': 0, 'spent': True, 'value': 822, 'spending_outpoints': [{'tx_index': 1978074717206206, 'n': 0}], 'n': 6, 'tx_index': 5672303711991658, 'script': '51207b4836b2edf3798b391cccd5ec58e832d494fe5445f12bb7ff528e3fbe63496c', 'addr': 'bc1p0dyrdvhd7duckwguen27ck8gxt2fflj5ghcjhdll228rl0nrf9kqlceyqu'}}]","[{'type': 0, 'spent': False, 'value': 546, 'spending_outpoints': [], 'n': 0, 'tx_index': 1978074717206206, 'script': '00143924fbe46da8ea43404e8cec962e91ac62bbd9e9', 'addr': 'bc1q8yj0herd4r4yxszw3nkfvt53433thk0f5qst4g'}]",546,7831703534835
fe1217a2e38af721361756427cbaa247c9d93bf87a4998cea77f053853efa2e2,2,2,1,340,709,1065,0.0.0.0,0,7974061689209007,False,1735212514,876443,876443,"[{'sequence': 2147483649, 'witness': '02473044022051791f18d2f46de77263e11c74778ef8d8724032197396965e0c45dde04a350f02205c5ccddacd12ce0bf881632352d6ac15af47e778bf586902291bb55413a65ec7012102c20c1d69e47f2cf20ffd522e62cafb207d77fc33ff20bed0cdce47d9f8167368', 'script': '', 'index': 0, 'prev_out': {'type': 0, 'spent': True, 'value': 330, 'spending_outpoints': [{'tx_index': 7974061689209007, 'n': 0}], 'n': 0, 'tx_index': 2006528062236567, 'script': '0014905520ca4bb83ea2be174392e0137786b9d04168', 'addr': 'bc1qjp2jpjjthql290shgwfwqymhs6uaqstgr6m30z'}}, {'sequence': 2147483649, 'witness': '024830450221009c5895ef3f483383b0ffff1e1b42f833a5ddff5b8d53455fee1282c62c3198b002204442484731b746d6d4337d1bad2cdf4c8c05f16b4362d1dc6d6a9e527186027a012102c20c1d69e47f2cf20ffd522e62cafb207d77fc33ff20bed0cdce47d9f8167368', 'script': '', 'index': 1, 'prev_out': {'type': 0, 'spent': True, 'value': 1281, 'spending_outpoints': [{'tx_index': 7974061689209007, 'n': 1}], 'n': 1, 'tx_index': 6527577682210508, 'script': '0014905520ca4bb83ea2be174392e0137786b9d04168', 'addr': 'bc1qjp2jpjjthql290shgwfwqymhs6uaqstgr6m30z'}}]","[{'type': 0, 'spent': False, 'value': 546, 'spending_outpoints': [], 'n': 0, 'tx_index': 7974061689209007, 'script': '00143924fbe46da8ea43404e8cec962e91ac62bbd9e9', 'addr': 'bc1q8yj0herd4r4yxszw3nkfvt53433thk0f5qst4g'}]",546,7831703534289
cfd3d0ca4cd4198ee3d140696289a535e014acf955922e431e75b0a8ebfe1ca1,2,1,4,451,1474,3220,0.0.0.0,0,5668669056423438,False,1734786074,875734,875734,"[{'sequence': 4294967293, 'witness': '02483045022100b3154505f09d4b91a0793c4f5dd2ea804ad9c7f2539bb805f67fd1133d12bb2a02207062a847fb26f890ab3e85dfa054a1365860278539f55365c15b4442d87673fe01210250242d21bc2a0c83b1624f5d4e467df50cf51e9eec27e8757d700e3021bfcda1', 'script': '', 'index': 0, 'prev_out': {'type': 0, 'spent': True, 'value': 110737, 'spending_outpoints': [{'tx_index': 5668669056423438, 'n': 0}], 'n': 3, 'tx_index': 4976794668159453, 'script': '0014517d4010be8ab726270150b57f33fde6a6938660', 'addr': 'bc1q2975qy9732mjvfcp2z6h7vlau6nf8pnq0tzgp6'}}]","[{'type': 0, 'spent': False, 'value': 790, 'spending_outpoints': [], 'n': 0, 'tx_index': 5668669056423438, 'script': '00143924fbe46da8ea43404e8cec962e91ac62bbd9e9', 'addr': 'bc1q8yj0herd4r4yxszw3nkfvt53433thk0f5qst4g'}, {'type': 0, 'spent': False, 'value': 790, 'spending_outpoints': [], 'n': 1, 'tx_index': 5668669056423438, 'script': '512103e74e24c29d5ef4275d590a14f45b2c1dc69479241f746ed3f244591c3b2480002102e2084d786751ffb00d172e0ed45c2c1f6e5675db29a675f380c5a2f08efe46002102020202020202020202020202020202020202020202020202020202020202020253ae'}, {'type': 0, 'spent': False, 'value': 790, 'spending_outpoints': [], 'n': 2, 'tx_index': 5668669056423438, 'script': '5121035ffe55dc792e3635660a7cef6ec4a25e23dfd5491bba6c69cfd4b767496362002102c63574b0844a500d02c0cae3607ca7f7d6edf99a87505cc28f2637abb3cc5f002102020202020202020202020202020202020202020202020202020202020202020253ae'}, {'type': 0, 'spent': True, 'value': 105147, 'spending_outpoints': [{'tx_index': 588259989440644, 'n': 0}], 'n': 3, 'tx_index': 5668669056423438, 'script': '0014517d4010be8ab726270150b57f33fde6a6938660', 'addr': 'bc1q2975qy9732mjvfcp2z6h7vlau6nf8pnq0tzgp6'}]",790,7831703533743
9c336a53622511ab29cb94cd1a78e9b1af31eb1e3150a783716a3b92c4c46ffd,2,2,2,370,832,1664,0.0.0.0,0,8917007501248365,False,1734695805,875587,875587,"[{'sequence': 2147483649, 'witness': '02473044022035f6ccc77fd8893989a9e2d14e5134628f809c2cff23e9ecbf6ac5bf373fd0b20220520bce394c05967ecfd7dbf01dcacd83113ad0f7370632ef3f93eed813b17bf4012102c20c1d69e47f2cf20ffd522e62cafb207d77fc33ff20bed0cdce47d9f8167368', 'script': '', 'index': 0, 'prev_out': {'type': 0, 'spent': True, 'value': 330, 'spending_outpoints': [{'tx_index': 8917007501248365, 'n': 0}], 'n': 0, 'tx_index': 6516117880872957, 'script': '0014905520ca4bb83ea2be174392e0137786b9d04168', 'addr': 'bc1qjp2jpjjthql290shgwfwqymhs6uaqstgr6m30z'}}, {'sequence': 2147483649, 'witness': '0247304402200f0844077ecb13bda436c3e990368770c3a9019416ba124b0dd51f46529c1f9002207a558585e921f69d3a47afc5971b25dfc7dde69499c8612005b90094f211c6f4012102c20c1d69e47f2cf20ffd522e62cafb207d77fc33ff20bed0cdce47d9f8167368', 'script': '', 'index': 1, 'prev_out': {'type': 0, 'spent': True, 'value': 10081, 'spending_outpoints': [{'tx_index': 8917007501248365, 'n': 1}], 'n': 1, 'tx_index': 5002887094526442, 'script': '0014905520ca4bb83ea2be174392e0137786b9d04168', 'addr': 'bc1qjp2jpjjthql290shgwfwqymhs6uaqstgr6m30z'}}]","[{'type': 0, 'spent': False, 'value': 546, 'spending_outpoints': [], 'n': 0, 'tx_index': 8917007501248365, 'script': '00143924fbe46da8ea43404e8cec962e91ac62bbd9e9', 'addr': 'bc1q8yj0herd4r4yxszw3nkfvt53433thk0f5qst4g'}, {'type': 0, 'spent': True, 'value': 8201, 'spending_outpoints': [{'tx_index': 6334317961382623, 'n': 1}], 'n': 1, 'tx_index': 8917007501248365, 'script': '0014905520ca4bb83ea2be174392e0137786b9d04168', 'addr': 'bc1qjp2jpjjthql290shgwfwqymhs6uaqstgr6m30z'}]",546,7831703532953
3dfcef483b4e98d2e50ffac65893834bf44cf095b36ccdf1bdc91dcc6d0b1375,2,1,1,316,562,705,0.0.0.0,0,4119189010351033,False,1734383678,875059,875059,"[{'sequence': 4294967295, 'witness': '0340e2c7c1370fd81f8352cecd09a61a2c5cd7d9eee92b6fbc975f141d9767fa787159db16a69d2258ea40e8e6a393006aa3315e8c9dfbe150d305a3f4a3d93c59ed8320a7bbbba42349275444f94eec9292ca116447a10a9f827ccd2f9102fde705089fac0063036f7264010118746578742f706c61696e3b636861727365743d7574662d38003d7b2270223a226272632d3230222c226f70223a226d696e74222c227469636b223a22e2888f2b222c22616d74223a22313233343536373839333639227d6821c1a7bbbba42349275444f94eec9292ca116447a10a9f827ccd2f9102fde705089f', 'script': '', 'index': 0, 'prev_out': {'type': 0, 'spent': True, 'value': 1251, 'spending_outpoints': [{'tx_index': 4119189010351033, 'n': 0}], 'n': 996, 'tx_index': 4911416144737937, 'script': '512092bbbcfefcdb565bc47037562671d416640627d845889b98d32332bee2682026', 'addr': 'bc1pj2amelhumdt9h3rsxatzvuw5zejqvf7cgkyfhxxnyvetacngyqnqckwp2t'}}]","[{'type': 0, 'spent': False, 'value': 546, 'spending_outpoints': [], 'n': 0, 'tx_index': 4119189010351033, 'script': '00143924fbe46da8ea43404e8cec962e91ac62bbd9e9', 'addr': 'bc1q8yj0herd4r4yxszw3nkfvt53433thk0f5qst4g'}]",546,7831703532407
86ba75fe34dee49bdcb2d9f24a7c2a743730832db5da8c798d5ebc03ebc80f2c,2,2,2,371,833,1664,0.0.0.0,0,1550281823254411,False,1733584807,873665,873665,"[{'sequence': 2147483649, 'witness': '0247304402206b55a2babd392dfbb7345985ce204fb3de04e70873906ed7fe3f011a68a470b702206fd728579e836e986125132250ac27eb57d6658c284d574590ca77afaf4415c7012102c20c1d69e47f2cf20ffd522e62cafb207d77fc33ff20bed0cdce47d9f8167368', 'script': '', 'index': 0, 'prev_out': {'type': 0, 'spent': True, 'value': 330, 'spending_outpoints': [{'tx_index': 1550281823254411, 'n': 0}], 'n': 0, 'tx_index': 5075083265833434, 'script': '0014905520ca4bb83ea2be174392e0137786b9d04168', 'addr': 'bc1qjp2jpjjthql290shgwfwqymhs6uaqstgr6m30z'}}, {'sequence': 2147483649, 'witness': '02483045022100fb1b14da6196358da222c6de6e6d3c150c7000c50de25c821438394a914d3eeb022068e2ed877dbcf3a1f11951f85c04102f36e571eaac094a7defba047fcbafa243012102c20c1d69e47f2cf20ffd522e62cafb207d77fc33ff20bed0cdce47d9f8167368', 'script': '', 'index': 1, 'prev_out': {'type': 0, 'spent': True, 'value': 41364, 'spending_outpoints': [{'tx_index': 1550281823254411, 'n': 1}], 'n': 1, 'tx_index': 2004988997533196, 'script': '0014905520ca4bb83ea2be174392e0137786b9d04168', 'addr': 'bc1qjp2jpjjthql290shgwfwqymhs6uaqstgr6m30z'}}]","[{'type': 0, 'spent': False, 'value': 546, 'spending_outpoints': [], 'n': 0, 'tx_index': 1550281823254411, 'script': '00143924fbe46da8ea43404e8cec962e91ac62bbd9e9', 'addr': 'bc1q8yj0herd4r4yxszw3nkfvt53433thk0f5qst4g'}, {'type': 0, 'spent': True, 'value': 39484, 'spending_outpoints': [{'tx_index': 7281038591625723, 'n': 1}], 'n': 1, 'tx_index': 1550281823254411, 'script': '0014905520ca4bb83ea2be174392e0137786b9d04168', 'addr': 'bc1qjp2jpjjthql290shgwfwqymhs6uaqstgr6m30z'}]",546,7831703531861
f5a1d24aafb855320c24800e66a6b7e64833311163f110d882aa6c8264153b5d,2,2,2,371,833,416,0.0.0.0,0,3280266987589013,False,1730861039,869060,869060,"[{'sequence': 2147483649, 'witness': '0247304402206ccbc2a05c2153437e3d997237d8e20e80a402b2cc3fcafc6e9c7f409e64a9b1022031663828c1c3d761cae2c815daca2234837953dd9c1307e59baf1257421be45d012102dc771f5ea6797389374d0f5a4c498bc4fd16d86783f6ff0fde1b70a8dbcb558b', 'script': '', 'index': 0, 'prev_out': {'type': 0, 'spent': True, 'value': 546, 'spending_outpoints': [{'tx_index': 3280266987589013, 'n': 0}], 'n': 0, 'tx_index': 4709802756094599, 'script': '0014f881d18dfae68fe5daa64f26898e4a0c199becb0', 'addr': 'bc1qlzqarr06u687tk4xfungnrj2psvehm9ske2pyg'}}, {'sequence': 2147483649, 'witness': '02483045022100aa8e748b5c7a3e15601d34c097f62143018d79e901b7887c81ac73573d82d397022011f994c9cf80263c6f9cf5ffac26420d25982d398aad22e655648beece3fa5fa012102dc771f5ea6797389374d0f5a4c498bc4fd16d86783f6ff0fde1b70a8dbcb558b', 'script': '', 'index': 1, 'prev_out': {'type': 0, 'spent': True, 'value': 123909, 'spending_outpoints': [{'tx_index': 3280266987589013, 'n': 1}], 'n': 1, 'tx_index': 4577892633263810, 'script': '0014f881d18dfae68fe5daa64f26898e4a0c199becb0', 'addr': 'bc1qlzqarr06u687tk4xfungnrj2psvehm9ske2pyg'}}]","[{'type': 0, 'spent': False, 'value': 546, 'spending_outpoints': [], 'n': 0, 'tx_index': 3280266987589013, 'script': '00143924fbe46da8ea43404e8cec962e91ac62bbd9e9', 'addr': 'bc1q8yj0herd4r4yxszw3nkfvt53433thk0f5qst4g'}, {'type': 0, 'spent': True, 'value': 123493, 'spending_outpoints': [{'tx_index': 5973523292535025, 'n': 1}], 'n': 1, 'tx_index': 3280266987589013, 'script': '0014f881d18dfae68fe5daa64f26898e4a0c199becb0', 'addr': 'bc1qlzqarr06u687tk4xfungnrj2psvehm9ske2pyg'}]",546,7831703531315
2066a274b98a6a3f9fdfc61c8393715d8c79c07812f6cecf8752730beeba5d67,1,1,31,1182,4401,11793,0.0.0.0,0,3636872505028202,False,1730485721,868436,868436,"[{'sequence': 4294967295, 'witness': '02473044022070ac0a35b184ea5ad8151141eb7cce76243e92536efae571209a15ec4386fc8f02204cb8d04783a09031defa6ea4d2d9c62c6b47b361f1ffa6598b00ec72d73cbfcc012102512a817dc4acc54d48793cbce9029d352ee75ba5d48e1890210a52ee37574303', 'script': '16001450a1d5405edb7e55ccadc95cdc2d5bf06f8fccd9', 'index': 0, 'prev_out': {'type': 0, 'spent': True, 'value': 13671545, 'spending_outpoints': [{'tx_index': 3636872505028202, 'n': 0}], 'n': 0, 'tx_index': 2572900551693455, 'script': 'a914f2d27b90150b1e3dfae60fdf8e6133d62f2cd47887', 'addr': '3PpwbZN8r6G5QRSdtJw1fhcdCfbXRKM88c'}}]","[{'type': 0, 'spent': True, 'value': 406897, 'spending_outpoints': [{'tx_index': 2277954581318666, 'n': 151}], 'n': 0, 'tx_index': 3636872505028202, 'script': '00140755ce73188bf29212f2988525eb1c9464633a14', 'addr': 'bc1qqa2uuucc30efyyhjnzzjt6cuj3jxxws55069fw'}, {'type': 0, 'spent': False, 'value': 64921, 'spending_outpoints': [], 'n': 1, 'tx_index': 3636872505028202, 'script': '001457c20414b45dcc61e5a23f6c3b74f0853253a893', 'addr': 'bc1q2lpqg995thxxredz8akrka8ss5e982ync4vha7'}, {'type': 0, 'spent': True, 'value': 1197268, 'spending_outpoints': [{'tx_index': 6194246027302385, 'n': 21}], 'n': 2, 'tx_index': 3636872505028202, 'script': '00144e4707ba6675264bbbc9389b2db2517098d0b703', 'addr': 'bc1qfers0wnxw5nyhw7f8zdjmvj3wzvdpdcr7vsc0n'}, {'type': 0, 'spent': True, 'value': 78881, 'spending_outpoints': [{'tx_index': 2982655782377511, 'n': 367}], 'n': 3, 'tx_index': 3636872505028202, 'script': '0014d2a6e18547934760f59ca0f51fd007f8642bea37', 'addr': 'bc1q62nwrp28jdrkpavu5r63l5q8lpjzh63hcq72gj'}, {'type': 0, 'spent': True, 'value': 168071, 'spending_outpoints': [{'tx_index': 442862130512986, 'n': 843}], 'n': 4, 'tx_index': 3636872505028202, 'script': '001460f17b815f29224ec355eed2e83bc65e382cdc72', 'addr': 'bc1qvrchhq2l9y3yas64amfwsw7xtcuzehrjfzfqfa'}, {'type': 0, 'spent': True, 'value': 58798, 'spending_outpoints': [{'tx_index': 4272638751021090, 'n': 31}], 'n': 5, 'tx_index': 3636872505028202, 'script': '0014b043c0acec3ff26f9851b2c5f3981bdea2a2c4ec', 'addr': 'bc1qkppupt8v8lexlxz3ktzl8xqmm632938vpsewny'}, {'type': 0, 'spent': True, 'value': 1442964, 'spending_outpoints': [{'tx_index': 8445021339825845, 'n': 0}], 'n': 6, 'tx_index': 3636872505028202, 'script': '001468f5710c676fe360709518c880a1b8d2831d6fbe', 'addr': 'bc1qdr6hzrr8dl3kquy4rrygpgdc62p36ma7vae3gy'}, {'type': 0, 'spent': False, 'value': 15629, 'spending_outpoints': [], 'n': 7, 'tx_index': 3636872505028202, 'script': '00143924fbe46da8ea43404e8cec962e91ac62bbd9e9', 'addr': 'bc1q8yj0herd4r4yxszw3nkfvt53433thk0f5qst4g'}, {'type': 0, 'spent': True, 'value': 155596, 'spending_outpoints': [{'tx_index': 5552327595302463, 'n': 62}], 'n': 8, 'tx_index': 3636872505028202, 'script': '0014702c01fa0d40e232285ea89d5178303521c4c78d', 'addr': 'bc1qwqkqr7sdgr3ry2z74zw4z7psx5suf3ud7zcjw8'}, {'type': 0, 'spent': True, 'value': 140635, 'spending_outpoints': [{'tx_index': 822889755243620, 'n': 0}], 'n': 9, 'tx_index': 3636872505028202, 'script': '00144487ae2af35512822241dc3dd34030a147264e97', 'addr': 'bc1qgjr6u2hn25fgygjpms7axsps59rjvn5hhpqz52'}, {'type': 0, 'spent': True, 'value': 86735, 'spending_outpoints': [{'tx_index': 1327885830034937, 'n': 0}], 'n': 10, 'tx_index': 3636872505028202, 'script': '00141e527a02cea8ba7386f738db2d93f261f61e151f', 'addr': 'bc1qref85qkw4za88phh8rdjmyljv8mpu9glkp3qjw'}, {'type': 0, 'spent': True, 'value': 1039301, 'spending_outpoints': [{'tx_index': 8736835827130479, 'n': 95}], 'n': 11, 'tx_index': 3636872505028202, 'script': '76a914f100374ca5708a4647737e176b7854eef25c34e688ac', 'addr': '1NyJ7EvMGgoSZKcqLvTm19Zxbmx3uZj7JT'}, {'type': 0, 'spent': True, 'value': 69648, 'spending_outpoints': [{'tx_index': 2974834715453874, 'n': 6}], 'n': 12, 'tx_index': 3636872505028202, 'script': 'a914842e62d1a08d1b06592330a189dcc7d6f42b602787', 'addr': '3DjvgpdDPwisiy5aU5q9umJG81WQRDS373'}, {'type': 0, 'spent': True, 'value': 34627, 'spending_outpoints': [{'tx_index': 5298173127256770, 'n': 117}], 'n': 13, 'tx_index': 3636872505028202, 'script': 'a914e5f414e384f255f35757159e95649314cbacb7d687', 'addr': '3Neu4ZQeLJwJzSPismoAsGrwhSAyMDT9vb'}, {'type': 0, 'spent': True, 'value': 35048, 'spending_outpoints': [{'tx_index': 6794181970608566, 'n': 271}], 'n': 14, 'tx_index': 3636872505028202, 'script': '001452ada45fc34fc95f77c909c184dd6502720cd025', 'addr': 'bc1q22k6gh7rfly47a7fp8qcfht9qfeqe5p9dsq4l2'}, {'type': 0, 'spent': True, 'value': 357051, 'spending_outpoints': [{'tx_index': 8621913471147719, 'n': 266}], 'n': 15, 'tx_index': 3636872505028202, 'script': '00144c9a1153bbc9d89c73bfe15ba9c7f63586b13f68', 'addr': 'bc1qfjdpz5ame8vfcualu9d6n3lkxkrtz0mg7gdpps'}, {'type': 0, 'spent': True, 'value': 46051, 'spending_outpoints': [{'tx_index': 648569283089780, 'n': 834}], 'n': 16, 'tx_index': 3636872505028202, 'script': '001436750dfde23d82df951b65af86f1edde7bc2f485', 'addr': 'bc1qxe6sml0z8kpdl9gmvkhcdu0dmeau9ay9yauepm'}, {'type': 0, 'spent': True, 'value': 297018, 'spending_outpoints': [{'tx_index': 8879661203168559, 'n': 1}], 'n': 17, 'tx_index': 3636872505028202, 'script': '0014f39e9c6b270ec50298fa44c8d4445fe61828d1cd', 'addr': 'bc1q7w0fc6e8pmzs9x86gnydg3zlucvz35wdcwmeem'}, {'type': 0, 'spent': True, 'value': 15967, 'spending_outpoints': [{'tx_index': 6791591728547290, 'n': 135}], 'n': 18, 'tx_index': 3636872505028202, 'script': '00144819628cb6591108829faa00dffc0315fea1efb3', 'addr': 'bc1qfqvk9r9ktygs3q5l4gqdllqrzhl2rmank0v95w'}, {'type': 0, 'spent': True, 'value': 86562, 'spending_outpoints': [{'tx_index': 3529271452616880, 'n': 14}], 'n': 19, 'tx_index': 3636872505028202, 'script': '00141d810d7f501025e6496a5924abfae678963d36a5', 'addr': 'bc1qrkqs6l6szqj7vjt2tyj2h7hx0ztr6d490gs8ca'}, {'type': 0, 'spent': True, 'value': 712502, 'spending_outpoints': [{'tx_index': 923906858935746, 'n': 5}], 'n': 20, 'tx_index': 3636872505028202, 'script': '0014031431dc0dcc35ffeeb4f0a4411c6e6c8bd16377', 'addr': 'bc1qqv2rrhqdes6llm457zjyz8rwdj9azcmhqea6qn'}, {'type': 0, 'spent': True, 'value': 724716, 'spending_outpoints': [{'tx_index': 6501969613864052, 'n': 1}], 'n': 21, 'tx_index': 3636872505028202, 'script': '76a91472fd2a1e1f4f50104d0b12b0afcde30ceafe448388ac', 'addr': '1BV1K3ncZu1Y5LzM7CDYT6PPv7B3tN6PGP'}, {'type': 0, 'spent': True, 'value': 112415, 'spending_outpoints': [{'tx_index': 1421567520500751, 'n': 943}], 'n': 22, 'tx_index': 3636872505028202, 'script': '00147a93eb184b628e50513a9533c13305d292f11873', 'addr': 'bc1q02f7kxztv289q5f6j5euzvc962f0zxrn2u9xaw'}, {'type': 0, 'spent': True, 'value': 62752, 'spending_outpoints': [{'tx_index': 3054579340046260, 'n': 0}], 'n': 23, 'tx_index': 3636872505028202, 'script': '00148ae8b8d567325ccb3098d8eea835a17eb1078b22', 'addr': 'bc1q3t5t34t8xfwvkvycmrh2sddp06cs0zezadgp4w'}, {'type': 0, 'spent': True, 'value': 138073, 'spending_outpoints': [{'tx_index': 4679999007446023, 'n': 45}], 'n': 24, 'tx_index': 3636872505028202, 'script': '0014274a52d647cd6ee1063721c834ed7c64e5b93764', 'addr': 'bc1qya9994j8e4hwzp3hy8yrfmtuvnjmjdmyc78dqa'}, {'type': 0, 'spent': True, 'value': 432000, 'spending_outpoints': [{'tx_index': 2179025128468201, 'n': 0}], 'n': 25, 'tx_index': 3636872505028202, 'script': '0014832a748ff559d904ff0f4a5b5ea7cdd5b7e4a508', 'addr': 'bc1qsv48frl4t8vsflc0ffd4af7d6km7ffgg30u5l5'}, {'type': 0, 'spent': True, 'value': 219518, 'spending_outpoints': [{'tx_index': 774197289961770, 'n': 113}], 'n': 26, 'tx_index': 3636872505028202, 'script': '76a914466761593b1b485e750330f102cc376f4226b76d88ac', 'addr': '17RG9R5GiRVdEvpDeJaqC7usYbxXMXu7FA'}, {'type': 0, 'spent': True, 'value': 408929, 'spending_outpoints': [{'tx_index': 8804822320247396, 'n': 6}], 'n': 27, 'tx_index': 3636872505028202, 'script': '00146866a13db8d3714dc59f96d5d3485fbb4d94a4ed', 'addr': 'bc1qdpn2z0dc6dc5m3vljm2axjzlhdxeff8dfy8jg2'}, {'type': 0, 'spent': True, 'value': 4059305, 'spending_outpoints': [{'tx_index': 1761324536858013, 'n': 0}], 'n': 28, 'tx_index': 3636872505028202, 'script': '512079dcd09dafe47b09f0852250f8b79b772d087f1798764997ee9807ff3bcb5416', 'addr': 'bc1p08wdp8d0u3asnuy9yfg03dumwuksslchnpmyn9lwnqrl7w7t2stq7harnf'}, {'type': 0, 'spent': True, 'value': 775453, 'spending_outpoints': [{'tx_index': 2427147387645625, 'n': 256}], 'n': 29, 'tx_index': 3636872505028202, 'script': '0020d169820fb58d73e00007fdf197489ca216e16fc16c614238f10d3fb19e3ec8bd', 'addr': 'bc1q695cyra434e7qqq8lhcewjyu5gtwzm7pd3s5yw83p5lmr837ez7st07aha'}, {'type': 0, 'spent': True, 'value': 216421, 'spending_outpoints': [{'tx_index': 6735805625075449, 'n': 40}], 'n': 30, 'tx_index': 3636872505028202, 'script': '76a914a58d96756ae64e0536a1a230d0f7e2f803806a1188ac', 'addr': '1G6N7LiSuNjnz6EB4a8ryhTSet6vyKVvzx'}]",15629,7831703530769
36f3a7fcb6b5ebd9fa4041928da89cd423662f9c5c12e41c80e07a6559d178ef,2,1,12,592,2368,5930,0.0.0.0,862986,8425669997145948,False,1727385851,862987,862987,"[{'sequence': 4294967293, 'witness': '', 'script': '47304402205ed68c46ff0195a7552de6dae54120dbfde6d52440022cadc1642e913d2c16fe02204c9992f75472afda88d6c5e3ae9f6c74592a6ce420bff7418bc58d423f8e1906012102c69d7ebb643c2eac064c6b3a62ec71e11a42ce53b46e7170d446091a368e52b9', 'index': 0, 'prev_out': {'type': 0, 'spent': True, 'value': 12810, 'spending_outpoints': [{'tx_index': 8425669997145948, 'n': 0}], 'n': 0, 'tx_index': 4882487272053491, 'script': '76a91404cce600de4564e4810f13efff56d1507046e3fb88ac', 'addr': '1SPAMxHvs3opuDRkGTTdW4X2YixZecEEz'}}]","[{'type': 0, 'spent': False, 'value': 0, 'spending_outpoints': [], 'n': 0, 'tx_index': 8425669997145948, 'script': '6a24454d41494c20414e4420534d5320424f4d42455220666c6f6f6463726d2e656d61696c20'}, {'type': 0, 'spent': False, 'value': 546, 'spending_outpoints': [], 'n': 1, 'tx_index': 8425669997145948, 'script': '00143924fbe46da8ea43404e8cec962e91ac62bbd9e9', 'addr': 'bc1q8yj0herd4r4yxszw3nkfvt53433thk0f5qst4g'}, {'type': 0, 'spent': False, 'value': 546, 'spending_outpoints': [], 'n': 2, 'tx_index': 8425669997145948, 'script': '0014e8b1bf6a27a1e76929b229f595f64cd381c87d87', 'addr': 'bc1qazcm763858nkj2dj986etajv6wquslv8uxwczt'}, {'type': 0, 'spent': True, 'value': 546, 'spending_outpoints': [{'tx_index': 6778814721344358, 'n': 36}], 'n': 3, 'tx_index': 8425669997145948, 'script': '0014fd4a46f4339753fa2d58094400c9d9d05a8d9885', 'addr': 'bc1ql49ydapnjafl5t2cp9zqpjwe6pdgmxy98859v2'}, {'type': 0, 'spent': False, 'value': 546, 'spending_outpoints': [], 'n': 4, 'tx_index': 8425669997145948, 'script': '00204364063fac8829a931a752ecd9049e43425e2cebf83681876c556002bf389b00', 'addr': 'bc1qgdjqv0av3q56jvd82tkdjpy7gdp9ut8tlqmgrpmv24sq90ecnvqqjwvw97'}, {'type': 0, 'spent': True, 'value': 546, 'spending_outpoints': [{'tx_index': 7514368465949291, 'n': 8}], 'n': 5, 'tx_index': 8425669997145948, 'script': '00206d490c8afb205cb251b377b0798094bd26643cc0833b94b5e09d2c08a98e9b80', 'addr': 'bc1qd4ysezhmypwty5dnw7c8nqy5h5nxg0xqsvaefd0qn5kq32vwnwqqgv4rzr'}, {'type': 0, 'spent': True, 'value': 546, 'spending_outpoints': [{'tx_index': 6341038870046895, 'n': 8}], 'n': 6, 'tx_index': 8425669997145948, 'script': '00209760928a37f3a32806d75a3ab4048c60901ea9ce6abe37e6f459ab51e49355bd', 'addr': 'bc1qjasf9z3h7w3jspkhtgatgpyvvzgpa2wwd2lr0eh5tx44reyn2k7sfc27a4'}, {'type': 0, 'spent': False, 'value': 546, 'spending_outpoints': [], 'n': 7, 'tx_index': 8425669997145948, 'script': '76a9146d57097a904ea9a39337d44d0254a9a36bff0f9d88ac', 'addr': '1Ay8vMC7R1UbyCCZRVULMV7iQpHSAbguJP'}, {'type': 0, 'spent': False, 'value': 546, 'spending_outpoints': [], 'n': 8, 'tx_index': 8425669997145948, 'script': '76a914a0b0d60e5991578ed37cbda2b17d8b2ce23ab29588ac', 'addr': '1FeexV6bAHb8ybZjqQMjJrcCrHGW9sb6uF'}, {'type': 0, 'spent': False, 'value': 546, 'spending_outpoints': [], 'n': 9, 'tx_index': 8425669997145948, 'script': 'a91423e522dfc6656a8fda3d47b4fa53f7585ac758cd87', 'addr': '34xp4vRoCGJym3xR7yCVPFHoCNxv4Twseo'}, {'type': 0, 'spent': False, 'value': 546, 'spending_outpoints': [], 'n': 10, 'tx_index': 8425669997145948, 'script': 'a914d401a46b6d847399a45878b1f25f499aad95983087', 'addr': '3M219KR5vEneNb47ewrPfWyb5jQ2DjxRP6'}, {'type': 0, 'spent': True, 'value': 1420, 'spending_outpoints': [{'tx_index': 8296879365211533, 'n': 0}], 'n': 11, 'tx_index': 8425669997145948, 'script': '76a91404cce600de4564e4810f13efff56d1507046e3fb88ac', 'addr': '1SPAMxHvs3opuDRkGTTdW4X2YixZecEEz'}]",546,7831703515140
33e3eca39e8f27a062ae049f8fc7d5504dd96be50441974801a69ff06487ad5f,2,1,2,171,480,555,0.0.0.0,0,3366364976649204,False,1726916784,862234,862234,"[{'sequence': 4294967295, 'witness': '01401c21af3f9a7537a4ca2b8d8cf91f6dacbf06fd51d58da9a11ce7516288c99664548187de7ca10a3c905c4ea8f4736ced18ddd4cd04bca8c680152175f242aba0', 'script': '', 'index': 0, 'prev_out': {'type': 0, 'spent': True, 'value': 885, 'spending_outpoints': [{'tx_index': 3366364976649204, 'n': 0}], 'n': 2, 'tx_index': 2409741286488960, 'script': '5120d359b87f1491f101194ee9fd60b8780cb56a8c35493fc70261e77bdefc81814a', 'addr': 'bc1p6dvmslc5j8cszx2wa87kpwrcpj6k4rp4fyluwqnpuaaaalyps99qltnf2t'}}]","[{'type': 0, 'spent': False, 'value': 330, 'spending_outpoints': [], 'n': 0, 'tx_index': 3366364976649204, 'script': '00143924fbe46da8ea43404e8cec962e91ac62bbd9e9', 'addr': 'bc1q8yj0herd4r4yxszw3nkfvt53433thk0f5qst4g'}, {'type': 0, 'spent': False, 'value': 0, 'spending_outpoints': [], 'n': 1, 'tx_index': 3366364976649204, 'script': '6a5d0914b8cd3414b80a1600'}]",330,7831703514594
04cc315ef005e6e200b305e6fb2b4db873f41c37324c066f4cb03a2f9aa3bf83,2,1,9,439,1429,1074,0.0.0.0,861863,4635491417057110,False,1726673975,861865,861865,"[{'sequence': 4294967293, 'witness': '0247304402204ef2228c983b6fd8965af5a5d8937949a281dbee525bdac8ee18d76ff19b5c9202203af242147ddf823865a1ff54621d1db9794e16e8f1022f96a6560f1278fb378d0121020059cf05ae2cc0d910cf46a037d61d1b4729d44e3a67eee2f1d49e04bedf97c1', 'script': '', 'index': 0, 'prev_out': {'type': 0, 'spent': True, 'value': 9560, 'spending_outpoints': [{'tx_index': 4635491417057110, 'n': 0}], 'n': 3, 'tx_index': 8106906834647119, 'script': '0014cd668a710b14ac2eac75bd6a19878ddf9880a030', 'addr': 'bc1qe4ng5ugtzjkzatr4h44pnpudm7vgpgpsmm96ez'}}]","[{'type': 0, 'spent': True, 'value': 942, 'spending_outpoints': [{'tx_index': 1727778968590539, 'n': 0}], 'n': 0, 'tx_index': 4635491417057110, 'script': '0014168a654bc61981a17d1ae880cd541a72415c89b3', 'addr': 'bc1qz69x2j7xrxq6zlg6azqv64q6wfq4ezdnh7exd8'}, {'type': 0, 'spent': True, 'value': 942, 'spending_outpoints': [{'tx_index': 1727778968590539, 'n': 1}], 'n': 1, 'tx_index': 4635491417057110, 'script': '0014168a654bc61981a17d1ae880cd541a72415c89b3', 'addr': 'bc1qz69x2j7xrxq6zlg6azqv64q6wfq4ezdnh7exd8'}, {'type': 0, 'spent': True, 'value': 942, 'spending_outpoints': [{'tx_index': 1768194837474854, 'n': 0}], 'n': 2, 'tx_index': 4635491417057110, 'script': '0014657f70b1940e94595eef6a83b4bb237b7487b9b3', 'addr': 'bc1qv4lhpvv5p629jhh0d2pmfwer0d6g0wdnrtnwnm'}, {'type': 0, 'spent': True, 'value': 942, 'spending_outpoints': [{'tx_index': 1727778968590539, 'n': 2}], 'n': 3, 'tx_index': 4635491417057110, 'script': '0014657f70b1940e94595eef6a83b4bb237b7487b9b3', 'addr': 'bc1qv4lhpvv5p629jhh0d2pmfwer0d6g0wdnrtnwnm'}, {'type': 0, 'spent': True, 'value': 942, 'spending_outpoints': [{'tx_index': 1727778968590539, 'n': 3}], 'n': 4, 'tx_index': 4635491417057110, 'script': '0014657f70b1940e94595eef6a83b4bb237b7487b9b3', 'addr': 'bc1qv4lhpvv5p629jhh0d2pmfwer0d6g0wdnrtnwnm'}, {'type': 0, 'spent': False, 'value': 942, 'spending_outpoints': [], 'n': 5, 'tx_index': 4635491417057110, 'script': '0014d6e9b2ba0a9c2ff5c38f2333f8468b2b4dc18b79', 'addr': 'bc1q6m5m9ws2nshltsu0yvels35t9dxurzmevdl9dq'}, {'type': 0, 'spent': True, 'value': 942, 'spending_outpoints': [{'tx_index': 1727778968590539, 'n': 4}], 'n': 6, 'tx_index': 4635491417057110, 'script': '0014fe39888b08a8baaf5543f785cdfda76ad2addcfb', 'addr': 'bc1qlcuc3zcg4za2742r77zumld8dtf2mh8mxs87zg'}, {'type': 0, 'spent': True, 'value': 942, 'spending_outpoints': [{'tx_index': 1727778968590539, 'n': 5}], 'n': 7, 'tx_index': 4635491417057110, 'script': '0014fe39888b08a8baaf5543f785cdfda76ad2addcfb', 'addr': 'bc1qlcuc3zcg4za2742r77zumld8dtf2mh8mxs87zg'}, {'type': 0, 'spent': False, 'value': 950, 'spending_outpoints': [], 'n': 8, 'tx_index': 4635491417057110, 'script': '00143924fbe46da8ea43404e8cec962e91ac62bbd9e9', 'addr': 'bc1q8yj0herd4r4yxszw3nkfvt53433thk0f5qst4g'}]",950,7831703514264
be550acb354d10e454997740112b8d63336897edadf51fd4e6d5b5a4c432276c,2,2,84,3023,11444,12875,0.0.0.0,0,3805299560715962,False,1726223099,861135,861135,"[{'sequence': 4294967295, 'witness': '0247304402202c8f2109faa2f66b8eca872d6743c4eb66c8ef76e7af96f290bf6d4db4ecfa2d02203b7cc48b89e53985ecbac2ae4bb36e80186511b9f7ad35d1f3c2901d1032ae70012102362b0c49e26625d004b06198ba1c050baefc56e0b7382e073be6ec9ffa02962f', 'script': '', 'index': 0, 'prev_out': {'type': 0, 'spent': True, 'value': 71384316, 'spending_outpoints': [{'tx_index': 3805299560715962, 'n': 0}], 'n': 0, 'tx_index': 4317639439460480, 'script': '001429bb19565b10209f711b3d0bd41834c7262b9e00', 'addr': 'bc1q9xa3j4jmzqsf7ugm859agxp5cunzh8sqps0f5v'}}, {'sequence': 4294967295, 'witness': '02473044022009d5ff554125bd9f52a54872fd11fddff6d18a533955a403a8390a8a6b1fb47002202b8e6f1adefd2a168e9f8979d9e9d675730d786be2741792c0cff7d36469cbd701210334842b608521d75dd7cc97cdada9559d1fb66391360e0f119a57f5f3bd76b6b6', 'script': '', 'index': 1, 'prev_out': {'type': 0, 'spent': True, 'value': 68368085, 'spending_outpoints': [{'tx_index': 3805299560715962, 'n': 1}], 'n': 0, 'tx_index': 305080953827830, 'script': '0014ef29a4955de039cd0b6ea20b8f59f4cc1c554ad9', 'addr': 'bc1qau56f92auquu6zmw5g9c7k05esw92jkeqcmxja'}}]","[{'type': 0, 'spent': True, 'value': 81661, 'spending_outpoints': [{'tx_index': 1895972980231990, 'n': 630}], 'n': 0, 'tx_index': 3805299560715962, 'script': 'a914afc24c25bed3e589b069da3fb7b744866058ad7687', 'addr': '3HiLw8wGyWdZt2378sESSDBMdQRoDJDoRK'}, {'type': 0, 'spent': True, 'value': 118732, 'spending_outpoints': [{'tx_index': 1049029255882875, 'n': 1}], 'n': 1, 'tx_index': 3805299560715962, 'script': '0014466768d120f551fca31aa41436d2e85e9b5553ce', 'addr': 'bc1qgenk35fq74glegc65s2rd5hgt6d4257wudwggv'}, {'type': 0, 'spent': True, 'value': 869461, 'spending_outpoints': [{'tx_index': 3608410011948878, 'n': 49}], 'n': 2, 'tx_index': 3805299560715962, 'script': '0014dd463d0abb23cedbaba252947081f6fa38725d24', 'addr': 'bc1qm4rr6z4my08dh2az2228pq0klgu8yhfyfzy89n'}, {'type': 0, 'spent': True, 'value': 17421, 'spending_outpoints': [{'tx_index': 2674659621366516, 'n': 118}], 'n': 3, 'tx_index': 3805299560715962, 'script': '0014fc9211b2ce58a904d0e061ecd138ee6151cffb75', 'addr': 'bc1qljfprvkwtz5sf58qv8kdzw8wv9gul7m4k3x83r'}, {'type': 0, 'spent': True, 'value': 17205, 'spending_outpoints': [{'tx_index': 6806617361184882, 'n': 98}], 'n': 4, 'tx_index': 3805299560715962, 'script': '76a9149a4662102374d8af8eb91cf278e8df628faa7d0c88ac', 'addr': '1F4jNqsJaoB7e5rpJumWA7pyxABjBUoetT'}, {'type': 0, 'spent': True, 'value': 330288, 'spending_outpoints': [{'tx_index': 2029036027918098, 'n': 0}], 'n': 5, 'tx_index': 3805299560715962, 'script': '0014b1d6558977f920beca02b5414b39d2bcdebc858e', 'addr': 'bc1qk8t9tzthlystajszk4q5kwwjhn0tepvwwveyz3'}, {'type': 0, 'spent': True, 'value': 246348, 'spending_outpoints': [{'tx_index': 1952877473168315, 'n': 183}], 'n': 6, 'tx_index': 3805299560715962, 'script': '0014e6469932821b098ae70b7fed3b3b6fc3b8c869cb', 'addr': 'bc1querfjv5zrvyc4ect0lknkwm0cwuvs6wt4aau7r'}, {'type': 0, 'spent': True, 'value': 78308, 'spending_outpoints': [{'tx_index': 1072100740151277, 'n': 41}], 'n': 7, 'tx_index': 3805299560715962, 'script': '0014c864faf59cadee5414996fab58a471dd5f29daa6', 'addr': 'bc1qepj04avu4hh9g9yed7443fr3m40jnk4x059uym'}, {'type': 0, 'spent': True, 'value': 103401, 'spending_outpoints': [{'tx_index': 3793174237234226, 'n': 52}], 'n': 8, 'tx_index': 3805299560715962, 'script': '0014287d79e25be2fdf167b58aca2d61131f9f667fdd', 'addr': 'bc1q9p7hncjmut7lzea43t9z6cgnr70kvl7aydlejc'}, {'type': 0, 'spent': True, 'value': 36474, 'spending_outpoints': [{'tx_index': 2267335871133668, 'n': 385}], 'n': 9, 'tx_index': 3805299560715962, 'script': 'a91402afaa19fd04af3cf13dc01772619c24fe461d1487', 'addr': '31wDiJpNyK1wNAJ3k47owaoqgHHvYmK261'}, {'type': 0, 'spent': True, 'value': 886173, 'spending_outpoints': [{'tx_index': 1430241599992946, 'n': 2}], 'n': 10, 'tx_index': 3805299560715962, 'script': 'a9146eb41454c9523ed7bb0bbe0758fa3071a849fa4f87', 'addr': '3BnMynLUEpV3ZmQtcy4BhgMVRaM2iNp7Cq'}, {'type': 0, 'spent': True, 'value': 36464, 'spending_outpoints': [{'tx_index': 3097986918682332, 'n': 286}], 'n': 11, 'tx_index': 3805299560715962, 'script': '00148046797597415a4ecd3c821b328c5e49d04e8220', 'addr': 'bc1qspr8javhg9dyanfusgdn9rz7f8gyaq3qv2wh2x'}, {'type': 0, 'spent': True, 'value': 36475, 'spending_outpoints': [{'tx_index': 6592238784610843, 'n': 0}], 'n': 12, 'tx_index': 3805299560715962, 'script': 'a914f9f2ae6be43d25f6bdaf416e3d772fd7d0df9b1187', 'addr': '3QUcu6zonQ8o1E2e3YhC4C1Ts2obbBir5x'}, {'type': 0, 'spent': True, 'value': 421552, 'spending_outpoints': [{'tx_index': 72157918464207, 'n': 8}], 'n': 13, 'tx_index': 3805299560715962, 'script': '0014f51f38fec2ff925504df1a02c59614df9de53332', 'addr': 'bc1q750n3lkzl7f92pxlrgpvt9s5m7w72vejuy745k'}, {'type': 0, 'spent': True, 'value': 498918, 'spending_outpoints': [{'tx_index': 8356565959052585, 'n': 38}], 'n': 14, 'tx_index': 3805299560715962, 'script': '76a9149f00662f9bddee26f766f0c15873562e064f940d88ac', 'addr': '1FVivEf15kBQQkuv6iq5do3AH5rn3F42PS'}, {'type': 0, 'spent': True, 'value': 1381593, 'spending_outpoints': [{'tx_index': 7435107068474251, 'n': 17}], 'n': 15, 'tx_index': 3805299560715962, 'script': '0014181f9f7602c7d09db7c92ec797eec07eb272c767', 'addr': 'bc1qrq0e7aszclgfmd7f9mre0mkq06e893m87zyfcc'}, {'type': 0, 'spent': True, 'value': 204322, 'spending_outpoints': [{'tx_index': 5815989476731116, 'n': 34}], 'n': 16, 'tx_index': 3805299560715962, 'script': '002041411cb8a64db84c1b2ae76bccaea882f9a79400c8e08de464925e563c0bea51', 'addr': 'bc1qg9q3ew9xfkuycxe2ua4uet4gstu609qqersgmeryjf09v0qtafgszx0rxt'}, {'type': 0, 'spent': False, 'value': 86027, 'spending_outpoints': [], 'n': 17, 'tx_index': 3805299560715962, 'script': '76a9143775a623831d21de358451660e55406c850567cf88ac', 'addr': '164F6wpCqxH4B7oWwPNxSjK8PiyPPf6dND'}, {'type': 0, 'spent': True, 'value': 583406, 'spending_outpoints': [{'tx_index': 5174776423228756, 'n': 0}], 'n': 18, 'tx_index': 3805299560715962, 'script': '00141291b68a8f5c93f2e0a55cf0396dc18bc177a9cf', 'addr': 'bc1qz2gmdz50tjfl9c99tncrjmwp30qh02w0vc783d'}, {'type': 0, 'spent': True, 'value': 65073, 'spending_outpoints': [{'tx_index': 3430924739791424, 'n': 860}], 'n': 19, 'tx_index': 3805299560715962, 'script': 'a91450cbe876c31211a26dc7d26edd2780d24cbec65e87', 'addr': '394EFfra3PzM2Yz53ie9EJu9RHRcoX85vG'}, {'type': 0, 'spent': True, 'value': 177564, 'spending_outpoints': [{'tx_index': 7754936078439794, 'n': 1}], 'n': 20, 'tx_index': 3805299560715962, 'script': '0014ef1bd8fd5a77945e9c7fb4a0370645c897ea5f22', 'addr': 'bc1qauda3l26w729a8rlkjsrwpj9ezt75hez2ktp7u'}, {'type': 0, 'spent': False, 'value': 60403, 'spending_outpoints': [], 'n': 21, 'tx_index': 3805299560715962, 'script': '76a9145cfaffa5193fd6e0579d37f010cba53ccbf93ea988ac', 'addr': '19UdrLbF1Yg16uMTMFBw3pvCtUXZfLakMX'}, {'type': 0, 'spent': True, 'value': 339501, 'spending_outpoints': [{'tx_index': 5430838118014937, 'n': 0}], 'n': 22, 'tx_index': 3805299560715962, 'script': '0014d40b1f9d277dedd2d99cfbf03af6f53a3d7ba74e', 'addr': 'bc1q6s93l8f80hka9kvul0cr4ah48g7hhf6wt25x9q'}, {'type': 0, 'spent': True, 'value': 344051, 'spending_outpoints': [{'tx_index': 5182212412932525, 'n': 0}], 'n': 23, 'tx_index': 3805299560715962, 'script': '001462549de7396f8acce933c72584734d58b3eeb74f', 'addr': 'bc1qvf2fmeeed79ve6fncujcgu6dtze7ad609ecakn'}, {'type': 0, 'spent': True, 'value': 246307, 'spending_outpoints': [{'tx_index': 807858265785596, 'n': 0}], 'n': 24, 'tx_index': 3805299560715962, 'script': '001476efa18015fbefd977fe1cb1b8bc1413284d5257', 'addr': 'bc1qwmh6rqq4l0hajal7rjcm30q5zv5y65jhzqxvg2'}, {'type': 0, 'spent': False, 'value': 5469, 'spending_outpoints': [], 'n': 25, 'tx_index': 3805299560715962, 'script': '00143924fbe46da8ea43404e8cec962e91ac62bbd9e9', 'addr': 'bc1q8yj0herd4r4yxszw3nkfvt53433thk0f5qst4g'}, {'type': 0, 'spent': True, 'value': 97788, 'spending_outpoints': [{'tx_index': 6668733235333634, 'n': 43}], 'n': 26, 'tx_index': 3805299560715962, 'script': '0014e08b67140de5d689e1acb09133417f2cc93ddfd8', 'addr': 'bc1quz9kw9qduhtgncdvkzgnxstl9nynmh7cq2mtjr'}, {'type': 0, 'spent': True, 'value': 77412, 'spending_outpoints': [{'tx_index': 1768131186257069, 'n': 648}], 'n': 27, 'tx_index': 3805299560715962, 'script': 'a91480f82755c426d5cc32c79e0bdc50ab243d54aaa587', 'addr': '3DSwh7gnZvugkvybFwkXShFZz6MwHz6ivU'}, {'type': 0, 'spent': True, 'value': 86014, 'spending_outpoints': [{'tx_index': 8288469223614062, 'n': 213}], 'n': 28, 'tx_index': 3805299560715962, 'script': '002093c24f6834d50c92828dd119d53693f861ebe932242d7b9d38af8b40592f8656', 'addr': 'bc1qj0py76p565xf9q5d6yva2d5nlps7h6fjyskhh8fc4795qkf0setqf3hkaj'}, {'type': 0, 'spent': True, 'value': 532982, 'spending_outpoints': [{'tx_index': 1464049341817291, 'n': 1}], 'n': 29, 'tx_index': 3805299560715962, 'script': '0014fbc91722b0d7cc4ec8ef5fe9f4baf4d8a7a5c09f', 'addr': 'bc1ql0y3wg4s6lxyaj80tl5lfwh5mzn6tsyld3r3ma'}, {'type': 0, 'spent': True, 'value': 1088136, 'spending_outpoints': [{'tx_index': 2355650589387087, 'n': 0}], 'n': 30, 'tx_index': 3805299560715962, 'script': '76a91426068c382f61f4caf12e381974b7c32091a4d7a788ac', 'addr': '14U4XEa5wYLqQAWdT1d4BFLezTE5J2qCEb'}, {'type': 0, 'spent': True, 'value': 37845, 'spending_outpoints': [{'tx_index': 8194857624237230, 'n': 0}], 'n': 31, 'tx_index': 3805299560715962, 'script': '00149e15bfa40e0cfe2c045eb900b48d3ef7bea3d7ab', 'addr': 'bc1qnc2mlfqwpnlzcpz7hyqtfrf777l284atlg6mf4'}, {'type': 0, 'spent': True, 'value': 330152, 'spending_outpoints': [{'tx_index': 3671498874414952, 'n': 0}], 'n': 32, 'tx_index': 3805299560715962, 'script': '0014fa81c7915b9f758e8cfe20a76fb2d9dfce4148cf', 'addr': 'bc1ql2qu0y2mna6car87yznklvkeml8yzjx0ccp37f'}, {'type': 0, 'spent': True, 'value': 49860, 'spending_outpoints': [{'tx_index': 5100001066976445, 'n': 417}], 'n': 33, 'tx_index': 3805299560715962, 'script': 'a9148c9b62b02ece64934504c3f7f945c5ef72ed858787', 'addr': '3EWUfmqbgWiJo5WuEpdn2porvmJbToiCwc'}, {'type': 0, 'spent': True, 'value': 44836, 'spending_outpoints': [{'tx_index': 3793174237234226, 'n': 47}], 'n': 34, 'tx_index': 3805299560715962, 'script': '001455a0e889641730c2e99985d58e5c59cc6d134031', 'addr': 'bc1q2ksw3ztyzucv96vesh2cuhzee3k3xsp3m5qg40'}, {'type': 0, 'spent': True, 'value': 145266, 'spending_outpoints': [{'tx_index': 3458956557861830, 'n': 846}], 'n': 35, 'tx_index': 3805299560715962, 'script': 'a914e2232e17514bc5873da7cd5ade369ac28e7a6f3c87', 'addr': '3NJinFSD3ctbuF9vpa2VK2AbGAGMovAD6L'}, {'type': 0, 'spent': True, 'value': 860447, 'spending_outpoints': [{'tx_index': 4715893348834056, 'n': 33}], 'n': 36, 'tx_index': 3805299560715962, 'script': '0014f412e84d302161aa9caa4f4d0cc60460199436fa', 'addr': 'bc1q7sfwsnfsy9s64892faxse3syvqvegdh6cm3j2e'}, {'type': 0, 'spent': True, 'value': 123157, 'spending_outpoints': [{'tx_index': 2438487758948804, 'n': 1}], 'n': 37, 'tx_index': 3805299560715962, 'script': '00143c86677c526aef77b7005fbb212c784bd7f3dc97', 'addr': 'bc1q8jrxwlzjdthh0dcqt7ajztrcf0tl8hyhcejw38'}, {'type': 0, 'spent': True, 'value': 36471, 'spending_outpoints': [{'tx_index': 268739542301141, 'n': 368}], 'n': 38, 'tx_index': 3805299560715962, 'script': '0014824243bffc01e0538c0c568305190ddf58bed3b0', 'addr': 'bc1qsfpy80luq8s98rqv26ps2xgdmavta5asczzg3y'}, {'type': 0, 'spent': True, 'value': 162152, 'spending_outpoints': [{'tx_index': 841311171077043, 'n': 134}], 'n': 39, 'tx_index': 3805299560715962, 'script': '00148bf17d833c57622078098d0a33cd64c8d2f6b246', 'addr': 'bc1q30chmqeu2a3zq7qf359r8ntyerf0dvjxqhjgr8'}, {'type': 0, 'spent': True, 'value': 103230, 'spending_outpoints': [{'tx_index': 7363391808830207, 'n': 130}], 'n': 40, 'tx_index': 3805299560715962, 'script': '0020a9927e5b63360bb7c45bc6cf4b4152cd318fd962dd54bfb55be0c15137aeb763', 'addr': 'bc1q4xf8ukmrxc9m03zmcm85ks2je5cclktzm42tld2murq4zdawka3s9pzdpl'}, {'type': 0, 'spent': True, 'value': 30973, 'spending_outpoints': [{'tx_index': 4544751831330610, 'n': 2}], 'n': 41, 'tx_index': 3805299560715962, 'script': '001487619243b574deadc7b5a3c5135de86057e220c9', 'addr': 'bc1qsaseysa4wn02m3a450z3xh0gvpt7ygxfgrztpe'}, {'type': 0, 'spent': True, 'value': 129022, 'spending_outpoints': [{'tx_index': 4069089551179914, 'n': 44}], 'n': 42, 'tx_index': 3805299560715962, 'script': '76a914d3cf413dbbe3cf06a1a4dc94ab4f3c2c2c39825988ac', 'addr': '1LJwro9A9uMgrP3fvJYh3bXa8dq3gMZyHD'}, {'type': 0, 'spent': True, 'value': 11374, 'spending_outpoints': [{'tx_index': 7938021748016345, 'n': 15}], 'n': 43, 'tx_index': 3805299560715962, 'script': '001447ed1636e3d2b0d2f04e229641e4b1b70bbe0faa', 'addr': 'bc1qglk3vdhr62cd9uzwy2tyre93ku9mura24lrg9s'}, {'type': 0, 'spent': True, 'value': 605501, 'spending_outpoints': [{'tx_index': 2421968704493329, 'n': 21}], 'n': 44, 'tx_index': 3805299560715962, 'script': '76a9147fbe60cb2fdc380f39d3aac49b4960bd6738a8ed88ac', 'addr': '1CeSt4kuTFAgcy8DYoEtFTj3xahx4Xs1D4'}, {'type': 0, 'spent': True, 'value': 212711, 'spending_outpoints': [{'tx_index': 7501232802431187, 'n': 0}], 'n': 45, 'tx_index': 3805299560715962, 'script': '001401f6204e84f59b39a7734e46e89b58df3112bab4', 'addr': 'bc1qq8mzqn5y7kdnnfmnferw3x6cmuc39w45450d0v'}, {'type': 0, 'spent': True, 'value': 103399, 'spending_outpoints': [{'tx_index': 2694296871157746, 'n': 90}], 'n': 46, 'tx_index': 3805299560715962, 'script': '001489cc7bc47d99a07c9ecd1945cb36c4e9bb6b17c7', 'addr': 'bc1q38x8h3ranxs8e8kdr9zukdkyaxakk9785fgkhj'}, {'type': 0, 'spent': True, 'value': 201034, 'spending_outpoints': [{'tx_index': 3277850528599413, 'n': 279}], 'n': 47, 'tx_index': 3805299560715962, 'script': 'a9147258ff8d128b5f97819bb713f65a1b1bf3dbb49587', 'addr': '3C7da7rX85wEPWEgk6QV7viN7tbNBu6QjN'}, {'type': 0, 'spent': True, 'value': 68824, 'spending_outpoints': [{'tx_index': 5564629625733884, 'n': 14}], 'n': 48, 'tx_index': 3805299560715962, 'script': '76a914bd3eea5ebbd71dc7c7ceeb188e181b9075a528d688ac', 'addr': '1JFe5hiossMrumugRhQf8gP7Y7PC9Rai3c'}, {'type': 0, 'spent': True, 'value': 161983, 'spending_outpoints': [{'tx_index': 5134248510877690, 'n': 0}], 'n': 49, 'tx_index': 3805299560715962, 'script': '76a914a8b1eac4d8fb0b579106f9215ca4f1dc7d5327c888ac', 'addr': '1GNyf85MrAXfr42vNj5QH4A8J7DqrJrEjK'}, {'type': 0, 'spent': True, 'value': 115335798, 'spending_outpoints': [{'tx_index': 8631398785272216, 'n': 0}], 'n': 50, 'tx_index': 3805299560715962, 'script': '0014d748ca34ab6cf890e643b0af1a97b91e084e4adb', 'addr': 'bc1q6ayv5d9tdnufpejrkzh349aercyyujkmwne89a'}, {'type': 0, 'spent': True, 'value': 575011, 'spending_outpoints': [{'tx_index': 3905410179670224, 'n': 27}], 'n': 51, 'tx_index': 3805299560715962, 'script': '0014f092e893a1592c6edf4953d02cc401303892c1a2', 'addr': 'bc1q7zfw3yaptykxah6f20gze3qpxquf9sdzalpppa'}, {'type': 0, 'spent': True, 'value': 27529, 'spending_outpoints': [{'tx_index': 5250086172073892, 'n': 43}], 'n': 52, 'tx_index': 3805299560715962, 'script': '0014ad22ffec12dba22443b683d02e8cbc7c78a4a869', 'addr': 'bc1q4530lmqjmw3zgsaks0gzar9u03u2f2rfdzvw2l'}, {'type': 0, 'spent': True, 'value': 49872, 'spending_outpoints': [{'tx_index': 7770658155393709, 'n': 3}], 'n': 53, 'tx_index': 3805299560715962, 'script': '0014126830a63801ff6781eccae6949d337efcfcdd0f', 'addr': 'bc1qzf5rpf3cq8lk0q0vetnff8fn0m70ehg0cfsv6t'}, {'type': 0, 'spent': True, 'value': 78316, 'spending_outpoints': [{'tx_index': 1444692126492958, 'n': 1}], 'n': 54, 'tx_index': 3805299560715962, 'script': '00143c9b1ef5ae6c7758be3874e84b19ff2d7bfc94f8', 'addr': 'bc1q8jd3aadwd3m4303cwn5ykx0l94ale98c9ek4es'}, {'type': 0, 'spent': True, 'value': 120150, 'spending_outpoints': [{'tx_index': 8515648632009487, 'n': 0}], 'n': 55, 'tx_index': 3805299560715962, 'script': '001460d878eec5f0b5759fa5a9afaf84e09d7ce3709f', 'addr': 'bc1qvrv83mk97z6ht8a94xh6lp8qn47wxuylaz055t'}, {'type': 0, 'spent': True, 'value': 161993, 'spending_outpoints': [{'tx_index': 341556338136931, 'n': 27}], 'n': 56, 'tx_index': 3805299560715962, 'script': 'a914cb488dd08e6fed34be8eaffb59f28a4f70a4929e87', 'addr': '3LDt1d6LvjXm7cKtzaUJRABhk2vXRqskEJ'}, {'type': 0, 'spent': True, 'value': 23083, 'spending_outpoints': [{'tx_index': 5284216101313578, 'n': 2}], 'n': 57, 'tx_index': 3805299560715962, 'script': '0014ffb08ee0359ed173e0d5c71ce7d5ece002bdb3ac', 'addr': 'bc1ql7cgacp4nmgh8cx4cuww040vuqptmvav2zmn8n'}, {'type': 0, 'spent': False, 'value': 36467, 'spending_outpoints': [], 'n': 58, 'tx_index': 3805299560715962, 'script': '00205565a7165b6aba108618041b39cc9856120fe4921f9d5e348cae3ff768dd4fde', 'addr': 'bc1q24j6w9jmd2apppscqsdnnnyc2cfqleyjr7w4udyv4cllw6xafl0q3kg0dy'}, {'type': 0, 'spent': True, 'value': 89452, 'spending_outpoints': [{'tx_index': 7886358837515412, 'n': 1}], 'n': 59, 'tx_index': 3805299560715962, 'script': '0014339603705e7e4796d6d2f0611afabddb4ace5f45', 'addr': 'bc1qxwtqxuz70ered4kj7ps3474amd9vuh69dfs6sj'}, {'type': 0, 'spent': True, 'value': 26833, 'spending_outpoints': [{'tx_index': 878013063121855, 'n': 4}], 'n': 60, 'tx_index': 3805299560715962, 'script': '0014948d9e7dbffb4ea3310844be8bd7573a3bbc2b08', 'addr': 'bc1qjjxeuldlld82xvgggjlgh46h8gamc2cg3qcq0r'}, {'type': 0, 'spent': True, 'value': 474020, 'spending_outpoints': [{'tx_index': 6438757211577335, 'n': 0}], 'n': 61, 'tx_index': 3805299560715962, 'script': '76a91412e914a944f32a6f5b4c6a31ca0da8075b38766b88ac', 'addr': '12izPBhTijjnwTpJoQeMPqU5PbXJtwhEx7'}, {'type': 0, 'spent': True, 'value': 970523, 'spending_outpoints': [{'tx_index': 7560643951127050, 'n': 5}], 'n': 62, 'tx_index': 3805299560715962, 'script': '76a9145ee370ca9b52dd036ee50c151fb8800871824f1288ac', 'addr': '19eiyt834L5A25Lyi42pJiGittW8o1oNXX'}, {'type': 0, 'spent': True, 'value': 78318, 'spending_outpoints': [{'tx_index': 6311511135481197, 'n': 84}], 'n': 63, 'tx_index': 3805299560715962, 'script': '0014f1d51bbd45c5afafcc2da372fec13a891522e386', 'addr': 'bc1q7823h029ckh6lnpd5de0asf63y2j9cuxd7vd6q'}, {'type': 0, 'spent': True, 'value': 34404, 'spending_outpoints': [{'tx_index': 841311171077043, 'n': 46}], 'n': 64, 'tx_index': 3805299560715962, 'script': '00143791a0605e17d383754649abcb866c51f370af66', 'addr': 'bc1qx7g6qcz7zlfcxa2xfx4uhpnv28ehptmxjtjlay'}, {'type': 0, 'spent': True, 'value': 103560, 'spending_outpoints': [{'tx_index': 8352572704048631, 'n': 4}], 'n': 65, 'tx_index': 3805299560715962, 'script': '00143291b8e4582a21b2136f5f9a0b49849638e15a06', 'addr': 'bc1qx2gm3ezc9gsmyym0t7dqkjvyjcuwzksxuane48'}, {'type': 0, 'spent': True, 'value': 162646, 'spending_outpoints': [{'tx_index': 7462411962810317, 'n': 0}], 'n': 66, 'tx_index': 3805299560715962, 'script': '001410f21f9e5facb539b1512f7d0bb73432a78d543e', 'addr': 'bc1qzrepl8jl4j6nnv239a7shde5x2nc64p7d3jwhv'}, {'type': 0, 'spent': True, 'value': 44838, 'spending_outpoints': [{'tx_index': 6178233365594908, 'n': 7}], 'n': 67, 'tx_index': 3805299560715962, 'script': '00145b9337ce7b3241f16f3bfa1badc6a15f4eaea687', 'addr': 'bc1qtwfn0nnmxfqlzmemlgd6m34pta82af58ep0xa7'}, {'type': 0, 'spent': True, 'value': 68783, 'spending_outpoints': [{'tx_index': 3863815709984576, 'n': 282}], 'n': 68, 'tx_index': 3805299560715962, 'script': 'a91468efdc558e36e3eca3cf6e14735121e36915410a87', 'addr': '3BFsYJiskF99jLXj6hdib51K82DHQkk6Zc'}, {'type': 0, 'spent': True, 'value': 161990, 'spending_outpoints': [{'tx_index': 7897604143831578, 'n': 615}], 'n': 69, 'tx_index': 3805299560715962, 'script': 'a9147c3525571ec0b9e5bc6241d8843defe220ff7f9487', 'addr': '3D1mNyCrJ6V1uVVS94oJVmwhRxEqQVVJHH'}, {'type': 0, 'spent': True, 'value': 305913, 'spending_outpoints': [{'tx_index': 7851487842544219, 'n': 2}], 'n': 70, 'tx_index': 3805299560715962, 'script': '0014960a610ad81ba37d30b0fc942088451eda8e918e', 'addr': 'bc1qjc9xzzkcrw3h6v9slj2zpzz9rmdgayvwmtwmd9'}, {'type': 0, 'spent': True, 'value': 88796, 'spending_outpoints': [{'tx_index': 7001058293523429, 'n': 0}], 'n': 71, 'tx_index': 3805299560715962, 'script': '0014aad2a0dd4b0acefad8337d867dc38d6b825433a4', 'addr': 'bc1q4tf2ph2tpt804kpn0kr8msuddwp9gvaykssshu'}, {'type': 0, 'spent': True, 'value': 30912, 'spending_outpoints': [{'tx_index': 3762433200689305, 'n': 430}], 'n': 72, 'tx_index': 3805299560715962, 'script': '001446bea14d68af857321c8fb9d54d83cbe647bf8ac', 'addr': 'bc1qg6l2zntg47zhxgwglww4fkpuhej8h79v23hf97'}, {'type': 0, 'spent': False, 'value': 55056, 'spending_outpoints': [], 'n': 73, 'tx_index': 3805299560715962, 'script': '002060e54ede7a603649bfe240b5ef3ea66e2a6b811d5f731d31cb1e683797019c63', 'addr': 'bc1qvrj5ahn6vqmyn0lzgz67704xdc4xhqgatae36vwtre5r09cpn33sdm2fqx'}, {'type': 0, 'spent': True, 'value': 44728, 'spending_outpoints': [{'tx_index': 5882320613194958, 'n': 195}], 'n': 74, 'tx_index': 3805299560715962, 'script': '001451bf25639569872c2b3dafb3f59a24a78b2d2b4d', 'addr': 'bc1q2xlj2cu4dxrjc2ea47eltx3y579j626dly62aa'}, {'type': 0, 'spent': True, 'value': 3440338, 'spending_outpoints': [{'tx_index': 4436829226062947, 'n': 80}], 'n': 75, 'tx_index': 3805299560715962, 'script': '76a914df58d6dd1430e0bb9ed2b1dcd6ddaca303dea6a088ac', 'addr': '1MMx7Scwcie8uFEgGyYcfRK8j4mtbNnPzi'}, {'type': 0, 'spent': True, 'value': 77434, 'spending_outpoints': [{'tx_index': 3793174237234226, 'n': 44}], 'n': 76, 'tx_index': 3805299560715962, 'script': '0014ead7d095aba32403f2ca9d08e107b9232232c1bc', 'addr': 'bc1qattap9dt5vjq8uk2n5ywzpaeyv3r9sduhjwnee'}, {'type': 0, 'spent': True, 'value': 187607, 'spending_outpoints': [{'tx_index': 5631820207769780, 'n': 5}], 'n': 77, 'tx_index': 3805299560715962, 'script': '00145e007937c5de6ee3a60e9505b871b3e11d4d3bfb', 'addr': 'bc1qtcq8jd79mehw8fswj5zmsudnuyw56wlm7hwljx'}, {'type': 0, 'spent': True, 'value': 60208, 'spending_outpoints': [{'tx_index': 6859314181719779, 'n': 994}], 'n': 78, 'tx_index': 3805299560715962, 'script': '0014fe4f08d13b5444cd6ebea419b7ea7b0ae564bdcd', 'addr': 'bc1qle8s35fm23zv6m475svm06nmptjkf0wdlv84rz'}, {'type': 0, 'spent': True, 'value': 2524657, 'spending_outpoints': [{'tx_index': 8897982743113818, 'n': 0}], 'n': 79, 'tx_index': 3805299560715962, 'script': '0014638ccbc563cb24065a8c322d1bac4a1bfac76fb5', 'addr': 'bc1qvwxvh3trevjqvk5vxgk3htz2r0avwma40hda75'}, {'type': 0, 'spent': True, 'value': 406665, 'spending_outpoints': [{'tx_index': 5678594280532616, 'n': 458}], 'n': 80, 'tx_index': 3805299560715962, 'script': '001401babcdfd4e2ef52d91291415cb265ee01d5b767', 'addr': 'bc1qqxateh75uth49kgjj9q4evn9acqatdm8wf9qda'}, {'type': 0, 'spent': True, 'value': 1088193, 'spending_outpoints': [{'tx_index': 268739542301141, 'n': 369}], 'n': 81, 'tx_index': 3805299560715962, 'script': '001458f5e926b2794beafb6971354505688a355ee370', 'addr': 'bc1qtr67jf4j099747mfwy652ptg3g64acmsd3rvel'}, {'type': 0, 'spent': True, 'value': 17205, 'spending_outpoints': [{'tx_index': 5651686405401711, 'n': 152}], 'n': 82, 'tx_index': 3805299560715962, 'script': '00148fdbad9ba763a9a48eaf819b8a70c9b5a5bbadab', 'addr': 'bc1q3ld6mxa8vw56fr40sxdc5uxfkkjmhtdt7f2zgq'}, {'type': 0, 'spent': True, 'value': 215062, 'spending_outpoints': [{'tx_index': 7011908777704922, 'n': 3}], 'n': 83, 'tx_index': 3805299560715962, 'script': '76a91464974e7fb115294580c34c0e92851632c6a4006388ac', 'addr': '1AAsq9qi7ohobe23JKVqT8o3uAm4UHgopR'}]",5469,7831703513314
1b2424d8fbd61cf211f8746bfb04af6e9f02415a4faa7bf6e1ccce9a6e7809ce,2,2,74,2706,10176,11449,0.0.0.0,0,7249282257344985,False,1726221133,861133,861133,"[{'sequence': 4294967295, 'witness': '0247304402202d9cda0000361eb4f6852d8ab96b67f512a80e1cad6414bcba41f337560c1a3602205f47cb70d428c71e94509cf2f8de4c980bcaad05184ea77540d7baec6a0bb174012103040fdc63e79a301eb775b87e0237e572dd7651f9f6e08acafe10d23c5f2a9e1c', 'script': '', 'index': 0, 'prev_out': {'type': 0, 'spent': True, 'value': 55929626, 'spending_outpoints': [{'tx_index': 7249282257344985, 'n': 0}], 'n': 130, 'tx_index': 13456723070354, 'script': '00141e0b987a1c21d02d8b9c9008289281ee82c06c45', 'addr': 'bc1qrc9es7suy8gzmzuujqyz3y5pa6pvqmz96csnlk'}}, {'sequence': 4294967295, 'witness': '02473044022014ab4750089984c83d49b48914fc9e00a1b5e173042d2246b8adb734d8f3cf2d02205f92eb3ca24cb3d2e937c224054aa6b5ba894921bf93a04682d61cc38960035c0121028207e46b5c3c129141ba80bbeecf64c08c675298bf5ff2eb94f0ff7334ceff43', 'script': '', 'index': 1, 'prev_out': {'type': 0, 'spent': True, 'value': 55830291, 'spending_outpoints': [{'tx_index': 7249282257344985, 'n': 1}], 'n': 61, 'tx_index': 8422339974293634, 'script': '001437937c5446e05ddd099b3b59fca9dd445c65f11a', 'addr': 'bc1qx7fhc4zxupwa6zvm8dvle2wag3wxtug6qu3k0w'}}]","[{'type': 0, 'spent': True, 'value': 118656, 'spending_outpoints': [{'tx_index': 5599670710503294, 'n': 134}], 'n': 0, 'tx_index': 7249282257344985, 'script': '001416643e88497ee3f44cf94083a115e90d789c2b9a', 'addr': 'bc1qzejrazzf0m3lgn8egzp6z90fp4ufc2u6zaatlh'}, {'type': 0, 'spent': True, 'value': 120458, 'spending_outpoints': [{'tx_index': 615809289299488, 'n': 24}], 'n': 1, 'tx_index': 7249282257344985, 'script': '76a914cba1839508703130a450c4d986ca341e119ae10d88ac', 'addr': '1KZhf8a7kMw2utVSuYLr5gDUky4NxcnR5N'}, {'type': 0, 'spent': True, 'value': 734789, 'spending_outpoints': [{'tx_index': 8503772211448650, 'n': 50}], 'n': 2, 'tx_index': 7249282257344985, 'script': '001480ccff117fb76c127d7c7ec4fc5c0b1d5d43f589', 'addr': 'bc1qsrx07ytlkakpyltu0mz0chqtr4w58avfy5xtn5'}, {'type': 0, 'spent': True, 'value': 1214249, 'spending_outpoints': [{'tx_index': 7268063183451733, 'n': 85}], 'n': 3, 'tx_index': 7249282257344985, 'script': '76a9149de5df15324e01c5c8b54b61e3b9f8f37079f5ff88ac', 'addr': '1FPtTs5dXyYqwbZYjd8bB5mJQAgf1vEJGb'}, {'type': 0, 'spent': True, 'value': 3441877, 'spending_outpoints': [{'tx_index': 6150355871637576, 'n': 1}], 'n': 4, 'tx_index': 7249282257344985, 'script': '76a9140742eb6a0eac4998d8752428c4ca128a068cc2af88ac', 'addr': '1fPtzqhcndsUYvmomdbxUEPgu5EGL7Jdf'}, {'type': 0, 'spent': True, 'value': 29753, 'spending_outpoints': [{'tx_index': 4826268571735069, 'n': 129}], 'n': 5, 'tx_index': 7249282257344985, 'script': 'a91422e12803b204fef2c6991130a538e71a6f1972e987', 'addr': '34sSdCaTDTjktX5Y1c3Ezfo4W7v7sRZ9zD'}, {'type': 0, 'spent': True, 'value': 3114696, 'spending_outpoints': [{'tx_index': 5070810607492729, 'n': 32}], 'n': 6, 'tx_index': 7249282257344985, 'script': '76a914ce5ef5543da5c22c42f8f55e167bba5a44365c7788ac', 'addr': '1KpBxLXExnGDuzBW7fcgrQtjEiVWct3Y1G'}, {'type': 0, 'spent': False, 'value': 46480, 'spending_outpoints': [], 'n': 7, 'tx_index': 7249282257344985, 'script': '76a914c631f9d29d1973d664f2a70eeef55815df8a8c0688ac', 'addr': '1K4xfNGiwA7oxQ1AGzAkyvdTYXXRYWB8cQ'}, {'type': 0, 'spent': True, 'value': 128971, 'spending_outpoints': [{'tx_index': 3149127742033549, 'n': 3}], 'n': 8, 'tx_index': 7249282257344985, 'script': '001457a5027104c24d33102f710bb98ffb306894176c', 'addr': 'bc1q27jsyugycfxnxyp0wy9mnrlmxp5fg9mvp04dfd'}, {'type': 0, 'spent': True, 'value': 23449, 'spending_outpoints': [{'tx_index': 1982874612639549, 'n': 219}], 'n': 9, 'tx_index': 7249282257344985, 'script': '0014aff92e2fbefb05d149b6efeea5ad2672a3f87c98', 'addr': 'bc1q4lujuta7lvzazjdkalh2ttfxw23lslyc2m3s5u'}, {'type': 0, 'spent': True, 'value': 709506, 'spending_outpoints': [{'tx_index': 5294435829842124, 'n': 1}], 'n': 10, 'tx_index': 7249282257344985, 'script': 'a914f435dc336202ff3b2bc05cca58b241e1d0e50cf187', 'addr': '3PxHKcuNTQcWPW93jsUcWpzx4jhTejxCBd'}, {'type': 0, 'spent': True, 'value': 170803, 'spending_outpoints': [{'tx_index': 5814628792634849, 'n': 984}], 'n': 11, 'tx_index': 7249282257344985, 'script': 'a9147c3525571ec0b9e5bc6241d8843defe220ff7f9487', 'addr': '3D1mNyCrJ6V1uVVS94oJVmwhRxEqQVVJHH'}, {'type': 0, 'spent': True, 'value': 187576, 'spending_outpoints': [{'tx_index': 5025356441695276, 'n': 825}], 'n': 12, 'tx_index': 7249282257344985, 'script': 'a914add13d15bade5f47c886d9692f612fb583a4df4e87', 'addr': '3HY5UtEPQPUXUo2vLCKk5tZZdbe5fh2nZz'}, {'type': 0, 'spent': True, 'value': 17732, 'spending_outpoints': [{'tx_index': 1982874612639549, 'n': 88}], 'n': 13, 'tx_index': 7249282257344985, 'script': '0014fb10b8076d17366ff697799f8b79277d7622bf5d', 'addr': 'bc1qlvgtspmdzumxla5h0x0ck7f804mz906auyazl4'}, {'type': 0, 'spent': True, 'value': 68835, 'spending_outpoints': [{'tx_index': 3863815709984576, 'n': 297}], 'n': 14, 'tx_index': 7249282257344985, 'script': 'a914f97a57b6f438c9b0cfc079bde60644710bb4bd4f87', 'addr': '3QS8jpo5pFd4A6iis7Jy9UduuujrDt7gKC'}, {'type': 0, 'spent': True, 'value': 111752, 'spending_outpoints': [{'tx_index': 6351968377509388, 'n': 0}], 'n': 15, 'tx_index': 7249282257344985, 'script': '0014090b5b730e45d92235730cb37a17f87506351929', 'addr': 'bc1qpy94kucwghvjydtnpjeh59lcw5rr2xffuq8y8l'}, {'type': 0, 'spent': True, 'value': 1849914, 'spending_outpoints': [{'tx_index': 3039154006905415, 'n': 42}], 'n': 16, 'tx_index': 7249282257344985, 'script': '76a91403286ac4208c58ec891ec0c9de96d841629a77f888ac', 'addr': '1HhSoVyJxvKKxymNUoTdq25M8UunLvxQW'}, {'type': 0, 'spent': True, 'value': 7155, 'spending_outpoints': [{'tx_index': 6265652840247991, 'n': 80}], 'n': 17, 'tx_index': 7249282257344985, 'script': 'a9147cb764d3ffe2062c97e16ded70ba3f79b50c6e9d87', 'addr': '3D4TQm1CvBMx1toD4ThXTPAJRjePDEYSQU'}, {'type': 0, 'spent': True, 'value': 79150, 'spending_outpoints': [{'tx_index': 1010077584323619, 'n': 3}], 'n': 18, 'tx_index': 7249282257344985, 'script': '0014542a924f7a4f4e573ad1d212433e187a61463e39', 'addr': 'bc1q2s4fynm6fa89wwk36gfyx0sc0fs5v03esrx5e0'}, {'type': 0, 'spent': True, 'value': 1729853, 'spending_outpoints': [{'tx_index': 4691020040755876, 'n': 0}], 'n': 19, 'tx_index': 7249282257344985, 'script': '76a914222c944c9c4f47bf7edf1f3903a7a63733a3a43588ac', 'addr': '147hNwrwtkHRJ5FZEWWZ3JSkBGADDpRhJG'}, {'type': 0, 'spent': True, 'value': 28078, 'spending_outpoints': [{'tx_index': 416549359807894, 'n': 0}], 'n': 20, 'tx_index': 7249282257344985, 'script': '0014e38f402ea070b5482cfe8b83cdcb7704b01b6835', 'addr': 'bc1quw85qt4qwz65st873wpumjmhqjcpk6p45jsl03'}, {'type': 0, 'spent': True, 'value': 60221, 'spending_outpoints': [{'tx_index': 2292477107679160, 'n': 226}], 'n': 21, 'tx_index': 7249282257344985, 'script': 'a914975179344e676e42f97a18bf8d705796ff5ce60c87', 'addr': '3FV7ZPHPeLnouAJe6ugHKGtgFe42RpUgjw'}, {'type': 0, 'spent': True, 'value': 296671, 'spending_outpoints': [{'tx_index': 2710856196766935, 'n': 0}], 'n': 22, 'tx_index': 7249282257344985, 'script': '0014f49a1f479f56043d0cc247bb8f0873ddaa556235', 'addr': 'bc1q7jdp73ul2czr6rxzg7ac7zrnmk492c34ejlzwk'}, {'type': 0, 'spent': True, 'value': 51516, 'spending_outpoints': [{'tx_index': 2181750862319914, 'n': 106}], 'n': 23, 'tx_index': 7249282257344985, 'script': '00144bffcec04bffab0baee699cb15c88f301f9e1a5c', 'addr': 'bc1qf0luasztl74shthxn893tjy0xq0euxjuyyhkfp'}, {'type': 0, 'spent': True, 'value': 344180, 'spending_outpoints': [{'tx_index': 6092749418303177, 'n': 12}], 'n': 24, 'tx_index': 7249282257344985, 'script': '76a91479d650b51cf86aa316e09707a160488d6c46544788ac', 'addr': '1C7DW6dUGhpc1HLYoJeJgvaymywe9VTdoQ'}, {'type': 0, 'spent': True, 'value': 195949, 'spending_outpoints': [{'tx_index': 3999443078445728, 'n': 39}], 'n': 25, 'tx_index': 7249282257344985, 'script': '76a9147573575ea16ca936e5c57d9552f372cf18db97d888ac', 'addr': '1Bi2EVqzuYbNsVuHSjdcZhLR8uv9z7ejqV'}, {'type': 0, 'spent': True, 'value': 94644, 'spending_outpoints': [{'tx_index': 3984075572812919, 'n': 23}], 'n': 26, 'tx_index': 7249282257344985, 'script': 'a914fe5f202119818d8ff4c3fb4498228436bcdfbd2d87', 'addr': '3Qt1Whpfzs6RKj4jwrsV6benq5DQpEMAfa'}, {'type': 0, 'spent': True, 'value': 246277, 'spending_outpoints': [{'tx_index': 6483566139441983, 'n': 16}], 'n': 27, 'tx_index': 7249282257344985, 'script': 'a914be546263ebf3a85db8f87e7497778814981dea5587', 'addr': '3K3PQ7oSFrZqdGetX4RP52BT9vLiaYhoUZ'}, {'type': 0, 'spent': True, 'value': 37856, 'spending_outpoints': [{'tx_index': 3108953452602007, 'n': 258}], 'n': 28, 'tx_index': 7249282257344985, 'script': 'a9145cac6583eb3b1deb464b239329f9deededd68ee687', 'addr': '3A92cWmUAoK8iG4yyrQGijezip9Vtmk3W1'}, {'type': 0, 'spent': True, 'value': 164063, 'spending_outpoints': [{'tx_index': 7340756960810477, 'n': 11}], 'n': 29, 'tx_index': 7249282257344985, 'script': '0014d26178bd0a3d2c64f62b5ff566ab44a1fad7e88a', 'addr': 'bc1q6fsh30g285kxfa3ttl6kd26y58ad06y2ytrr70'}, {'type': 0, 'spent': True, 'value': 56503, 'spending_outpoints': [{'tx_index': 7714978258804861, 'n': 61}], 'n': 30, 'tx_index': 7249282257344985, 'script': '0014616c279e9c06404f6a37ddb4465744a9eafe6425', 'addr': 'bc1qv9kz085uqeqy763hmk6yv46y4840uep9jjdytg'}, {'type': 0, 'spent': True, 'value': 162592, 'spending_outpoints': [{'tx_index': 2542955264103913, 'n': 0}], 'n': 31, 'tx_index': 7249282257344985, 'script': '0014c65b34fbd7b89367bd2983cf232582ebc2cade2d', 'addr': 'bc1qcednf77hhzfk00ffs08jxfvza0pv4h3d9s44ts'}, {'type': 0, 'spent': True, 'value': 260200, 'spending_outpoints': [{'tx_index': 4460692310502186, 'n': 9}], 'n': 32, 'tx_index': 7249282257344985, 'script': '00141547bd46713c512ad0b5ae38beb23900dad5d10e', 'addr': 'bc1qz4rm63n383gj45944cutav3eqrddt5gwrexpqr'}, {'type': 0, 'spent': True, 'value': 145590, 'spending_outpoints': [{'tx_index': 7879575460134297, 'n': 7}], 'n': 33, 'tx_index': 7249282257344985, 'script': '001497e260baa48df9baab8bd8e5804555385d3e45ed', 'addr': 'bc1qjl3xpw4y3hum42utmrjcq3248pwnu30dkfxa9t'}, {'type': 0, 'spent': True, 'value': 1668609, 'spending_outpoints': [{'tx_index': 317597552276479, 'n': 33}], 'n': 34, 'tx_index': 7249282257344985, 'script': '76a91455675a6bf7d2b63e13b7c648c5f67e95b5e442b588ac', 'addr': '18naFQvg5hrRbMLasPGABX9TbtjtUACkR6'}, {'type': 0, 'spent': True, 'value': 78302, 'spending_outpoints': [{'tx_index': 4416851530246060, 'n': 238}], 'n': 35, 'tx_index': 7249282257344985, 'script': 'a914c1fdf091cb412397dc6567bb1f3ebd8fbca8196e87', 'addr': '3KNkYcExSkGfSF1LKXVJKkayMzdpGDY4ZK'}, {'type': 0, 'spent': True, 'value': 8746, 'spending_outpoints': [{'tx_index': 1404260501574124, 'n': 43}], 'n': 36, 'tx_index': 7249282257344985, 'script': '0020efd8f317a0d357b97c2b551a5bfd68cf3e87dd70ac32a03623913886280372fa', 'addr': 'bc1qalv0x9aq6dtmjlpt25d9hltgeulg0hts4se2qd3rjyugv2qrwtaqaw23v4'}, {'type': 0, 'spent': True, 'value': 44795, 'spending_outpoints': [{'tx_index': 2967423099632750, 'n': 362}], 'n': 37, 'tx_index': 7249282257344985, 'script': 'a914a832e17fe5a2d3f2558ca783d7e6a8b1dd5531f487', 'addr': '3H2NQ2zomFzZFubKZGHpci8jyBFyn8zKn3'}, {'type': 0, 'spent': True, 'value': 34418, 'spending_outpoints': [{'tx_index': 5404045003847206, 'n': 3}], 'n': 38, 'tx_index': 7249282257344985, 'script': '76a914baa61e1aa2c57a7fbecc4dffec3965ecb3d1df2788ac', 'addr': '1J1ugjXazgtje4sqFpykULtvkj9ZwiaUCf'}, {'type': 0, 'spent': True, 'value': 1032714, 'spending_outpoints': [{'tx_index': 3534115102072153, 'n': 34}], 'n': 39, 'tx_index': 7249282257344985, 'script': '76a91461485e5b71f10fe46579f918d8fd3b625e51c37788ac', 'addr': '19sPEsAKEMcvCThBLc7hPWkiozATXsz5Hw'}, {'type': 0, 'spent': True, 'value': 415131, 'spending_outpoints': [{'tx_index': 8937280263639284, 'n': 0}], 'n': 40, 'tx_index': 7249282257344985, 'script': '0014ef0c487bdb5cc0f615790d71be9da1582087ac16', 'addr': 'bc1qauxys77mtnq0v9tep4cma8dptqsg0tqkechdnk'}, {'type': 0, 'spent': True, 'value': 54861, 'spending_outpoints': [{'tx_index': 1404260501574124, 'n': 25}], 'n': 41, 'tx_index': 7249282257344985, 'script': '00204fb644f369c6eeeac9f5ea640c6df10e40e9c13138a77a88abad8e79311ed368', 'addr': 'bc1qf7myfumfcmhw4j04afjqcm03peqwnsf38znh4z9t4k88jvg76d5q4f2ddn'}, {'type': 0, 'spent': True, 'value': 60230, 'spending_outpoints': [{'tx_index': 7829736326034791, 'n': 2}], 'n': 42, 'tx_index': 7249282257344985, 'script': '001436d9aaf048ea2ffe4bdca0e8481043f21f946a4a', 'addr': 'bc1qxmv64uzgaghluj7u5r5ysyzr7g0eg6j2vr9ys7'}, {'type': 0, 'spent': True, 'value': 3367874, 'spending_outpoints': [{'tx_index': 964044264517050, 'n': 73}], 'n': 43, 'tx_index': 7249282257344985, 'script': '76a9143ef101c811974c15cb6b3a6397b4f38a559bdfba88ac', 'addr': '16jocMLKBoGaUZiVZsWuAcZLfkc227wQS6'}, {'type': 0, 'spent': True, 'value': 161957, 'spending_outpoints': [{'tx_index': 2674659621366516, 'n': 429}], 'n': 44, 'tx_index': 7249282257344985, 'script': '00146a6c6373cc069b49a76b3008b06f9c360bc435ae', 'addr': 'bc1qdfkxxu7vq6d5nfmtxqytqmuuxc9ugddw5j5x82'}, {'type': 0, 'spent': True, 'value': 172091, 'spending_outpoints': [{'tx_index': 8856931910352753, 'n': 1}], 'n': 45, 'tx_index': 7249282257344985, 'script': '0014ae7fd65634d0d6ee31fa14a42912db2dca01803c', 'addr': 'bc1q4elav4356rtwuv06zjjzjykm9h9qrqpu966czs'}, {'type': 0, 'spent': True, 'value': 1720876, 'spending_outpoints': [{'tx_index': 62468017650474, 'n': 0}], 'n': 46, 'tx_index': 7249282257344985, 'script': '00142c4ee6834170da787f98ad3c4d86aed360aa6c36', 'addr': 'bc1q938wdq6pwrd8sluc457ymp4w6ds25mpkf2kck2'}, {'type': 0, 'spent': False, 'value': 6784, 'spending_outpoints': [], 'n': 47, 'tx_index': 7249282257344985, 'script': '00143924fbe46da8ea43404e8cec962e91ac62bbd9e9', 'addr': 'bc1q8yj0herd4r4yxszw3nkfvt53433thk0f5qst4g'}, {'type': 0, 'spent': True, 'value': 3388465, 'spending_outpoints': [{'tx_index': 5692142631481849, 'n': 55}], 'n': 48, 'tx_index': 7249282257344985, 'script': '76a914847e849162c94cb3fb353b3768e1fb3cc56bc4b588ac', 'addr': '1D5ZkwFyT1mZcnSwveLM4p2CrEx7oox69D'}, {'type': 0, 'spent': True, 'value': 111757, 'spending_outpoints': [{'tx_index': 2517751642554022, 'n': 28}], 'n': 49, 'tx_index': 7249282257344985, 'script': '76a91432f8f644d65dd6c3698f502c3b22c4fa549e8fb788ac', 'addr': '15eX2msiP5TdSJ93CSxapyTp9xB4S7PJF2'}, {'type': 0, 'spent': True, 'value': 195296, 'spending_outpoints': [{'tx_index': 8937280263639284, 'n': 2}], 'n': 50, 'tx_index': 7249282257344985, 'script': '00144c919fda988fb27e48e77bcde982f96e36114e57', 'addr': 'bc1qfjgelk5c37e8uj8800x7nqhedcmpznjhxsrah0'}, {'type': 0, 'spent': True, 'value': 36457, 'spending_outpoints': [{'tx_index': 2267335871133668, 'n': 347}], 'n': 51, 'tx_index': 7249282257344985, 'script': 'a914060b130a81c35fd64c6d16077bace61afc335fdd87', 'addr': '32EyFA1KVEwDh8aRSAndWpsa39puSa1bzA'}, {'type': 0, 'spent': True, 'value': 71387463, 'spending_outpoints': [{'tx_index': 4317639439460480, 'n': 0}], 'n': 52, 'tx_index': 7249282257344985, 'script': '0014013fcfed898da9ea8e03f5e2a82c782942d3d6f7', 'addr': 'bc1qqylulmvf3k574rsr7h32strc99pd84hh844gpz'}, {'type': 0, 'spent': True, 'value': 44804, 'spending_outpoints': [{'tx_index': 8519853260713148, 'n': 150}], 'n': 53, 'tx_index': 7249282257344985, 'script': '00142e9a8afc0217c0f25c8a7a31656996f95d0e512c', 'addr': 'bc1q96dg4lqzzlq0yhy20gck26vkl9wsu5fvzt7cwm'}, {'type': 0, 'spent': True, 'value': 56529, 'spending_outpoints': [{'tx_index': 8857188946051609, 'n': 9}], 'n': 54, 'tx_index': 7249282257344985, 'script': 'a914fee42fbe867056efaa33e00333cd8bbfe9bb6a9387', 'addr': '3QvkuwkHA874XLz6erhoNDGBCPaAwjp3Tn'}, {'type': 0, 'spent': True, 'value': 79120, 'spending_outpoints': [{'tx_index': 3793174237234226, 'n': 26}], 'n': 55, 'tx_index': 7249282257344985, 'script': '00143ad0d5a487a11f6e3d838d5492f478d2913c7ca8', 'addr': 'bc1q8tgdtfy85y0ku0vr342f9arc62gncl9gvlh0zk'}, {'type': 0, 'spent': False, 'value': 28117, 'spending_outpoints': [], 'n': 56, 'tx_index': 7249282257344985, 'script': '76a9146d7c1b50574791b02df69c7c18f45920833f5eef88ac', 'addr': '1AyuKzeFnf9x9szuT7j2xyxRVgx7RzSsZh'}, {'type': 0, 'spent': True, 'value': 1003887, 'spending_outpoints': [{'tx_index': 5140558789316694, 'n': 123}], 'n': 57, 'tx_index': 7249282257344985, 'script': '0014cd1cd3aaff623674fd7f3244a87596e426154ff9', 'addr': 'bc1qe5wd82hlvgm8fltlxfz2savkusnp2nlep3ppg4'}, {'type': 0, 'spent': True, 'value': 28075, 'spending_outpoints': [{'tx_index': 375224634792945, 'n': 19}], 'n': 58, 'tx_index': 7249282257344985, 'script': '0014ee6edabf91755ef9d923c066d3ba1be9a6bd3fca', 'addr': 'bc1qaehd40u3w400nkfrcpnd8wsmaxnt6072uy8a6f'}, {'type': 0, 'spent': True, 'value': 1850892, 'spending_outpoints': [{'tx_index': 5159960689066746, 'n': 4}], 'n': 59, 'tx_index': 7249282257344985, 'script': '76a91495dea5f6097eb2d042e68c3291b824b50f7bc73a88ac', 'addr': '1EfSQTVidYK88EsPCNFRmER8UB6hUsZ9Yg'}, {'type': 0, 'spent': True, 'value': 204363, 'spending_outpoints': [{'tx_index': 425598712313861, 'n': 0}], 'n': 60, 'tx_index': 7249282257344985, 'script': '0014440b2e290460ed236226f00b7d27c2929b5c533a', 'addr': 'bc1qgs9ju2gyvrkjxc3x7q9h6f7zj2d4c5e69swurd'}, {'type': 0, 'spent': True, 'value': 53183, 'spending_outpoints': [{'tx_index': 7090930483993363, 'n': 73}], 'n': 61, 'tx_index': 7249282257344985, 'script': '00145edf02d6e926f526997d0c23138e9384b8d9e78c', 'addr': 'bc1qtm0s94hfym6jdxtaps338r5nsjudneuvnxkpsx'}, {'type': 0, 'spent': True, 'value': 583349, 'spending_outpoints': [{'tx_index': 2374045444856720, 'n': 25}], 'n': 62, 'tx_index': 7249282257344985, 'script': '76a91450fe6a958f4613a2f388b2e25cb417c0b8b1294a88ac', 'addr': '18PFqWEKCYt9fvAZevWRAc3irF1K7RX5Gn'}, {'type': 0, 'spent': True, 'value': 36141, 'spending_outpoints': [{'tx_index': 301097946178081, 'n': 1012}], 'n': 63, 'tx_index': 7249282257344985, 'script': 'a91472306a720c0bc1a996c1d9f12adeaa8f38ee828487', 'addr': '3C6nxQETdNRgWTxd2dyxBeFm7pRt4NdriD'}, {'type': 0, 'spent': True, 'value': 301120, 'spending_outpoints': [{'tx_index': 8710647649741861, 'n': 50}], 'n': 64, 'tx_index': 7249282257344985, 'script': '0014de5a2bc7ae864a7f04a221d733498f052bb0a6cd', 'addr': 'bc1qmedzh3awse987p9zy8tnxjv0q54mpfkd3eceuh'}, {'type': 0, 'spent': True, 'value': 1204682, 'spending_outpoints': [{'tx_index': 2798779933763260, 'n': 0}], 'n': 65, 'tx_index': 7249282257344985, 'script': '76a914b43409e5a6eb749db0b6cb51f3fbbba07a7be58f88ac', 'addr': '1HRpyEryDq5wX4GF42p2iSUF1SJ6YRJXZr'}, {'type': 0, 'spent': True, 'value': 980343, 'spending_outpoints': [{'tx_index': 6265652840247991, 'n': 12}], 'n': 66, 'tx_index': 7249282257344985, 'script': 'a91431693308925b4c4a197b48dbc52d211cbaf196ef87', 'addr': '36CH4KenLnEEBCq9ZBSt26te9coU9tGr69'}, {'type': 0, 'spent': True, 'value': 1691107, 'spending_outpoints': [{'tx_index': 7556725486615725, 'n': 0}], 'n': 67, 'tx_index': 7249282257344985, 'script': '0014b5204ba9db814b3d455fe02c1158038febc565a5', 'addr': 'bc1qk5syh2wms99n632luqkpzkqr3l4u2ed99dxyvq'}, {'type': 0, 'spent': True, 'value': 211075, 'spending_outpoints': [{'tx_index': 2583565537411291, 'n': 486}], 'n': 68, 'tx_index': 7249282257344985, 'script': 'a91458b7e23f469a4f620b5d124e82d69a1c8011c7cc87', 'addr': '39n7ftnhtxKkqZei1NKSZZysHea66wWbU5'}, {'type': 0, 'spent': True, 'value': 1570964, 'spending_outpoints': [{'tx_index': 8524473213012828, 'n': 71}], 'n': 69, 'tx_index': 7249282257344985, 'script': 'a9148a76262744b0a7f1c5bab6ef06605949b4a992d987', 'addr': '3EK8i9xohBmYETpVX6RRwnNfpDivU6eNz6'}, {'type': 0, 'spent': True, 'value': 18023, 'spending_outpoints': [{'tx_index': 881533428717133, 'n': 134}], 'n': 70, 'tx_index': 7249282257344985, 'script': '76a9143b5ba539e0c94c548cabbbc2f33fa02d830f350788ac', 'addr': '16QrexGxWo276ChPNqj3jCyZWsYTX2W9Bp'}, {'type': 0, 'spent': True, 'value': 51618, 'spending_outpoints': [{'tx_index': 6757684319100093, 'n': 291}], 'n': 71, 'tx_index': 7249282257344985, 'script': 'a914a73b4bad55e5ada43e0d3bbd5035838b7d2aef8b87', 'addr': '3GwFoWaumWMAkxqNU1ZcUtKJ4eij9TEj16'}, {'type': 0, 'spent': True, 'value': 77432, 'spending_outpoints': [{'tx_index': 5514555442841815, 'n': 870}], 'n': 72, 'tx_index': 7249282257344985, 'script': 'a914b130f89a3365bc4539df9dd98a3fcd6d3379b2f687', 'addr': '3HqvC4zTKt3MgynN5o7cEVAJYpe92TYZHq'}, {'type': 0, 'spent': True, 'value': 1676824, 'spending_outpoints': [{'tx_index': 2894269949307881, 'n': 0}], 'n': 73, 'tx_index': 7249282257344985, 'script': '0014ad02c613d0bb0a96c1c64b2cf5028d27187bb6e1', 'addr': 'bc1q45pvvy7shv9fdswxfvk02q5dyuv8hdhpfesyzn'}]",6784,7831703507845
7537803292e292df81a05a4956673ddfe64f57f328bb1b16ff248006cfe33888,2,1,3,243,645,810,0.0.0.0,0,4792893489336324,False,1724940221,858969,858969,"[{'sequence': 4294967295, 'witness': '0247304402206a7ae01ff22cad38c7df75983223e091bb140314b9ed0aff5472d3c4d2428a060220686eb2864e5063fff3c068734785876075ed22444d1f728ad3280cdf3e6453b1012103e6a18a5cdaa2bbf3a71e5c0c1876d9ce996bc7c6c24d994b0780e9864340503a', 'script': '', 'index': 0, 'prev_out': {'type': 0, 'spent': True, 'value': 55266, 'spending_outpoints': [{'tx_index': 4792893489336324, 'n': 0}], 'n': 2, 'tx_index': 3112713048647507, 'script': '0014edbd2227e119cae98dd39fb1ca46b0434d54d39b', 'addr': 'bc1qak7jyflpr89wnrwnn7cu534sgdx4f5umwjgag6'}}]","[{'type': 0, 'spent': False, 'value': 330, 'spending_outpoints': [], 'n': 0, 'tx_index': 4792893489336324, 'script': '00143924fbe46da8ea43404e8cec962e91ac62bbd9e9', 'addr': 'bc1q8yj0herd4r4yxszw3nkfvt53433thk0f5qst4g'}, {'type': 0, 'spent': False, 'value': 0, 'spending_outpoints': [], 'n': 1, 'tx_index': 4792893489336324, 'script': '6a5d091497b63414b90c1600'}, {'type': 0, 'spent': True, 'value': 54126, 'spending_outpoints': [{'tx_index': 4439322163980079, 'n': 0}], 'n': 2, 'tx_index': 4792893489336324, 'script': '0014edbd2227e119cae98dd39fb1ca46b0434d54d39b', 'addr': 'bc1qak7jyflpr89wnrwnn7cu534sgdx4f5umwjgag6'}]",330,7831703501061
438b13eef9d371c26fa049e14edcb6e17d01fc340d5c300c2d5d703c2b9813e6,2,2,3,323,890,669,0.0.0.0,0,8095098615598603,False,1724823582,858755,858755,"[{'sequence': 4294967295, 'witness': '0140363e5fd5cc9d30d7d77df3214ce45edae3a0c2a6b186a83815ccede066fde751b42abc1918eeedb1b3c80e8c975812f5408b257a5c241aff5f5a5ea8434e34bd', 'script': '', 'index': 0, 'prev_out': {'type': 0, 'spent': True, 'value': 330, 'spending_outpoints': [{'tx_index': 8095098615598603, 'n': 0}], 'n': 0, 'tx_index': 3255969477728781, 'script': '51207866ad37336ac7811f2eaf77e28255276f2e4ce7973205f0a2a513ef501af6bb', 'addr': 'bc1p0pn26dendtrcz8ew4am79qj4yahjun88jueqtu9z55f775q676as4amnq8'}}, {'sequence': 4294967295, 'witness': '01401f08c9c57c8bef91cfa3509d65f870b30f6065bbb64bf5ed56c11bfbb4d92d26b543ab4c07d6d46891b416992f1586f637ab5b83645e41157ef20811d3482800', 'script': '', 'index': 1, 'prev_out': {'type': 0, 'spent': True, 'value': 10519, 'spending_outpoints': [{'tx_index': 8095098615598603, 'n': 1}], 'n': 2, 'tx_index': 922218919297799, 'script': '51207866ad37336ac7811f2eaf77e28255276f2e4ce7973205f0a2a513ef501af6bb', 'addr': 'bc1p0pn26dendtrcz8ew4am79qj4yahjun88jueqtu9z55f775q676as4amnq8'}}]","[{'type': 0, 'spent': False, 'value': 546, 'spending_outpoints': [], 'n': 0, 'tx_index': 8095098615598603, 'script': '00143924fbe46da8ea43404e8cec962e91ac62bbd9e9', 'addr': 'bc1q8yj0herd4r4yxszw3nkfvt53433thk0f5qst4g'}, {'type': 0, 'spent': False, 'value': 0, 'spending_outpoints': [], 'n': 1, 'tx_index': 8095098615598603, 'script': '6a5d0b0090c533028094ebdc0300'}, {'type': 0, 'spent': True, 'value': 9634, 'spending_outpoints': [{'tx_index': 1960320300245113, 'n': 1}], 'n': 2, 'tx_index': 8095098615598603, 'script': '51207866ad37336ac7811f2eaf77e28255276f2e4ce7973205f0a2a513ef501af6bb', 'addr': 'bc1p0pn26dendtrcz8ew4am79qj4yahjun88jueqtu9z55f775q676as4amnq8'}]",546,7831703500731
e5b2e1abaccd113accf136fa91a910291c9e3e78e3f64781e746dc304d88ded8,2,1,4,451,1474,3285,0.0.0.0,0,7630408995183496,False,1721761770,853605,853605,"[{'sequence': 4294967293, 'witness': '02483045022100bb2d38204d172363c06631d814edabc512076486ef660fbcc952846c656aa08e02202b085df44bb3372510914624f157bf7ad76343b4f235d047bf46d56dc74a92db0121028f550a0e7239da720ef65769f132c27138202dcc881180927d3bc98d163f6713', 'script': '', 'index': 0, 'prev_out': {'type': 0, 'spent': True, 'value': 157231, 'spending_outpoints': [{'tx_index': 7630408995183496, 'n': 0}], 'n': 1, 'tx_index': 1733701519514919, 'script': '0014db0529c641dde2fe6a2fb0df9062f61b0f64722b', 'addr': 'bc1qmvzjn3jpmh30u630kr0eqchkrv8kgu3t5z3ecn'}}]","[{'type': 0, 'spent': False, 'value': 547, 'spending_outpoints': [], 'n': 0, 'tx_index': 7630408995183496, 'script': '00143924fbe46da8ea43404e8cec962e91ac62bbd9e9', 'addr': 'bc1q8yj0herd4r4yxszw3nkfvt53433thk0f5qst4g'}, {'type': 0, 'spent': True, 'value': 151807, 'spending_outpoints': [{'tx_index': 479861620737138, 'n': 0}], 'n': 1, 'tx_index': 7630408995183496, 'script': '0014db0529c641dde2fe6a2fb0df9062f61b0f64722b', 'addr': 'bc1qmvzjn3jpmh30u630kr0eqchkrv8kgu3t5z3ecn'}, {'type': 0, 'spent': False, 'value': 796, 'spending_outpoints': [], 'n': 2, 'tx_index': 7630408995183496, 'script': '51210250681b9d5415a299a8be54e62e3ad87a18b6354048c34b13d60ef33b38b8e21c210227beee99dac1e12371504d5d3dfa191a28182cdf0e33906672ca57934b0772802102222222222222222222222222222222222222222222222222222222222222222253ae'}, {'type': 0, 'spent': False, 'value': 796, 'spending_outpoints': [], 'n': 3, 'tx_index': 7630408995183496, 'script': '51210239f3d3b5b69f046789f52bc28d841e8e05bc0d4fbd8479376863279c970ff29d2102e8ac14d7f55e7cfdfbb845f9b84a7c114a04319bcaebe9cbb87f8fdc1ead018f2102222222222222222222222222222222222222222222222222222222222222222253ae'}]",547,7831703500185
b46003d3d98f8ee21d16d78971ce5ef60847fada40cdff7c6c369e2cbb5cbf55,2,1,3,214,652,815,0.0.0.0,0,3016972252320710,False,1721179419,852535,852535,"[{'sequence': 4294967295, 'witness': '01402a87e27c01bde68aa4a5be321637d4bfb70d0c9f8509020be1f8fefa4c0b675cd2f71cbe52e53a461628368912a73e868e92a1efad275b0f56a581fa81ba8ce9', 'script': '', 'index': 0, 'prev_out': {'type': 0, 'spent': True, 'value': 18000, 'spending_outpoints': [{'tx_index': 3016972252320710, 'n': 0}], 'n': 1, 'tx_index': 8525611823267562, 'script': '512083681b64fee2dee9208344fc2d3d434c47dc053878b43c144f93c47d097961b0', 'addr': 'bc1psd5pke87ut0wjgyrgn7z602rf3racpfc0z6rc9z0j0z86ztevxcqje209n'}}]","[{'type': 0, 'spent': False, 'value': 330, 'spending_outpoints': [], 'n': 0, 'tx_index': 3016972252320710, 'script': '00143924fbe46da8ea43404e8cec962e91ac62bbd9e9', 'addr': 'bc1q8yj0herd4r4yxszw3nkfvt53433thk0f5qst4g'}, {'type': 0, 'spent': False, 'value': 0, 'spending_outpoints': [], 'n': 1, 'tx_index': 3016972252320710, 'script': '6a5d0914fdc53314aa091600'}, {'type': 0, 'spent': True, 'value': 16855, 'spending_outpoints': [{'tx_index': 8244723940887164, 'n': 0}], 'n': 2, 'tx_index': 3016972252320710, 'script': '512083681b64fee2dee9208344fc2d3d434c47dc053878b43c144f93c47d097961b0', 'addr': 'bc1psd5pke87ut0wjgyrgn7z602rf3racpfc0z6rc9z0j0z86ztevxcqje209n'}]",330,7831703499638
76e16271c99a39391b1f4d0b714583f2ffe5c169093d001bb0a36f45d0e0bddd,2,1,1,340,586,882,0.0.0.0,0,7801842889698804,False,1718642980,851013,851013,"[{'sequence': 4294967295, 'witness': '034052968a949c5a15d1ed854ecc2b24fbeacfba8728adedcf77a40d61fc302ccab2b7b54ea88278ee15f4647ee87ba3631b843d63a6aedb6952c11903e0c6425f5b9b202ed0aac521d860ee19195632ebb00999fe101a1734d987676bac0843921d7cdaac0063036f7264010118746578742f706c61696e3b636861727365743d7574662d38004c547b2270223a226272632d3230222c226f70223a226d696e74222c227469636b223a2252455744222c22616d74223a22313030222c2277656273697465223a227777772e62726332307265776172642e636f6d227d6821c02ed0aac521d860ee19195632ebb00999fe101a1734d987676bac0843921d7cda', 'script': '', 'index': 0, 'prev_out': {'type': 0, 'spent': True, 'value': 1428, 'spending_outpoints': [{'tx_index': 7801842889698804, 'n': 0}], 'n': 1, 'tx_index': 2703012732731307, 'script': '51209c9dde276c872bebaf558b55d2ff1f48b7d510df44447ee4eeaa462dc03984ae', 'addr': 'bc1pnjwaufmvsu47ht643d2a9lclfzma2yxlg3z8ae8w4frzmspesjhqtradck'}}]","[{'type': 0, 'spent': False, 'value': 546, 'spending_outpoints': [], 'n': 0, 'tx_index': 7801842889698804, 'script': '00143924fbe46da8ea43404e8cec962e91ac62bbd9e9', 'addr': 'bc1q8yj0herd4r4yxszw3nkfvt53433thk0f5qst4g'}]",546,7831703499308
9b2f389b476eef251d4f01fd18b703e4ae7698621edfff272fe6e2c1f1bbaadf,2,1,1,188,752,5613,0.0.0.0,846683,7869580499762268,False,1717637050,846685,846685,"[{'sequence': 4294967293, 'witness': '', 'script': '47304402201c91c671f416c555a79f0c14d5925280189ce7549aa7c53a17bc380d69ac7fa102202eb27ec635ad473a437fac3d40b818a4f9f9f4d4865a8d78d6262a00b3bfdb050121029e850709ad256adeba896d58823bf58332b806ed3b3d0cdaa13ec146d7fe195a', 'index': 0, 'prev_out': {'type': 0, 'spent': True, 'value': 24200, 'spending_outpoints': [{'tx_index': 7869580499762268, 'n': 0}], 'n': 0, 'tx_index': 1860096700895893, 'script': '76a91442412962f7430b9ec4c136522b82468aec9d34f788ac', 'addr': '173KfB2ADAZQduiXNgzWfhADUeUdcNgYFu'}}]","[{'type': 0, 'spent': False, 'value': 18587, 'spending_outpoints': [], 'n': 0, 'tx_index': 7869580499762268, 'script': '00143924fbe46da8ea43404e8cec962e91ac62bbd9e9', 'addr': 'bc1q8yj0herd4r4yxszw3nkfvt53433thk0f5qst4g'}]",18587,7831703498762
867ec8ba5bd8f252ba9679f3602722143e7d4500bd6e46018495123f71c32ca9,2,2,2,371,833,2288,0.0.0.0,0,5952311124288082,False,1715655199,843385,843385,"[{'sequence': 2147483649, 'witness': '02483045022100e21259bf095c37740aebc7e4393d6f16c2edfe263c048453d100bec849552908022033bfe8d36e4d90e56fad2a6c304879883f1d408d5693489a6ea74c63529e7f7c012103fc8b6f61fe5fce765ec5e6f2aebbbc5ac638c9e212a2c7cf6cd1f4b342f481b6', 'script': '', 'index': 0, 'prev_out': {'type': 0, 'spent': True, 'value': 546, 'spending_outpoints': [{'tx_index': 5952311124288082, 'n': 0}], 'n': 0, 'tx_index': 7299124325535937, 'script': '0014420785cdc830d229175b1277354f7f1a5f9d0941', 'addr': 'bc1qggrctnwgxrfzj96mzfmn2nmlrf0e6z2pcuemrc'}}, {'sequence': 2147483649, 'witness': '024730440220099e639388984697a3a7277ae73b3d1dd7606582652fb01cffb760713edfe5cb02203af3a9239b95fa16811dfc461ea2eb43a013427db5c236005fbacab7ba4b6236012103fc8b6f61fe5fce765ec5e6f2aebbbc5ac638c9e212a2c7cf6cd1f4b342f481b6', 'script': '', 'index': 1, 'prev_out': {'type': 0, 'spent': True, 'value': 38085, 'spending_outpoints': [{'tx_index': 5952311124288082, 'n': 1}], 'n': 1, 'tx_index': 672564362937865, 'script': '0014420785cdc830d229175b1277354f7f1a5f9d0941', 'addr': 'bc1qggrctnwgxrfzj96mzfmn2nmlrf0e6z2pcuemrc'}}]","[{'type': 0, 'spent': False, 'value': 546, 'spending_outpoints': [], 'n': 0, 'tx_index': 5952311124288082, 'script': '00143924fbe46da8ea43404e8cec962e91ac62bbd9e9', 'addr': 'bc1q8yj0herd4r4yxszw3nkfvt53433thk0f5qst4g'}, {'type': 0, 'spent': True, 'value': 35797, 'spending_outpoints': [{'tx_index': 5126315721765875, 'n': 0}], 'n': 1, 'tx_index': 5952311124288082, 'script': '0014420785cdc830d229175b1277354f7f1a5f9d0941', 'addr': 'bc1qggrctnwgxrfzj96mzfmn2nmlrf0e6z2pcuemrc'}]",546,7831703480175
06e1983430ec675ee2e379c29c017698624072bec8494e74d475452bc909f0f2,1,2,6,441,1362,3762,0.0.0.0,0,8547608648050862,False,1715260396,843051,843051,"[{'sequence': 4294967295, 'witness': '0140ef17afd59fc92e99355754edfd5bce4e77c5c3a1e2a8941470c2e304a67f4f17eb8dd462cd61f594e78ccc9cc5c9147ff7159278b32a75d3e9afd904e81a2e51', 'script': '', 'index': 0, 'prev_out': {'type': 0, 'spent': True, 'value': 546, 'spending_outpoints': [{'tx_index': 8547608648050862, 'n': 0}], 'n': 0, 'tx_index': 7577075648049658, 'script': '51207d7ea9b09960a515e9d980be42e04a47a7cf73543ed85df3c30b5978d8131295', 'addr': 'bc1p04l2nvyevzj3t6weszly9cz2g7nu7u658mv9mu7rpdvh3kqnz22s4vawjf'}}, {'sequence': 4294967295, 'witness': '014065c00872dbfa1e6c84daa3d0a6cbb3b5bb725b81026ffb19f383a1e08f00e7b5c40b793b54feaf1cb5a1c6ea520956325295f60498bc2bdc2590a48749042f12', 'script': '', 'index': 1, 'prev_out': {'type': 0, 'spent': True, 'value': 66423, 'spending_outpoints': [{'tx_index': 8547608648050862, 'n': 1}], 'n': 3, 'tx_index': 4399370077623763, 'script': '51207d7ea9b09960a515e9d980be42e04a47a7cf73543ed85df3c30b5978d8131295', 'addr': 'bc1p04l2nvyevzj3t6weszly9cz2g7nu7u658mv9mu7rpdvh3kqnz22s4vawjf'}}]","[{'type': 0, 'spent': True, 'value': 546, 'spending_outpoints': [{'tx_index': 2895684169992299, 'n': 2}], 'n': 0, 'tx_index': 8547608648050862, 'script': '51207d7ea9b09960a515e9d980be42e04a47a7cf73543ed85df3c30b5978d8131295', 'addr': 'bc1p04l2nvyevzj3t6weszly9cz2g7nu7u658mv9mu7rpdvh3kqnz22s4vawjf'}, {'type': 0, 'spent': False, 'value': 0, 'spending_outpoints': [], 'n': 1, 'tx_index': 8547608648050862, 'script': '6a5d1500cab5339b01c8d007020000c070030000ccb10304'}, {'type': 0, 'spent': False, 'value': 546, 'spending_outpoints': [], 'n': 2, 'tx_index': 8547608648050862, 'script': '76a914a0b0d60e5991578ed37cbda2b17d8b2ce23ab29588ac', 'addr': '1FeexV6bAHb8ybZjqQMjJrcCrHGW9sb6uF'}, {'type': 0, 'spent': False, 'value': 546, 'spending_outpoints': [], 'n': 3, 'tx_index': 8547608648050862, 'script': '0014e8b1bf6a27a1e76929b229f595f64cd381c87d87', 'addr': 'bc1qazcm763858nkj2dj986etajv6wquslv8uxwczt'}, {'type': 0, 'spent': False, 'value': 546, 'spending_outpoints': [], 'n': 4, 'tx_index': 8547608648050862, 'script': '00143924fbe46da8ea43404e8cec962e91ac62bbd9e9', 'addr': 'bc1q8yj0herd4r4yxszw3nkfvt53433thk0f5qst4g'}, {'type': 0, 'spent': True, 'value': 61023, 'spending_outpoints': [{'tx_index': 1706170353163193, 'n': 1}], 'n': 5, 'tx_index': 8547608648050862, 'script': '51207d7ea9b09960a515e9d980be42e04a47a7cf73543ed85df3c30b5978d8131295', 'addr': 'bc1p04l2nvyevzj3t6weszly9cz2g7nu7u658mv9mu7rpdvh3kqnz22s4vawjf'}]",546,7831703479629
477586a8a7f02b54e3562ef42e538e4311228907291860f7484cc05127290b10,1,1,2,223,892,5424,0.0.0.0,0,564483876075529,False,1711656415,836710,836710,"[{'sequence': 4294967295, 'witness': '', 'script': '483045022100b364d475675b68e2610c3c352431b8bdb4448eeb23fe24f796c9ce35faafde86022020bbca1716f765acd6364407e137d6f5f9840965c3e985599ee6b4813c1c0e8d012102663261b731401b9613b0ad99f43ea5b470f7abf5d0a49472ef66e1f62490b68e', 'index': 0, 'prev_out': {'type': 0, 'spent': True, 'value': 10876, 'spending_outpoints': [{'tx_index': 564483876075529, 'n': 0}], 'n': 0, 'tx_index': 7223074447668532, 'script': '76a91446fc7ce09416f5bbe6cf359c132fdeccae44512e88ac', 'addr': '17ULmb7YCVd3auyktKLQNsCuE32FomyZku'}}]","[{'type': 0, 'spent': False, 'value': 1558, 'spending_outpoints': [], 'n': 0, 'tx_index': 564483876075529, 'script': '00143924fbe46da8ea43404e8cec962e91ac62bbd9e9', 'addr': 'bc1q8yj0herd4r4yxszw3nkfvt53433thk0f5qst4g'}, {'type': 0, 'spent': False, 'value': 3894, 'spending_outpoints': [], 'n': 1, 'tx_index': 564483876075529, 'script': '76a9146009d8bfc4effd9dc1563be7fdd3719f42d3fbb288ac', 'addr': '19kofaLYQCtjrnYqHGdLh2Zhc9PSm6Jive'}]",1558,7831703479083
9f7605f2464be482cfc825e0889760d645383d76548dc6e7cde2cf5ebc194958,1,1,32,1190,4433,46288,0.0.0.0,0,3106271604234748,False,1711562709,836536,836536,"[{'sequence': 4294967295, 'witness': '02473044022050327d109c08f77f8ddbe120656058c73340710cef952dde3fb443a358f02dc2022007ee967d4b261be64d9e70fe09e8a729f3000602d739f635238e0a224e609f510121039af70f4f593641a180ef57423ba83ac3832ec6aad14ea4c36883b110624372d3', 'script': '1600146948ad786cfdd82d4150c8a0e696a138916c3e37', 'index': 0, 'prev_out': {'type': 0, 'spent': True, 'value': 48423834, 'spending_outpoints': [{'tx_index': 3106271604234748, 'n': 0}], 'n': 6, 'tx_index': 8814624752877433, 'script': 'a914acdbb69efbedd7cf265bb243947d9b6c6d4c1e1a87', 'addr': '3HT1MVQzBbphZzESS5e36E68XqycDu8xEr'}}]","[{'type': 0, 'spent': True, 'value': 268846, 'spending_outpoints': [{'tx_index': 1532047611919104, 'n': 21}], 'n': 0, 'tx_index': 3106271604234748, 'script': '0014ad1a6cb275b68eebd2ef1f0c7fb30d6192b8708a', 'addr': 'bc1q45dxevn4k68wh5h0rux8lvcdvxftsuy2np4v30'}, {'type': 0, 'spent': True, 'value': 60720, 'spending_outpoints': [{'tx_index': 4654296279837611, 'n': 108}], 'n': 1, 'tx_index': 3106271604234748, 'script': 'a914b8610a0a8664b08d69322d2f3a7b0284afd2826b87', 'addr': '3JVvWF6ywnyV83jzhNw1RHdWjgbDH1LCEw'}, {'type': 0, 'spent': False, 'value': 1453350, 'spending_outpoints': [], 'n': 2, 'tx_index': 3106271604234748, 'script': '0014870fca846372ddad0860c605bf6ab091ec9ba4ac', 'addr': 'bc1qsu8u4prrwtw66zrqcczm764sj8kfhf9vm5d5y2'}, {'type': 0, 'spent': True, 'value': 3672119, 'spending_outpoints': [{'tx_index': 4517290354913207, 'n': 19}], 'n': 3, 'tx_index': 3106271604234748, 'script': '0014a56431fa5adcec279a332d7df9497572ae0c1744', 'addr': 'bc1q54jrr7j6mnkz0x3n947ljjt4w2hqc96ysqnsdj'}, {'type': 0, 'spent': True, 'value': 12175, 'spending_outpoints': [{'tx_index': 2387981723590329, 'n': 0}], 'n': 4, 'tx_index': 3106271604234748, 'script': '0014b4dc0a29acb4bfe0291549ced0f231b4d9240553', 'addr': 'bc1qknwq52dvkjl7q2g4f88dpu33knvjgp2n2tfzwf'}, {'type': 0, 'spent': True, 'value': 138042, 'spending_outpoints': [{'tx_index': 7405086903880763, 'n': 37}], 'n': 5, 'tx_index': 3106271604234748, 'script': '76a91470e025c681102ec988cb8ce1e5cd33a8b9c1d55888ac', 'addr': '1BHqCXmfo1uNzapuSxZY2rE4YzjBXwS9w9'}, {'type': 0, 'spent': True, 'value': 871237, 'spending_outpoints': [{'tx_index': 3753001936818067, 'n': 4}], 'n': 6, 'tx_index': 3106271604234748, 'script': '00146c92dc36b45509f3a8f095598adfa33c4253f41d', 'addr': 'bc1qdjfdcd4525yl828sj4vc4har83p98aqar06ee9'}, {'type': 0, 'spent': True, 'value': 164655, 'spending_outpoints': [{'tx_index': 1913371899114040, 'n': 20}], 'n': 7, 'tx_index': 3106271604234748, 'script': 'a9148f5304af7ab3a57d069cf162fde7fac89d00305687', 'addr': '3Ekr1BsfiQANmnsTYKYFfAP3wze5drKZq3'}, {'type': 0, 'spent': True, 'value': 474462, 'spending_outpoints': [{'tx_index': 7878944026550471, 'n': 63}], 'n': 8, 'tx_index': 3106271604234748, 'script': '76a9149a5487118af6a9c57abebad719d1ea19cffbfd8788ac', 'addr': '1F52Kd9kAAWqYHLmmdNnBMA4mQAWq3m5Ho'}, {'type': 0, 'spent': True, 'value': 72667, 'spending_outpoints': [{'tx_index': 3917078836964028, 'n': 0}], 'n': 9, 'tx_index': 3106271604234748, 'script': '00148dac90f3f1648a5a4b85c5b35f7a24f81f1de7bd', 'addr': 'bc1q3kkfpul3vj995ju9cke4773ylq03meaavh670z'}, {'type': 0, 'spent': False, 'value': 340375, 'spending_outpoints': [], 'n': 10, 'tx_index': 3106271604234748, 'script': '0014e10940dfb74c386378db66d4bd6da9fa72fc3568', 'addr': 'bc1quyy5phahfsuxx7xmvm2t6mdflfe0cdtgvcg0zz'}, {'type': 0, 'spent': False, 'value': 145263, 'spending_outpoints': [], 'n': 11, 'tx_index': 3106271604234748, 'script': '0014dcf2c2ff8502ab04e23318116894560acd3f9d81', 'addr': 'bc1qmnev9lu9q24sfc3nrqgk39zkptxnl8vpneftq9'}, {'type': 0, 'spent': True, 'value': 29338562, 'spending_outpoints': [{'tx_index': 51619891819758, 'n': 0}], 'n': 12, 'tx_index': 3106271604234748, 'script': '00147f1b29d4e8c69d98c45f86f5086d84435b1ec9e5', 'addr': 'bc1q0udjn48gc6we33zlsm6ssmvygdd3aj09plpg8f'}, {'type': 0, 'spent': True, 'value': 59962, 'spending_outpoints': [{'tx_index': 3630996478254746, 'n': 0}], 'n': 13, 'tx_index': 3106271604234748, 'script': '00142b4b298bb2e6b48711930d85d38b6fba648a6693', 'addr': 'bc1q9d9jnzaju66gwyvnpkza8zm0hfjg5e5nfq8qmq'}, {'type': 0, 'spent': True, 'value': 134462, 'spending_outpoints': [{'tx_index': 7307044196322486, 'n': 98}], 'n': 14, 'tx_index': 3106271604234748, 'script': '0014add9ae6d4fdc070a0ad9bcd8fc9d9ace268eeaa8', 'addr': 'bc1q4hv6um20msrs5zkehnv0e8v6ecnga64gdwperk'}, {'type': 0, 'spent': True, 'value': 1161460, 'spending_outpoints': [{'tx_index': 3291182730794174, 'n': 2}], 'n': 15, 'tx_index': 3106271604234748, 'script': '00146ee48dc35ca318cf1ca3d93cb41e1674a15e392f', 'addr': 'bc1qdmjgms6u5vvv789rmy7tg8skwjs4uwf0837yu3'}, {'type': 0, 'spent': True, 'value': 1272894, 'spending_outpoints': [{'tx_index': 169641281587878, 'n': 54}], 'n': 16, 'tx_index': 3106271604234748, 'script': '00147766f270e7ba9c10c22878b3e0321bd30921b311', 'addr': 'bc1qwan0yu88h2wpps3g0ze7qvsm6vyjrvc3eru7kz'}, {'type': 0, 'spent': False, 'value': 15323, 'spending_outpoints': [], 'n': 17, 'tx_index': 3106271604234748, 'script': '76a9142675447b7c0b183637c0e97459bcd56da395e96c88ac', 'addr': '14WMABNx981VdAUVTd4MVWbiFaSRmrM1hA'}, {'type': 0, 'spent': True, 'value': 388783, 'spending_outpoints': [{'tx_index': 5732096817100393, 'n': 3}], 'n': 18, 'tx_index': 3106271604234748, 'script': '00145344083d49b8d86f12f057209389ade80e47abdf', 'addr': 'bc1q2dzqs02fhrvx7yhs2usf8zddaq8y027ldc0ztc'}, {'type': 0, 'spent': False, 'value': 14519, 'spending_outpoints': [], 'n': 19, 'tx_index': 3106271604234748, 'script': '00143924fbe46da8ea43404e8cec962e91ac62bbd9e9', 'addr': 'bc1q8yj0herd4r4yxszw3nkfvt53433thk0f5qst4g'}, {'type': 0, 'spent': True, 'value': 201562, 'spending_outpoints': [{'tx_index': 1348057028937928, 'n': 4}], 'n': 20, 'tx_index': 3106271604234748, 'script': '00146b693d05bbce5f2573eeede05abd45e280cf6d6a', 'addr': 'bc1qdd5n6pdmee0j2ulwahs94029u2qv7mt2kc5s4r'}, {'type': 0, 'spent': True, 'value': 146282, 'spending_outpoints': [{'tx_index': 5233433426122058, 'n': 1}], 'n': 21, 'tx_index': 3106271604234748, 'script': '0014e4e672806f6792f19161af4821e345d1b242e243', 'addr': 'bc1qunn89qr0v7f0rytp4ayzrc696xey9cjrawvke4'}, {'type': 0, 'spent': True, 'value': 25151, 'spending_outpoints': [{'tx_index': 6335260055173852, 'n': 486}], 'n': 22, 'tx_index': 3106271604234748, 'script': '001435cf8f1387e0b9321cda33eb2183bc77d062c8d4', 'addr': 'bc1qxh8c7yu8uzuny8x6x04jrqauwlgx9jx54lhsld'}, {'type': 0, 'spent': True, 'value': 130966, 'spending_outpoints': [{'tx_index': 6577135366836876, 'n': 85}], 'n': 23, 'tx_index': 3106271604234748, 'script': '76a9143d0bb6c894f07febed0caa7762d7837abc76379588ac', 'addr': '16ZnFc4b5LhyQENG9Z9b8zfJFhwuuJNBUT'}, {'type': 0, 'spent': True, 'value': 20000, 'spending_outpoints': [{'tx_index': 725474021241756, 'n': 242}], 'n': 24, 'tx_index': 3106271604234748, 'script': '0014de1e853222ee837ede9fea6148863926901975ec', 'addr': 'bc1qmc0g2v3za6phah5lafs53p3ey6gpja0v9etven'}, {'type': 0, 'spent': True, 'value': 443708, 'spending_outpoints': [{'tx_index': 1747005045446278, 'n': 0}], 'n': 25, 'tx_index': 3106271604234748, 'script': '0014176254a35cfdb7f3fc5397bddab5ed3de6d81a3f', 'addr': 'bc1qza39fg6ulkml8lznj77a4d0d8hndsx3lavng64'}, {'type': 0, 'spent': False, 'value': 575366, 'spending_outpoints': [], 'n': 26, 'tx_index': 3106271604234748, 'script': '00140e2e7aea82b08193025c4c9e54612525d262e4b4', 'addr': 'bc1qpch8465zkzqexqjufj09gcf9yhfx9e95tudpfl'}, {'type': 0, 'spent': True, 'value': 1840708, 'spending_outpoints': [{'tx_index': 2625162735938225, 'n': 0}], 'n': 27, 'tx_index': 3106271604234748, 'script': '001407cbc3b563132224364dee4bbb212926579d8cf7', 'addr': 'bc1qql9u8dtrzv3zgdjdae9mkgffyetemr8hjvdyu0'}, {'type': 0, 'spent': True, 'value': 143831, 'spending_outpoints': [{'tx_index': 5893134418242545, 'n': 37}], 'n': 28, 'tx_index': 3106271604234748, 'script': '00149a0c17e00d7e0d4a77066d2161f8be6d1477f87a', 'addr': 'bc1qngxp0cqd0cx55acxd5skr797d52807r6524phs'}, {'type': 0, 'spent': True, 'value': 4250000, 'spending_outpoints': [{'tx_index': 6812066369222755, 'n': 3}], 'n': 29, 'tx_index': 3106271604234748, 'script': 'a914b8a8ad6e67c7bc008d0c35c06a984e86fab34e7787', 'addr': '3JXQKkpboz5pLo8gfvHjXoBrXuoFgKEiPF'}, {'type': 0, 'spent': True, 'value': 322305, 'spending_outpoints': [{'tx_index': 6034397098275395, 'n': 1}], 'n': 30, 'tx_index': 3106271604234748, 'script': '00144ce91bfa9cbd500b9b4e6e9c528f63598c1b9b47', 'addr': 'bc1qfn53h75uh4gqhx6wd6w99rmrtxxphx68h6ntd7'}, {'type': 0, 'spent': True, 'value': 217791, 'spending_outpoints': [{'tx_index': 3753001936818067, 'n': 5}], 'n': 31, 'tx_index': 3106271604234748, 'script': '00149e4ede0ae919faa02414ba12567cde7e6c34ebe5', 'addr': 'bc1qne8duzhfr8a2qfq5hgf9vlx70ekrf6l9j54cek'}]",14519,7831703477525
49961014df6727d1495b0ba486648566e8da0bc12d92eb412e3c3a6cf8724d5d,2,2,2,300,798,1592,0.0.0.0,0,3282791127942983,False,1711347601,836211,836211,"[{'sequence': 2147483649, 'witness': '01408c301107fd722a4d85e1c511386792c311b1b5fd03cf64a9904eaf859deab8fde18e139e52b0860ce93438a9cedbe8220c7991d0a281c277799093a24dadd08d', 'script': '', 'index': 0, 'prev_out': {'type': 0, 'spent': True, 'value': 546, 'spending_outpoints': [{'tx_index': 3282791127942983, 'n': 0}], 'n': 0, 'tx_index': 7846839356242246, 'script': '5120c9010af76ec23acdc623811d702e572436f62beca0fee35d1d97ed173dc61f83', 'addr': 'bc1peyqs4amwcgavm33rsywhqtjhysm0v2lv5rlwxhgajlk3w0wxr7psx8jggy'}}, {'sequence': 2147483649, 'witness': '01403639c51946ff4e6b63d6dfe3c0b9381417ee20a8fe97c53f46486dec63ea908fdbc4df8109441755d830512cad300036bba79794639c8d71e6d6bd9ac75a60a6', 'script': '', 'index': 1, 'prev_out': {'type': 0, 'spent': True, 'value': 120181, 'spending_outpoints': [{'tx_index': 3282791127942983, 'n': 1}], 'n': 1, 'tx_index': 2656127321477122, 'script': '5120c9010af76ec23acdc623811d702e572436f62beca0fee35d1d97ed173dc61f83', 'addr': 'bc1peyqs4amwcgavm33rsywhqtjhysm0v2lv5rlwxhgajlk3w0wxr7psx8jggy'}}]","[{'type': 0, 'spent': False, 'value': 546, 'spending_outpoints': [], 'n': 0, 'tx_index': 3282791127942983, 'script': '00143924fbe46da8ea43404e8cec962e91ac62bbd9e9', 'addr': 'bc1q8yj0herd4r4yxszw3nkfvt53433thk0f5qst4g'}, {'type': 0, 'spent': True, 'value': 118589, 'spending_outpoints': [{'tx_index': 5603883020910489, 'n': 1}], 'n': 1, 'tx_index': 3282791127942983, 'script': '5120c9010af76ec23acdc623811d702e572436f62beca0fee35d1d97ed173dc61f83', 'addr': 'bc1peyqs4amwcgavm33rsywhqtjhysm0v2lv5rlwxhgajlk3w0wxr7psx8jggy'}]",546,7831703463006
3ca2188e9805310b0cc9d57b2fb800efeb74a6eeb6f616bac864f887fe4e74c1,2,1,2,222,561,2688,0.0.0.0,835837,6806569141468940,False,1711157553,835855,835855,"[{'sequence': 4294967293, 'witness': '02473044022049859c745dc2a041f8b8d3bcaaf29709a5e6bc38a8317b9db38e6305bd7271b702200b5d74bf901558f9d0ca325dbb7bc8cf79e5520b0e8e076a7e1fe30f97e03b58012102f4bec11e10535d68c4cd03020bf3de9455be9f6337f7761b387c42bce3925385', 'script': '', 'index': 0, 'prev_out': {'type': 0, 'spent': True, 'value': 8705103465148, 'spending_outpoints': [{'tx_index': 6806569141468940, 'n': 0}], 'n': 0, 'tx_index': 6655654933414941, 'script': '0014c2e3b242cb2ec636250ef6c0bd778199d477d703', 'addr': 'bc1qct3myskt9mrrvfgw7mqt6aupn82804crg0xxg7'}}]","[{'type': 0, 'spent': False, 'value': 7831703462460, 'spending_outpoints': [], 'n': 0, 'tx_index': 6806569141468940, 'script': '00143924fbe46da8ea43404e8cec962e91ac62bbd9e9', 'addr': 'bc1q8yj0herd4r4yxszw3nkfvt53433thk0f5qst4g'}, {'type': 0, 'spent': True, 'value': 873400000000, 'spending_outpoints': [{'tx_index': 6000261628920891, 'n': 1}], 'n': 1, 'tx_index': 6806569141468940, 'script': '0014d6e9b2ba0a9c2ff5c38f2333f8468b2b4dc18b79', 'addr': 'bc1q6m5m9ws2nshltsu0yvels35t9dxurzmevdl9dq'}]",7831703462460,7831703462460
