wallet_address,rank,first_timestamp,last_timestamp,transactions,amount_btc,balance_btc,total_fee,first_block,last_block,last_updated,price_usd,transaction_value_usd,transaction_type,portfolio_pct,timestamp
bc1qcpflj68s3ahy4xajez4d8v3vk28pvf7qte2jmlftvxzfke2u6mqsge3gvh,18.0,2024-03-01 13:53:26,2024-03-01 17:28:30,"32e61334b8d366ac2cba405ec8b7d4e8286336d04d4b976089db0d68d0c4c75b,0cdd8d9827c1329a2dacdcb4f17faeb682af0731116bb664d7583893f24061b2,f975ea3f237d9e9a95ef615a01017df8734791141cac7b07365145dc995429e0",2650.0,2650.0,0.00584373,832688,832720,2025-06-19 17:08:07.793113,62346.0,165216900.0,buy,100.0,2024-03-01
bc1qcpflj68s3ahy4xajez4d8v3vk28pvf7qte2jmlftvxzfke2u6mqsge3gvh,18.0,2024-03-02 16:02:01,2024-03-02 16:02:01,be80bfede4b85c781f556ce3408f431ab2dcc52f2c4e9e005058e2c8efa2b332,610.0,3260.0,0.00239932,832842,832842,2025-06-19 17:08:07.793113,61962.0,37796820.0,buy,18.711656441717793,2024-03-02
bc1qcpflj68s3ahy4xajez4d8v3vk28pvf7qte2jmlftvxzfke2u6mqsge3gvh,18.0,2024-03-03 00:00:17,2024-03-03 00:00:17,f86c2173dc1977e0c2f8f7291473d8d5b0c54b42023e3f485f044e466daed2ca,400.0,3660.0,0.00048096,832884,832884,2025-06-19 17:08:07.793113,63121.0,25248400.0,buy,10.92896174863388,2024-03-03
bc1qcpflj68s3ahy4xajez4d8v3vk28pvf7qte2jmlftvxzfke2u6mqsge3gvh,18.0,2024-03-04 20:42:16,2024-03-04 20:42:16,d7ee5adb8fc440bc8dbe455450728035720cf2a02179075a821aad22dd94cb67,1599.9998,5259.9998,0.01109592,833149,833149,2025-06-19 17:08:07.793113,68110.0,108975986.378,buy,30.418248304876368,2024-03-04
bc1qcpflj68s3ahy4xajez4d8v3vk28pvf7qte2jmlftvxzfke2u6mqsge3gvh,18.0,2024-03-05 01:16:35,2024-03-05 15:06:21,"72d90603a886c38b41252f0ee54150dd1e618a3ad377a1a21d27bdecb36fc377,47250c44132c22c567dfa22a9952fd879e13b8e2bdc2f8d98809e8ca2dbc4d8d",3030.0,8289.9998,0.0017877700000000002,833178,833275,2025-06-19 17:08:07.793113,63818.0,193368540.0,buy,36.55006119541764,2024-03-05
bc1qcpflj68s3ahy4xajez4d8v3vk28pvf7qte2jmlftvxzfke2u6mqsge3gvh,18.0,2024-03-11 20:53:35,2024-03-11 20:53:35,1918b4c947d6ec1aae564ea85e8adb2f0b58361b515f70c62debe6c4e54fb35e,2050.0,10339.9998,0.00100708,834265,834265,2025-06-19 17:08:07.793113,71937.0,147470850.0,buy,19.82591914556904,2024-03-11
bc1qcpflj68s3ahy4xajez4d8v3vk28pvf7qte2jmlftvxzfke2u6mqsge3gvh,18.0,2024-03-13 21:38:39,2024-03-13 21:38:39,d8ee28955fb61aa8c564dbcfc27afa5b5ce91452965c3c053f27f9e9c0eb9f68,2100.0,12439.9998,0.00289231,834570,834570,2025-06-19 17:08:07.793113,72974.0,153245400.0,buy,16.881029210305936,2024-03-13
bc1qcpflj68s3ahy4xajez4d8v3vk28pvf7qte2jmlftvxzfke2u6mqsge3gvh,18.0,2024-03-14 23:04:04,2024-03-14 23:04:04,523e0e07aaf361480ff6a2f423610549a8c52f0f2138039794626eba41298554,800.0,13239.9998,0.00246277,834721,834721,2025-06-19 17:08:07.793113,71364.0,57091200.0,buy,6.042296163780909,2024-03-14
bc1qcpflj68s3ahy4xajez4d8v3vk28pvf7qte2jmlftvxzfke2u6mqsge3gvh,18.0,2024-03-18 13:46:31,2024-03-18 13:46:31,9251a4a422d97f842a44ad5c7dc4acdd4b0073c1be90982abb96d1e8a2705a96,500.0,13739.9998,0.00072889,835234,835234,2025-06-19 17:08:07.793113,67606.0,33803000.0,buy,3.639010242198111,2024-03-18
bc1qcpflj68s3ahy4xajez4d8v3vk28pvf7qte2jmlftvxzfke2u6mqsge3gvh,18.0,2024-03-19 15:16:33,2024-03-19 15:16:33,bb5c3baac19bdc1c8b742dc6292a3c3137f10675d6c54794d690a0f79d6d9129,299.9998,14039.9996,0.00151201,835380,835380,2025-06-19 17:08:07.793113,62072.0,18621587.5856,buy,2.1367507731268027,2024-03-19
bc1qcpflj68s3ahy4xajez4d8v3vk28pvf7qte2jmlftvxzfke2u6mqsge3gvh,18.0,2024-03-23 04:15:54,2024-03-23 04:15:54,8de994784af43e254c33fcbf93b7101dc2ab37e5d5ad710c9e0d08efcae98fca,5.46e-06,14039.99960546,0.00402981,835872,835872,2025-06-19 17:08:07.793113,64069.0,0.34981674,buy,3.888888998171101e-08,2024-03-23
bc1qcpflj68s3ahy4xajez4d8v3vk28pvf7qte2jmlftvxzfke2u6mqsge3gvh,18.0,2024-03-27 03:56:15,2024-03-27 03:56:15,68c2b80824383b5f361ee49207bc56ff8af78612b6994c09bd0c0737fcd164f4,9.99e-06,14039.99961545,0.01141418,836467,836467,2025-06-19 17:08:07.793113,69467.0,0.6939753299999999,buy,7.115384810272167e-08,2024-03-27
bc1qcpflj68s3ahy4xajez4d8v3vk28pvf7qte2jmlftvxzfke2u6mqsge3gvh,18.0,2024-04-01 09:48:39,2024-04-01 09:48:39,4d8fee70d48221c619b4474ff23b3ddcd2d706c648122bae8712558b7d2912ab,2040.0,16079.99961545,0.00149101,837228,837228,2025-06-19 17:08:07.793113,69691.0,142169640.0,buy,12.686567467575841,2024-04-01
bc1qcpflj68s3ahy4xajez4d8v3vk28pvf7qte2jmlftvxzfke2u6mqsge3gvh,18.0,2024-04-02 07:47:24,2024-04-02 13:13:50,"8f0817f0a7547a9700d57d9683d638501154ae3e698789449ab04d3e1512f830,c3e3ebac473a3d420e7933f7b3f8353e04059e7a7eabecc68e8c24b5186cb897,0ed55838a8b9ebe18ade6f4275ccba647377210035833fd3e97f813df119a13f",2130.00001092,18209.99962637,0.01190058,837365,837403,2025-06-19 17:08:07.793113,65495.0,139504350.71520537,buy,11.696870151691465,2024-04-02
bc1qcpflj68s3ahy4xajez4d8v3vk28pvf7qte2jmlftvxzfke2u6mqsge3gvh,18.0,2024-04-03 10:59:01,2024-04-03 10:59:01,be15cacd74d752d473fb9a0351ae48daa64c901aa1177240dbba8a8ac0e76ca3,2100.0,20309.99962637,0.00033675,837533,837533,2025-06-19 17:08:07.793113,65967.0,138530700.0,buy,10.339734311336038,2024-04-03
bc1qcpflj68s3ahy4xajez4d8v3vk28pvf7qte2jmlftvxzfke2u6mqsge3gvh,18.0,2024-04-04 16:51:53,2024-04-04 16:51:53,f906d8f51bab916424437561a7c1bab9413ea47eb028a23810ec63487fcaad4c,2100.0,22409.99962637,0.00104272,837696,837696,2025-06-19 17:08:07.793113,68518.0,143887800.0,buy,9.370816755966901,2024-04-04
bc1qcpflj68s3ahy4xajez4d8v3vk28pvf7qte2jmlftvxzfke2u6mqsge3gvh,18.0,2024-04-07 08:48:07,2024-04-07 08:48:07,b10b6d7b50884a407f5071db984af6887d0c1881cc06d879c38cbddaa653b8d0,5.46e-06,22409.99963183,0.00501849,838105,838105,2025-06-19 17:08:07.793113,69343.0,0.37861278000000004,buy,2.436412355957784e-08,2024-04-07
bc1qcpflj68s3ahy4xajez4d8v3vk28pvf7qte2jmlftvxzfke2u6mqsge3gvh,18.0,2024-04-08 13:46:57,2024-04-08 13:46:57,71553d482aad4593416148a768a18ed0075e48890bab4c75d141ec4c1adbfc76,555.0,22964.99963183,0.00091251,838309,838309,2025-06-19 17:08:07.793113,71675.0,39779625.0,buy,2.4167211360663714,2024-04-08
bc1qcpflj68s3ahy4xajez4d8v3vk28pvf7qte2jmlftvxzfke2u6mqsge3gvh,18.0,2024-04-09 20:09:40,2024-04-09 20:09:40,2572be718736604d0aeb0edcb28c55372f571f1e9f03acf9333cd3e92d23f31d,680.0,23644.99963183,0.0004904,838501,838501,2025-06-19 17:08:07.793113,69164.0,47031520.0,buy,2.8758723222165323,2024-04-09
bc1qcpflj68s3ahy4xajez4d8v3vk28pvf7qte2jmlftvxzfke2u6mqsge3gvh,18.0,2024-04-12 06:53:03,2024-04-12 06:53:03,4478334111394fdd492c2838e44f339d95e265731af30ccf21564dbb7fe2bf92,1010.0,24654.99963183,0.01003989,838836,838836,2025-06-19 17:08:07.793113,67061.0,67731610.0,buy,4.096532204754421,2024-04-12
bc1qcpflj68s3ahy4xajez4d8v3vk28pvf7qte2jmlftvxzfke2u6mqsge3gvh,18.0,2024-04-15 19:20:50,2024-04-15 19:20:50,c9e809cda583db54d4748a7e1df68bc57d111b3966972e76301b41f275ace2a5,100.0,24754.99963183,0.00177673,839379,839379,2025-06-19 17:08:07.793113,63488.0,6348800.0,buy,0.4039588022106852,2024-04-15
bc1qcpflj68s3ahy4xajez4d8v3vk28pvf7qte2jmlftvxzfke2u6mqsge3gvh,18.0,2024-04-24 09:24:59,2024-04-24 12:18:16,"14f46571a975bde3bffdd4d7d70a29f0e1ccca543887e05788695114bf71501d,f4f616fd14cb37d85b217a165d69d36ae0acc1eb5d0ed36584fc99c33aaad3dd",-0.0036164599999999997,24754.99601537,0.04139743,840640,840657,2025-06-19 17:08:07.793113,64345.0,-232.7011187,sell,1.460901063266015e-05,2024-04-24
bc1qcpflj68s3ahy4xajez4d8v3vk28pvf7qte2jmlftvxzfke2u6mqsge3gvh,18.0,2024-04-25 14:40:39,2024-04-25 22:52:41,"ebc7ee776a02566f820507cdb14484bb3a6ac3ec6061c6f61de5ac38c38743f1,f74eed7bdad5b9485c970f4dd2bbb5e564d5d8d70266d4a5a4cbaa74f2764e0a",1.092e-05,24754.99602629,0.03742341,840829,840886,2025-06-19 17:08:07.793113,64555.0,0.7049406,buy,4.411230762631865e-08,2024-04-25
bc1qcpflj68s3ahy4xajez4d8v3vk28pvf7qte2jmlftvxzfke2u6mqsge3gvh,18.0,2024-04-26 10:22:41,2024-04-26 14:07:21,"9c413d28759d69efaf4e84276cca768f370822a3f1f4af559fb512114216ac46,58e10baa5ad996f55fd9ed66e2930bafc590adc052b104021344f0e27b267292,ca1757fe3d7d661354d03a6300feb2efba36351a157f6c807fafce871a06347a",-1200.01449937,23554.98152692,0.07320971,840939,840960,2025-06-19 17:08:07.793113,63874.0,-76649726.13275939,sell,5.094525325772613,2024-04-26
bc1qcpflj68s3ahy4xajez4d8v3vk28pvf7qte2jmlftvxzfke2u6mqsge3gvh,18.0,2024-04-27 12:23:06,2024-04-27 12:23:06,625689ca44c14ebefa97777edf82ef73fc5a5f300414327b140f7786f0a8bb48,5.46e-06,23554.98153238,0.0227169,841096,841096,2025-06-19 17:08:07.793113,63574.0,0.34711404,buy,2.317981014968905e-08,2024-04-27
bc1qcpflj68s3ahy4xajez4d8v3vk28pvf7qte2jmlftvxzfke2u6mqsge3gvh,18.0,2024-04-30 00:35:06,2024-04-30 00:35:06,83c2e26a51bd7d0bcf8c0e0203992e23f69872e7fbdf580c423e16c2a69e677f,3.3e-06,23554.98153568,0.02254884,841433,841433,2025-06-19 17:08:07.793113,60836.0,0.20075880000000002,buy,1.4009775363233942e-08,2024-04-30
bc1qcpflj68s3ahy4xajez4d8v3vk28pvf7qte2jmlftvxzfke2u6mqsge3gvh,18.0,2024-05-01 14:05:05,2024-05-01 20:40:29,"71a8735ea739b87da14f679d7d19081b318b023f30b8843b235177dffa382cab,4422cecd93afdf692b0247dcc736a2d3f1826028204d59648ebe48df36007260",-1225.00004054,22329.98149514,0.012553839999999998,841654,841739,2025-06-19 17:08:07.793113,58457.0,-71609827.36984679,sell,5.485898144638475,2024-05-01
bc1qcpflj68s3ahy4xajez4d8v3vk28pvf7qte2jmlftvxzfke2u6mqsge3gvh,18.0,2024-05-09 19:32:45,2024-05-09 19:32:45,230e86ecfe98d0f318c15fa7f7bfb76e753f6b8fc0de7e4ee7bfa10969bfb525,-348.000097,21981.98139814,9.7e-05,842742,842742,2025-06-19 17:08:07.793113,63209.0,-21996738.131272998,sell,1.583115237416432,2024-05-09
bc1qcpflj68s3ahy4xajez4d8v3vk28pvf7qte2jmlftvxzfke2u6mqsge3gvh,18.0,2024-05-13 12:35:11,2024-05-13 12:35:11,05aff8ba52f1a48ad9a195faf8127de0c0273243a7b8e7097bd03951a459df55,5.46e-06,21981.9814036,0.00823454,843282,843282,2025-06-19 17:08:07.793113,62986.0,0.34390356,buy,2.4838525243706257e-08,2024-05-13
bc1qcpflj68s3ahy4xajez4d8v3vk28pvf7qte2jmlftvxzfke2u6mqsge3gvh,18.0,2024-05-16 01:33:49,2024-05-16 01:33:49,5d4155909115e03a6d007e6681a51bf937ff2e33c1fa511db730946da03d3a51,5.46e-06,21981.98140906,3.204e-05,843653,843653,2025-06-19 17:08:07.793113,65314.0,0.35661444000000003,buy,2.483852523753673e-08,2024-05-16
bc1qcpflj68s3ahy4xajez4d8v3vk28pvf7qte2jmlftvxzfke2u6mqsge3gvh,18.0,2024-05-17 16:39:54,2024-05-17 16:39:54,1f15d017c9516fee44ab79961fae94c371295d2094d33385924d487e93c273d9,500.0,22481.98140906,0.00033133,843888,843888,2025-06-19 17:08:07.793113,67182.0,33591000.0,buy,2.2240032624460104,2024-05-17
bc1qcpflj68s3ahy4xajez4d8v3vk28pvf7qte2jmlftvxzfke2u6mqsge3gvh,18.0,2024-05-20 20:44:53,2024-05-20 20:44:53,d8d2ac7e41838845851a4521819c6ec08bd931d9a74d9d457c44edcc56d896ee,650.0,23131.98140906,0.00056109,844350,844350,2025-06-19 17:08:07.793113,71428.0,46428200.0,buy,2.809962486591907,2024-05-20
bc1qcpflj68s3ahy4xajez4d8v3vk28pvf7qte2jmlftvxzfke2u6mqsge3gvh,18.0,2024-05-21 05:51:53,2024-05-21 09:04:07,"6f151272c92dae4ddccd77306de6d3989a404c1f385d1338b884f260151161ef,a1a6e21c50acac2fc6fe31cb82abf9da2f946f109f9e502f7ee97133d1f9d98f",-2850.00024606,20281.981163,0.00037632,844402,844419,2025-06-19 17:08:07.793113,70148.0,-199921817.26061687,sell,14.051882915951014,2024-05-21
bc1qcpflj68s3ahy4xajez4d8v3vk28pvf7qte2jmlftvxzfke2u6mqsge3gvh,18.0,2024-05-22 08:52:01,2024-05-22 09:53:05,"1450a294c396b6f52472e11712aa533036eb51c24c2a5eb8ce25be3f8b57c789,a7e8f46295047ba404f414c3a8a03a881372be6c87997512d47d6013f00e53fc",510.00000546,20791.98116846,9.061e-05,844564,844568,2025-06-19 17:08:07.793113,69225.0,35304750.3779685,buy,2.4528687349603553,2024-05-22
bc1qcpflj68s3ahy4xajez4d8v3vk28pvf7qte2jmlftvxzfke2u6mqsge3gvh,18.0,2024-05-23 03:35:54,2024-05-23 13:20:30,"27868c1ea4ce4a2653dab068778170a4d7d750b4af1ce48ef8c23d2357a69574,afd12a5ea548034e3f8a59548192ddef1701ca4d92ab3fcb980d75f239bbb635,32243b4353b0702b5dbd12867ab979a65e4c500011bc4575c01dc2911edfaae7,38184438dbffe2a4e3eb6c51b08058825ce9cda1791b01c8f220ba79b5284ed6",2080.00000546,22871.98117392,0.00300785,844684,844750,2025-06-19 17:08:07.793113,68058.0,141560640.3715967,buy,9.094096351529618,2024-05-23
bc1qcpflj68s3ahy4xajez4d8v3vk28pvf7qte2jmlftvxzfke2u6mqsge3gvh,18.0,2024-05-24 13:29:20,2024-05-24 13:29:20,df35836520539dbd021ebfadf125e6a3d559bf38b0371f85857cbf904c990864,635.0,23506.98117392,0.00038247,844925,844925,2025-06-19 17:08:07.793113,68604.0,43563540.0,buy,2.701325173580798,2024-05-24
bc1qcpflj68s3ahy4xajez4d8v3vk28pvf7qte2jmlftvxzfke2u6mqsge3gvh,18.0,2024-05-27 14:13:10,2024-05-27 14:13:10,51ddcfa49a102741b57554919ffce1815d9d5c5a99dac23098e44bd23e7d715f,520.0,24026.98117392,0.0011466,845384,845384,2025-06-19 17:08:07.793113,69492.0,36135840.0,buy,2.164233601533063,2024-05-27
bc1qcpflj68s3ahy4xajez4d8v3vk28pvf7qte2jmlftvxzfke2u6mqsge3gvh,18.0,2024-05-28 19:21:33,2024-05-28 19:21:33,5109b133d2585b6571c3c9608e1d2a16d66c7c8b61a723848cbaa40f48de77f2,-340.000061,23686.98111292,6.1e-05,845553,845553,2025-06-19 17:08:07.793113,68434.0,-23267564.174474,sell,1.4353879009704107,2024-05-28
bc1qcpflj68s3ahy4xajez4d8v3vk28pvf7qte2jmlftvxzfke2u6mqsge3gvh,18.0,2024-05-30 17:16:11,2024-05-30 17:16:11,384f033859158316ead43b034b30443fa3b3d30dd1815a7c375f53166e4592f4,-1519.00023,22167.98088292,0.00023,845805,845805,2025-06-19 17:08:07.793113,68413.0,-103919362.73499,sell,6.852226362078652,2024-05-30
bc1qcpflj68s3ahy4xajez4d8v3vk28pvf7qte2jmlftvxzfke2u6mqsge3gvh,18.0,2024-06-03 07:22:28,2024-06-03 12:48:24,"bd1122496e178e624395ffb82ecae220a5cd91138638c703b86904064d7a79b4,f95fef1bebe633c03f25dff5cb85e74ced4e6fe475d0c6d2bd7f3f853ccfb0c1",1030.0,23197.98088292,0.00114748,846314,846352,2025-06-19 17:08:07.793113,68859.0,70924770.0,buy,4.440041593267969,2024-06-03
bc1qcpflj68s3ahy4xajez4d8v3vk28pvf7qte2jmlftvxzfke2u6mqsge3gvh,18.0,2024-06-05 08:08:14,2024-06-05 08:08:14,d00689bb947812ce23ecd8d22c99b0a1359dc059d5f2903d4bb3b85b2cf00232,400.0,23597.98088292,0.00156099,846599,846599,2025-06-19 17:08:07.793113,71101.0,28440400.0,buy,1.695060276489656,2024-06-05
bc1qcpflj68s3ahy4xajez4d8v3vk28pvf7qte2jmlftvxzfke2u6mqsge3gvh,18.0,2024-06-06 12:40:29,2024-06-06 12:40:29,ac81c36d5e6b2eef5b1187acb20891a0335b3a5bfba72f0580629409bea2887c,400.0,23997.98088292,0.00081884,846736,846736,2025-06-19 17:08:07.793113,70836.0,28334400.0,buy,1.666806894927942,2024-06-06
bc1qcpflj68s3ahy4xajez4d8v3vk28pvf7qte2jmlftvxzfke2u6mqsge3gvh,18.0,2024-06-07 12:18:16,2024-06-07 12:18:16,c534b53655374767e6616c10c02fd46c1e33ef4711634b508cc7b8e1e5306804,397.0,24394.98088292,0.00162091,846887,846887,2025-06-19 17:08:07.793113,69403.0,27552991.0,buy,1.6273839356765276,2024-06-07
bc1qcpflj68s3ahy4xajez4d8v3vk28pvf7qte2jmlftvxzfke2u6mqsge3gvh,18.0,2024-06-12 13:50:57,2024-06-12 15:53:11,"eb824f86356fdb4c834ece5fcfe2a6330fc6ed3189b31949b82df8c3780fa8df,f4183c94e674812522aef449b4dab2adf534ed737ff927d0f348aef722cdf60d",820.0,25214.98088292,0.0015619000000000002,847627,847640,2025-06-19 17:08:07.793113,68266.0,55978120.0,buy,3.252034985897798,2024-06-12
bc1qcpflj68s3ahy4xajez4d8v3vk28pvf7qte2jmlftvxzfke2u6mqsge3gvh,18.0,2024-06-20 08:22:48,2024-06-20 08:22:48,2d69dfd17a4c5b466765c786d91bf0e6c5a1129c7855db031f3ae2eecd139de0,-220.000107,24994.98077592,0.000107,848729,848729,2025-06-19 17:08:07.793113,65000.0,-14300006.955,sell,0.8801771402518808,2024-06-20
bc1qcpflj68s3ahy4xajez4d8v3vk28pvf7qte2jmlftvxzfke2u6mqsge3gvh,18.0,2024-06-21 23:26:33,2024-06-21 23:26:33,8615fe4fec92da3158cd8867c2971be9e91e5985395b8d896d9f79ee3985b3e5,-800.00016,24194.98061592,0.00016,848950,848950,2025-06-19 17:08:07.793113,64234.0,-51387210.277440004,sell,3.306471588878272,2024-06-21
bc1qcpflj68s3ahy4xajez4d8v3vk28pvf7qte2jmlftvxzfke2u6mqsge3gvh,18.0,2024-06-24 20:50:32,2024-06-24 20:50:32,6c10f94f580e575722609b43fd36e60e67bb9db6bf76da8ab0b6ac99d637e9a9,599.9998,24794.98041592,0.00053968,849355,849355,2025-06-19 17:08:07.793113,60372.0,36223187.9256,buy,2.4198438148987647,2024-06-24
bc1qcpflj68s3ahy4xajez4d8v3vk28pvf7qte2jmlftvxzfke2u6mqsge3gvh,18.0,2024-06-26 06:15:19,2024-06-26 10:59:00,"cf9e363f8593c9211c9199a648f9e516f2f659adfe9d9173964c5c8bac0a941d,d738dabb25db115c3e113ed2fba19e893f2aebd1688f5f8a79de0e1a59981f97,9df1014c556e2700d702fd04537942953adc3721f07b18b52366f46057306cb5",-1970.0000562,22824.98035972,0.00024105,849522,849555,2025-06-19 17:08:07.793113,60923.0,-120018313.4238726,sell,8.630894857971157,2024-06-26
bc1qcpflj68s3ahy4xajez4d8v3vk28pvf7qte2jmlftvxzfke2u6mqsge3gvh,18.0,2024-06-27 07:22:09,2024-06-27 07:22:09,9aeef13fda8195313a8ceeba4dc096e4966afe0203b1a3f869fb607aa981601a,-700.000057,22124.98030272,5.7e-05,849660,849660,2025-06-19 17:08:07.793113,61803.0,-43262103.522771,sell,3.16384488222095,2024-06-27
bc1qcpflj68s3ahy4xajez4d8v3vk28pvf7qte2jmlftvxzfke2u6mqsge3gvh,18.0,2024-06-28 08:02:57,2024-06-28 08:02:57,984fa07fb6189e7c9a4ff2c81480e3e5ffbfb2daee6d318c165c5e61970a704d,582.0,22706.98030272,0.00029421,849790,849790,2025-06-19 17:08:07.793113,60546.0,35237772.0,buy,2.5630884963170733,2024-06-28
bc1qcpflj68s3ahy4xajez4d8v3vk28pvf7qte2jmlftvxzfke2u6mqsge3gvh,18.0,2024-07-01 07:32:31,2024-07-01 12:57:58,"2ccc851f931cf9e39de2c2d5c4297cb37b85b790a5675e331a24feec12374b0d,32686705c0b472db0fa156eb1adfc7a744649af33760c705ee3b2016a50270ad",2145.0,24851.98030272,0.00158728,850209,850236,2025-06-19 17:08:07.793113,62965.0,135059925.0,buy,8.631102929713952,2024-07-01
bc1qcpflj68s3ahy4xajez4d8v3vk28pvf7qte2jmlftvxzfke2u6mqsge3gvh,18.0,2024-07-04 06:12:01,2024-07-04 21:50:10,"24f44ca05ec993507e3e29c2fa2c44f9123f5d20230427255830e23d0e245704,29c6611c0def65c6dac2e63b0b3f47a2abe8a2504382bc3187ae9e57af702dc2",-2680.00044072,22171.979862,0.00044072,850639,850724,2025-06-19 17:08:07.793113,57118.0,-153076265.17304495,sell,12.087330303385246,2024-07-04
bc1qcpflj68s3ahy4xajez4d8v3vk28pvf7qte2jmlftvxzfke2u6mqsge3gvh,18.0,2024-07-05 03:22:48,2024-07-05 21:04:25,"ffc8cf71950a61f415010ada4e3790c18368f2aaa0e6bb92426995a7eb98eb04,c18ae5f327c7a3c0b0fca3513dd2109ad2920f04d72ccc6fcefa33654e876945,59fa6ea22a2921a73e8ea9cafda49acf52c3df3143581003dd67e4cd81f02e70",1199.999907,23371.979769,0.00089996,850754,850842,2025-06-19 17:08:07.793113,56759.0,68110794.721413,buy,5.134352839855053,2024-07-05
bc1qcpflj68s3ahy4xajez4d8v3vk28pvf7qte2jmlftvxzfke2u6mqsge3gvh,18.0,2024-07-07 13:09:55,2024-07-07 13:09:55,a6d14ae89d33b7d57c2c0ef8db2b026d5faa6ff8787c4b7a39b7c873a342150e,-240.000042,23131.979727,4.2e-05,851101,851101,2025-06-19 17:08:07.793113,56050.0,-13452002.3541,sell,1.0375248674451685,2024-07-07
bc1qcpflj68s3ahy4xajez4d8v3vk28pvf7qte2jmlftvxzfke2u6mqsge3gvh,18.0,2024-07-08 10:36:05,2024-07-08 10:36:05,a26ddc47db8c554c3a52f6e87fd93791b1dd579e27f7ce2b894312059431fdfd,5.46e-06,23131.97973246,0.00499627,851246,851246,2025-06-19 17:08:07.793113,56873.0,0.31052658,buy,2.3603686598161088e-08,2024-07-08
bc1qcpflj68s3ahy4xajez4d8v3vk28pvf7qte2jmlftvxzfke2u6mqsge3gvh,18.0,2024-07-11 20:31:16,2024-07-11 20:31:16,d3be3573ff6156d496aa1602caa2e5ca87283a11df7f65741c8dce1c08ed920c,-740.00005246,22391.97968,5.246e-05,851731,851731,2025-06-19 17:08:07.793113,57458.0,-42518923.01424668,sell,3.3047549302706405,2024-07-11
bc1qcpflj68s3ahy4xajez4d8v3vk28pvf7qte2jmlftvxzfke2u6mqsge3gvh,18.0,2024-07-13 03:20:45,2024-07-13 09:11:21,"99e06ab23c33532c6e6274e44d972cd7bd1e0ca8ca349d1f3f42d378f621be97,8dfe4d00eeddf78779835c73b709c09eeb1db092057f00c975264c4079d2b4eb",-145.000048,22246.979632,0.0001525,851917,851948,2025-06-19 17:08:07.793113,59382.0,-8610392.850336,sell,0.6517740852849628,2024-07-13
bc1qcpflj68s3ahy4xajez4d8v3vk28pvf7qte2jmlftvxzfke2u6mqsge3gvh,18.0,2024-07-15 09:11:41,2024-07-15 21:08:29,"f4639e3bd7129323b517d6e296be866d3f293dd31d7f71da3e35b8eac1138ee8,9d09510c60b789577b31e0f15844fb5d2c58c05a2c182e28ae49f200b129bbe1,dc39c562088285aa81ab17016b9ae9f67f943e8ef3d5118f389a96076bd34262,4c5d316a193b8df832e092fb89903210d0fa96ef0d1bc17e1cbe7ff26c84b876,b1455a8b729dc7487a267796d2d69a20078340d1af1e19ecb0c9fde7b62ba3e6",-1235.00007,21011.979562,0.00161383,852282,852363,2025-06-19 17:08:07.793113,64882.0,-80129274.54174,sell,5.877599806129109,2024-07-15
bc1qcpflj68s3ahy4xajez4d8v3vk28pvf7qte2jmlftvxzfke2u6mqsge3gvh,18.0,2024-07-16 07:22:18,2024-07-16 18:58:28,"a938018756b300868f60cd6166aab6b709bf31dba33457516611b5f5e8f03e69,2752f2dac555e11c86f218446b7291edcf9e0c137477e6ce0930c4629bb9848d,a8ec8779e724fc60b709e36fd123a2a744e45eba3dda6cbd6cd135cbba71d0d9,97d01aa7adad5b84420581f790806906643ff05f62b63342ca792441658f31b7,7a7467a8b0108f2968afee7d73535d614794801d47ec5045173cd8f61b4515c1,70cc3473a78d03f247f28a1411258fa09d933718710d158202b0416c6873cbae,abe4e608eddd1d502ab5b2f525c2a595de28033777b7d3721441b617167b320f,b7eb4ee51bc3fb59cbbc237d770a1c08fe8200d5e055979136498b6ffd9feb19",1655.019919,22666.999481,0.00232316,852419,852490,2025-06-19 17:08:07.793113,65188.0,107887438.479772,buy,7.301451259075009,2024-07-16
bc1qcpflj68s3ahy4xajez4d8v3vk28pvf7qte2jmlftvxzfke2u6mqsge3gvh,18.0,2024-07-17 05:54:51,2024-07-17 05:54:51,428261b7cc96e201884715d47e8654e682c8177a0f2c1a91606572ac000433ca,400.0,23066.999481,2.322e-05,852569,852569,2025-06-19 17:08:07.793113,64204.0,25681600.0,buy,1.7340790263140857,2024-07-17
bc1qcpflj68s3ahy4xajez4d8v3vk28pvf7qte2jmlftvxzfke2u6mqsge3gvh,18.0,2024-07-18 10:24:03,2024-07-18 10:24:03,3b8fe2182cc9ed2324293a60512c216f1b35db4bdb98a15768f7dff5604890ad,-340.000121,22726.99936,0.000121,852728,852728,2025-06-19 17:08:07.793113,64048.0,-21776327.749808,sell,1.4960185267502024,2024-07-18
bc1qcpflj68s3ahy4xajez4d8v3vk28pvf7qte2jmlftvxzfke2u6mqsge3gvh,18.0,2024-07-19 20:01:52,2024-07-19 20:01:52,640f2f09a2ecef73de8aadbfdf089ed3d4b76b81011fee2400b4e351d89ac410,500.0,23226.99936,0.00037975,852927,852927,2025-06-19 17:08:07.793113,66789.0,33394500.0,buy,2.152667213919448,2024-07-19
bc1qcpflj68s3ahy4xajez4d8v3vk28pvf7qte2jmlftvxzfke2u6mqsge3gvh,18.0,2024-07-22 12:44:17,2024-07-22 12:44:17,bca0b9b2b6d5d25f0b89fa152015d69a101132cddb26a8cfc19b93d4ec0c9e24,300.0,23526.99936,4.473e-05,853371,853371,2025-06-19 17:08:07.793113,67714.0,20314200.0,buy,1.2751307355839534,2024-07-22
bc1qcpflj68s3ahy4xajez4d8v3vk28pvf7qte2jmlftvxzfke2u6mqsge3gvh,18.0,2024-07-24 14:15:39,2024-07-24 14:20:20,"5a80c45113f943872da49c73bc05365bdbcc3b9509c4f3cf1edd11f0d84c7d3d,727312bacbdbb84174be93186097c008be72e8b9ceffb4899dab97342b5b05bb",-400.00004404,23126.99931596,4.404e-05,853723,853724,2025-06-19 17:08:07.793113,65482.0,-26192802.88382728,sell,1.729580386003466,2024-07-24
bc1qcpflj68s3ahy4xajez4d8v3vk28pvf7qte2jmlftvxzfke2u6mqsge3gvh,18.0,2024-07-25 06:20:03,2024-07-25 23:59:56,"060c3c90273cad7795547a29959b662207d68571bbae349259db39d83e3d0155,b99e0b7777c2d0f0b6482b355af1cec77e216803681977d115296cd44e62b51e,4ee463e3e9d0f8bd75ac31d6f3f179be34e3271d3a11efe7a93ff94fe8b088d2",-1850.00013404,21276.99918192,0.00016156,853819,853942,2025-06-19 17:08:07.793113,65849.0,-121820658.82639995,sell,8.694835762422862,2024-07-25
bc1qcpflj68s3ahy4xajez4d8v3vk28pvf7qte2jmlftvxzfke2u6mqsge3gvh,18.0,2024-07-26 07:02:37,2024-07-26 20:02:58,"b767ceac954c318b124577cf330c407fb3b6ba4b0579aea9673c96c6176118d3,003e144c2eacd371614f11c9738ac7f44a2cb66acba88d7f446790c4eb4f5a90,66f4c125628fd11653f1bbe8da0bd17ea1b9535467d1002d61b2a294af009be8,93f6cd5e5bd20d5d755ef40138e5df24bc7a1e0aa84957444aaaed97b2aa4239,9a35fd851d181b34c269ffdea0d8cd1bb9a530cb58fb4d0b7449cab704af6643",631.99991108,21908.999093,0.00076685,853993,854083,2025-06-19 17:08:07.793113,68061.0,43014545.94801588,buy,2.8846589860050984,2024-07-26
bc1qcpflj68s3ahy4xajez4d8v3vk28pvf7qte2jmlftvxzfke2u6mqsge3gvh,18.0,2024-07-29 05:54:34,2024-07-29 06:51:39,"5528dbec522d538653d116fff79f447231b67d24e587e9a12fcb5d0bf05ab85b,b12e42a2009197bcebcfe041541ecb5de9e72abed0bee66ecda0800b14505a6e",700.0,22608.999093,0.00074096,854448,854452,2025-06-19 17:08:07.793113,66933.0,46853100.0,buy,3.0961122919268367,2024-07-29
bc1qcpflj68s3ahy4xajez4d8v3vk28pvf7qte2jmlftvxzfke2u6mqsge3gvh,18.0,2024-08-02 06:12:54,2024-08-02 06:12:54,4a4901c1e765d8862cc040471580535f7cae1dd285a36a0bf878bdb302e77945,680.0,23288.999093,0.00018732,855052,855052,2025-06-19 17:08:07.793113,61529.0,41839720.0,buy,2.91983351145558,2024-08-02
bc1qcpflj68s3ahy4xajez4d8v3vk28pvf7qte2jmlftvxzfke2u6mqsge3gvh,18.0,2024-08-04 16:10:35,2024-08-04 16:10:35,015ae2b05702779497339080409d9c042a0f761a81069588ab1ffd2146657396,250.0,23538.999093,1.955e-05,855370,855370,2025-06-19 17:08:07.793113,58203.0,14550750.0,buy,1.0620672485362588,2024-08-04
bc1qcpflj68s3ahy4xajez4d8v3vk28pvf7qte2jmlftvxzfke2u6mqsge3gvh,18.0,2024-08-05 01:11:38,2024-08-05 01:11:38,900346a0ee1343d1aedf2798895f00543db91192f1ba7021eff244550c10ccf4,400.0,23938.999093,2.42e-05,855423,855423,2025-06-19 17:08:07.793113,54169.0,21667600.0,buy,1.6709136353030063,2024-08-05
bc1qcpflj68s3ahy4xajez4d8v3vk28pvf7qte2jmlftvxzfke2u6mqsge3gvh,18.0,2024-08-06 08:08:07,2024-08-06 08:08:07,88cf3fdf74f65598e6f322343c524a3e11d884c92183a3894ebc50421d8a4ea3,-960.000053,22978.99904,5.3e-05,855623,855623,2025-06-19 17:08:07.793113,56187.0,-53939522.977910995,sell,4.177727895496705,2024-08-06
bc1qcpflj68s3ahy4xajez4d8v3vk28pvf7qte2jmlftvxzfke2u6mqsge3gvh,18.0,2024-08-07 20:36:50,2024-08-07 20:36:50,10371e0633cd35a62459f00cdb00f5dcddc038969bdf8e1e00333e169eeec822,-812.000018,22166.999022,1.8e-05,855821,855821,2025-06-19 17:08:07.793113,55179.0,-44805348.993222,sell,3.663103053300617,2024-08-07
bc1qcpflj68s3ahy4xajez4d8v3vk28pvf7qte2jmlftvxzfke2u6mqsge3gvh,18.0,2024-08-09 20:22:44,2024-08-09 20:22:44,5377a7c8eeb23c7ce57e65e589a0c8fc6243120d88492402945bbfd77b3ac495,-2325.000039,19841.998983,3.9e-05,856079,856079,2025-06-19 17:08:07.793113,60970.0,-141755252.37783,sell,11.717569590604187,2024-08-09
bc1qcpflj68s3ahy4xajez4d8v3vk28pvf7qte2jmlftvxzfke2u6mqsge3gvh,18.0,2024-08-10 16:36:47,2024-08-10 16:36:47,1db0ae657dbb161ba00c2412e539b973585cb148007c3554f2c96a5147748264,-490.000022,19351.998961,2.2e-05,856180,856180,2025-06-19 17:08:07.793113,61018.0,-29898821.342396,sell,2.5320382818720426,2024-08-10
bc1qcpflj68s3ahy4xajez4d8v3vk28pvf7qte2jmlftvxzfke2u6mqsge3gvh,18.0,2024-08-12 01:12:32,2024-08-12 01:12:32,d17e6320bdffde17ebd3498d3e8a2196b7c4f178ffff0c55b2684cb3100d88f2,200.0,19551.998961,1.06e-05,856391,856391,2025-06-19 17:08:07.793113,59440.0,11888000.0,buy,1.0229133113137752,2024-08-12
bc1qcpflj68s3ahy4xajez4d8v3vk28pvf7qte2jmlftvxzfke2u6mqsge3gvh,18.0,2024-08-13 14:05:33,2024-08-13 14:05:33,1f5a7e90cab8878d8dffbb44cacf8f1c113b76c8e7c418f83b6e5a8b51366d26,-457.000028,19094.998933,2.8e-05,856605,856605,2025-06-19 17:08:07.793113,60666.0,-27724363.698648,sell,2.39329695489122,2024-08-13
bc1qcpflj68s3ahy4xajez4d8v3vk28pvf7qte2jmlftvxzfke2u6mqsge3gvh,18.0,2024-08-16 16:50:49,2024-08-16 16:50:49,cc76a997028a974b175845bb0bba4399f8739c58b6a2f1cbcb42910a5415300c,-635.000017,18459.998916,1.7e-05,857056,857056,2025-06-19 17:08:07.793113,58996.0,-37462461.002932,sell,3.4398702832513206,2024-08-16
bc1qcpflj68s3ahy4xajez4d8v3vk28pvf7qte2jmlftvxzfke2u6mqsge3gvh,18.0,2024-08-20 07:35:38,2024-08-20 07:35:38,cc2aa8125508f394f1298b687514e4fa69180a5815802a7afbbfdd8443f84ba2,704.0,19163.998916,6.848e-05,857586,857586,2025-06-19 17:08:07.793113,59172.0,41657088.0,buy,3.673554789299384,2024-08-20
bc1qcpflj68s3ahy4xajez4d8v3vk28pvf7qte2jmlftvxzfke2u6mqsge3gvh,18.0,2024-08-23 11:46:50,2024-08-23 14:43:40,"9f3f7e4a541158eadaa77364de84392c0026534f7d13b4393abf8e2a9cdbe391,20ba91aff978fde39ec21078f26650ded0052d432b403e874d857c9a34fa4013",1277.0,20440.998916,0.00026462999999999997,858077,858101,2025-06-19 17:08:07.793113,64151.0,81920827.0,buy,6.247248508977906,2024-08-23
bc1qcpflj68s3ahy4xajez4d8v3vk28pvf7qte2jmlftvxzfke2u6mqsge3gvh,18.0,2024-08-27 21:14:40,2024-08-27 21:14:40,a8a6f0d5d1773da3d0e14aac3b9cb057a823750450b3b32085a2a681e0f0326e,-2300.000029,18140.998887,2.9e-05,858698,858698,2025-06-19 17:08:07.793113,59570.0,-137011001.72753,sell,12.678464087488589,2024-08-27
bc1qcpflj68s3ahy4xajez4d8v3vk28pvf7qte2jmlftvxzfke2u6mqsge3gvh,18.0,2024-08-28 07:03:59,2024-08-28 11:05:27,"70e46603d579e97f0d7a4c737bca656c9c1abf286ae9a7bce5c803231935b737,5274fb04205e08bd46335716f1751df5269888bdafcb86eeae99896f5d86aad2",1.092e-05,18140.99889792,1.539e-05,858763,858791,2025-06-19 17:08:07.793113,59145.0,0.6458634,buy,6.019514174190298e-08,2024-08-28
bc1qcpflj68s3ahy4xajez4d8v3vk28pvf7qte2jmlftvxzfke2u6mqsge3gvh,18.0,2024-08-31 12:30:00,2024-08-31 12:30:00,f5f3307c1b32ac6395a9a37d587be6d5052050b572992bc73f751cb959c640b9,5.46e-06,18140.99890338,8.34e-06,859226,859226,2025-06-19 17:08:07.793113,59155.0,0.3229863,buy,3.009757086189285e-08,2024-08-31
bc1qcpflj68s3ahy4xajez4d8v3vk28pvf7qte2jmlftvxzfke2u6mqsge3gvh,18.0,2024-09-02 00:07:23,2024-09-02 00:07:23,32215a3617a8a388ee7f0a7d8f55983acd481e0960d14f60c7a77e600e4c473b,500.0,18640.99890338,4.689e-05,859445,859445,2025-06-19 17:08:07.793113,59308.0,29654000.0,buy,2.682259693225665,2024-09-02
bc1qcpflj68s3ahy4xajez4d8v3vk28pvf7qte2jmlftvxzfke2u6mqsge3gvh,18.0,2024-09-06 15:14:17,2024-09-06 15:14:17,c0993d7e833ee17f7f330a01200afdb9f687ab727def6e1fe86a27c3e05d3f94,1000.0,19640.99890338,0.000129,860160,860160,2025-06-19 17:08:07.793113,54133.0,54133000.0,buy,5.091390743002949,2024-09-06
bc1qcpflj68s3ahy4xajez4d8v3vk28pvf7qte2jmlftvxzfke2u6mqsge3gvh,18.0,2024-09-09 14:30:04,2024-09-09 14:30:04,f3ee95845c6163673ddfa6a91d5dedaa4d17a2c8fcb38047839f66d3b37d250c,514.0,20154.99890338,0.00017487,860624,860624,2025-06-19 17:08:07.793113,57110.0,29354540.0,buy,2.550235812286757,2024-09-09
bc1qcpflj68s3ahy4xajez4d8v3vk28pvf7qte2jmlftvxzfke2u6mqsge3gvh,18.0,2024-09-17 18:24:42,2024-09-17 18:24:42,7d20e67fcc2a769cb8cd307398a833c49e4ab69ce9c8d2141050a8e9e9a7a369,-1400.00003938,18754.998864,3.938e-05,861734,861734,2025-06-19 17:08:07.793113,60435.0,-84609002.3799303,sell,7.464676748486952,2024-09-17
bc1qcpflj68s3ahy4xajez4d8v3vk28pvf7qte2jmlftvxzfke2u6mqsge3gvh,18.0,2024-09-19 10:32:50,2024-09-19 10:32:50,8ef257c8d89673ba5a8faae14a56f5eb743114f07bcff90a0fb52266df4fd1b2,458.0,19212.998864,2.1e-05,861955,861955,2025-06-19 17:08:07.793113,63032.0,28868656.0,buy,2.383802774579709,2024-09-19
bc1qcpflj68s3ahy4xajez4d8v3vk28pvf7qte2jmlftvxzfke2u6mqsge3gvh,18.0,2024-09-26 17:06:31,2024-09-26 17:06:31,777abb34d34dd313103661491f174b2f47416b77550ab607c5e9b1d9b4b024e3,-1000.00007022,18212.99879378,7.022e-05,862976,862976,2025-06-19 17:08:07.793113,65307.0,-65307004.58585754,sell,5.4905843982239455,2024-09-26
bc1qcpflj68s3ahy4xajez4d8v3vk28pvf7qte2jmlftvxzfke2u6mqsge3gvh,18.0,2024-09-30 20:24:45,2024-09-30 20:24:45,685bc0746a4018b7183f1b282023447d00cf0f875f5c1e7caaede2abb0689191,6e-06,18212.99879978,4.56e-06,863549,863549,2025-06-19 17:08:07.793113,63468.0,0.38080800000000004,buy,3.2943504065198066e-08,2024-09-30
bc1qcpflj68s3ahy4xajez4d8v3vk28pvf7qte2jmlftvxzfke2u6mqsge3gvh,18.0,2024-10-15 20:21:35,2024-10-15 20:21:35,4b3e39e85c849fc1d5352e9cfbbce5541e572646342e35c743669a360a602db7,-9.219e-05,18212.99870759,9.219e-05,865809,865809,2025-06-19 17:08:07.793113,67123.0,-6.18806937,sell,5.061769425239193e-07,2024-10-15
bc1qcpflj68s3ahy4xajez4d8v3vk28pvf7qte2jmlftvxzfke2u6mqsge3gvh,18.0,2024-10-18 15:48:09,2024-10-18 15:48:09,d5383cc3940087f9b314c3f24bfcdc60f379f9e4b2b63d86e8ce61764d901be1,415.0,18627.99870759,0.00011652,866213,866213,2025-06-19 17:08:07.793113,68368.0,28372720.0,buy,2.2278292290782034,2024-10-18
bc1qcpflj68s3ahy4xajez4d8v3vk28pvf7qte2jmlftvxzfke2u6mqsge3gvh,18.0,2024-10-19 12:52:25,2024-10-19 12:52:25,73e837ae99bd9c45de456dd410833704684d1e268be43101ce4bbd87557660e2,937.0,19564.99870759,5.718e-05,866353,866353,2025-06-19 17:08:07.793113,68360.0,64053320.0,buy,4.789164640407067,2024-10-19
bc1qcpflj68s3ahy4xajez4d8v3vk28pvf7qte2jmlftvxzfke2u6mqsge3gvh,18.0,2024-10-20 13:49:21,2024-10-20 13:49:21,69c11ca9df0fb34835c6ea6d2db1914d0fc8ad6c7195b442bf6336299a78e785,356.0,19920.99870759,0.0001966,866526,866526,2025-06-19 17:08:07.793113,69045.0,24580020.0,buy,1.787058998524819,2024-10-20
bc1qcpflj68s3ahy4xajez4d8v3vk28pvf7qte2jmlftvxzfke2u6mqsge3gvh,18.0,2024-10-21 07:24:34,2024-10-21 07:24:34,d353688f755743c5e7d5f32f01b01e15058ed21f92a1372c20d869167fa6b657,0.01,19921.00870759,4.8e-05,866674,866674,2025-06-19 17:08:07.793113,67425.0,674.25,buy,5.0198261276749256e-05,2024-10-21
bc1qcpflj68s3ahy4xajez4d8v3vk28pvf7qte2jmlftvxzfke2u6mqsge3gvh,18.0,2024-10-30 13:30:12,2024-10-30 20:35:57,"affebd69b670f665fe699374abf2490d412eca36834fb78f25eb608c9306fd1c,a00e1d0c3529df0b42ba68e9c27f7049f54ecd3ee19a909ffea7993abe417580",-4.99000000218075e-05,19921.00865769,8.688000000000001e-05,868098,868153,2025-06-19 17:08:07.793113,72455.0,-3.615504503250122,sell,2.504893245078977e-07,2024-10-30
bc1qcpflj68s3ahy4xajez4d8v3vk28pvf7qte2jmlftvxzfke2u6mqsge3gvh,18.0,2024-11-06 19:31:49,2024-11-06 19:31:49,4bdb2862b14061f839dfd3e606f74a82f60355d7b24b3490a3816253e5f55fd6,304.0,20225.00865769,0.0001181,869171,869171,2025-06-19 17:08:07.793113,75580.0,22976320.0,buy,1.5030895914322016,2024-11-06
bc1qcpflj68s3ahy4xajez4d8v3vk28pvf7qte2jmlftvxzfke2u6mqsge3gvh,18.0,2024-11-07 16:11:50,2024-11-07 16:11:50,75ba0b6edf9768ea77094cf980d5e9fc0bbcc565c1e96e95ca9b6541c1091ea3,277.0,20502.00865769,8.808e-05,869302,869302,2025-06-19 17:08:07.793113,75864.0,21014328.0,buy,1.3510871282170756,2024-11-07
bc1qcpflj68s3ahy4xajez4d8v3vk28pvf7qte2jmlftvxzfke2u6mqsge3gvh,18.0,2024-11-08 13:31:47,2024-11-08 13:31:47,1cd0a79d4b678af75c00dfd95a3aacb762b753834d51a44d8c007b63f0dfd0dd,540.0,21042.00865769,5.743e-05,869430,869430,2025-06-19 17:08:07.793113,76496.0,41307840.0,buy,2.566294923572574,2024-11-08
bc1qcpflj68s3ahy4xajez4d8v3vk28pvf7qte2jmlftvxzfke2u6mqsge3gvh,18.0,2024-11-10 06:45:35,2024-11-10 06:45:35,66935e1ec1c16c4f896fb013547c68a68f9a1f2cdac3e8dd01420215302bc39a,5.46e-06,21042.00866315,6.6e-06,869673,869673,2025-06-19 17:08:07.793113,80367.0,0.43880382,buy,2.5948093109389655e-08,2024-11-10
bc1qcpflj68s3ahy4xajez4d8v3vk28pvf7qte2jmlftvxzfke2u6mqsge3gvh,18.0,2024-11-11 00:34:01,2024-11-11 18:07:06,"dd6dc148194c71ce2cfd6922d743bd99dec0781badcb86919a79777241f8cbbb,de84e26aad492eeb3e8db0ef1f17f16cddc9f6374c1b8d84d343246743036a3b",54.999927000000014,21097.00859015,0.0008251300000000001,869785,869876,2025-06-19 17:08:07.793113,88566.0,4871123.534681998,buy,0.2607001213701879,2024-11-11
bc1qcpflj68s3ahy4xajez4d8v3vk28pvf7qte2jmlftvxzfke2u6mqsge3gvh,18.0,2024-11-14 13:16:05,2024-11-14 13:16:05,eb4557f76c19ab3225d387e9a026120ec26e5ccb0b8412e4b1a139637e8d8444,624.0,21721.00859015,0.00033982,870282,870282,2025-06-19 17:08:07.793113,87407.51273710128,54542287.9479512,buy,2.8727947756669563,2024-11-14
bc1qcpflj68s3ahy4xajez4d8v3vk28pvf7qte2jmlftvxzfke2u6mqsge3gvh,18.0,2024-11-18 14:40:08,2024-11-18 21:25:53,"18f2d589660bfafa18a0da11dae2b3ee73254cdf2c0b955ab993b1dc89e2f679,ad7886024c66c12942af5b3fd27fdb5dc643f024d35de74d37c154c9d898167e,6d5e55092b188d258bdc989a69179b120c0c0bac9c77d4b563ff60f392c74a22,049ca0ad298f99dd3fbfdf1685b4ac200689301f7ad7df75ca541c1dbd9de241",1559.0,23280.00859015,0.00079028,870875,870921,2025-06-19 17:08:07.793113,90534.62459650292,141143479.74594805,buy,6.696732924143458,2024-11-18
bc1qcpflj68s3ahy4xajez4d8v3vk28pvf7qte2jmlftvxzfke2u6mqsge3gvh,18.0,2024-11-19 01:21:52,2024-11-19 23:48:19,"cb97812e006315e7074c383205e100685b755dd74272bd2ac09ecaf014f40c5b,61f0bea3ef804ac711681125f00d9663af0a1eb182480dcc0f6d23940f62cc73,715875d2934199674fc75eb23ba2d5717364e6e2d3f7f2eeeb75dcceebb4670f,33967d506916064149ec2c6c8a42bce025bb55874b1bb935a83cd49307d483ad",1380.0,24660.00859015,0.00095847,870952,871115,2025-06-19 17:08:07.793113,92251.65240738312,127307280.3221887,buy,5.5961051065943925,2024-11-19
bc1qcpflj68s3ahy4xajez4d8v3vk28pvf7qte2jmlftvxzfke2u6mqsge3gvh,18.0,2024-11-20 15:35:28,2024-11-20 23:12:19,"972cad1a4530dd4e2673fb33f8be80ece3de3e9f60e4cc64084d7b3b7f975ed7,95de0cf6ba8f866c4217001f98fa3dbfbe1867a45c3528232f2ab9f075351061",350.0,25010.00859015,0.00029894000000000003,871205,871256,2025-06-19 17:08:07.793113,94217.02229634204,32975957.803719714,buy,1.3994397432468089,2024-11-20
bc1qcpflj68s3ahy4xajez4d8v3vk28pvf7qte2jmlftvxzfke2u6mqsge3gvh,18.0,2024-11-21 23:12:07,2024-11-21 23:12:07,0a71c0c168f2a3879086de4ba90ef725d72b88eb629ab65a942b34c5fc93eed6,288.0,25298.00859015,7.54e-05,871402,871402,2025-06-19 17:08:07.793113,98509.11859102432,28370626.154215004,buy,1.1384295288449515,2024-11-21
bc1qcpflj68s3ahy4xajez4d8v3vk28pvf7qte2jmlftvxzfke2u6mqsge3gvh,18.0,2024-11-25 18:27:32,2024-11-25 21:23:13,"1b841f085e0d998634ed40d25c1758f2e64c9d0689a824cafcc61f3b7c41ba65,0e721a58de305b174c7391b1be666b9f390e5e83639b953ea445010bb8cd7d36,a1b3a87a3ee7cfa03f2a463323c65773877eb9eea4f118ce0264d7284c409a3a",-670.00014538,24628.00844477,0.007156409999999999,871946,871966,2025-06-19 17:08:07.793113,93004.70093103289,-62313163.14481546,sell,2.720480411083671,2024-11-25
bc1qcpflj68s3ahy4xajez4d8v3vk28pvf7qte2jmlftvxzfke2u6mqsge3gvh,18.0,2024-11-26 01:48:55,2024-11-26 16:11:01,"b465c0931c0ffa1a650f6c90bb08beccc32cc064a96b8b440d051e82fa5ffeff,ff0f9659faeceb0cc18bf7f74f0d5c47731e1effaf2d75bf1d0d5cca1246f168",-1835.00029046,22793.00815431,0.00029046,872001,872088,2025-06-19 17:08:07.793113,91931.83077291829,-168694936.17082462,sell,8.05071571964938,2024-11-26
bc1qcpflj68s3ahy4xajez4d8v3vk28pvf7qte2jmlftvxzfke2u6mqsge3gvh,18.0,2024-11-27 02:55:17,2024-11-27 20:56:50,"600c3b4c6029ccb8ce1eac5a2472d5dbdd37d761674b8259283f52f99bea5847,58d2b0687edc57a288bc9edbfca3ca0629ebe112edf68b99356a84c0e9eb814b",-1294.00003752,21499.00811679,0.00055908,872148,872245,2025-06-19 17:08:07.793113,95981.18057210564,-124199651.2615186,sell,6.018882501418425,2024-11-27
bc1qcpflj68s3ahy4xajez4d8v3vk28pvf7qte2jmlftvxzfke2u6mqsge3gvh,18.0,2024-11-28 00:05:36,2024-11-28 00:05:36,628decbb0a79c6778f5a7dfa7e1e3cccd00b7b57d9a1e61e4c1ca3708c79781a,500.0,21999.00811679,0.00011752,872263,872263,2025-06-19 17:08:07.793113,95661.59595817851,47830797.97908926,buy,2.27282974462104,2024-11-28
bc1qcpflj68s3ahy4xajez4d8v3vk28pvf7qte2jmlftvxzfke2u6mqsge3gvh,18.0,2024-12-02 13:53:31,2024-12-02 15:25:57,"3ad8bcd9e8a20f4f630f05f284821f1fafecf0b155b2795c12b1f867cf7fa70e,887caea2470708de44af88ac685095042fd60985dfa0c6c5a6104bf475f8cf6a",663.999,22663.00711679,0.00106938,872919,872927,2025-06-19 17:08:07.793113,95833.1362300365,63633106.62360801,buy,2.9298803842675984,2024-12-02
bc1qcpflj68s3ahy4xajez4d8v3vk28pvf7qte2jmlftvxzfke2u6mqsge3gvh,18.0,2024-12-03 11:24:12,2024-12-03 11:24:12,07583ca9edd272e59a2cf31e557e532a4344943766a9181cfcf90d93fbb87410,300.0,22963.00711679,0.00014016,873061,873061,2025-06-19 17:08:07.793113,96031.63097759832,28809489.2932795,buy,1.3064491008263774,2024-12-03
bc1qcpflj68s3ahy4xajez4d8v3vk28pvf7qte2jmlftvxzfke2u6mqsge3gvh,18.0,2024-12-04 10:12:15,2024-12-04 20:29:13,"eb1e9454efcf583cc9e07bcce5a04a1ad9f79228a8593cabdf5f3a50556618ae,6ce74b76a27d97b4d269c82b53be26df11c14962d956bbd89320adf98238c55c,1aa3001d16adef52fc65942edf2b5b5b753350393bf8c5dbc35125ff8d87797c,b47d23c0f8230b06f951db293e9f80523abbc13032f0ef90a45085878e23f9c6",1040.0,24003.00711679,0.00067035,873199,873259,2025-06-19 17:08:07.793113,98881.4694561823,102836728.2344296,buy,4.33279044971213,2024-12-04
bc1qcpflj68s3ahy4xajez4d8v3vk28pvf7qte2jmlftvxzfke2u6mqsge3gvh,18.0,2024-12-05 17:49:28,2024-12-05 17:49:28,7cfe97afae2d930a0c4bf40e4d6d727d1799204dc2cf5b31676fa07e698a1fc7,1100.0,25103.00711679,0.00017115,873399,873399,2025-06-19 17:08:07.793113,97201.5003640774,106921650.40048513,buy,4.381945138613578,2024-12-05
bc1qcpflj68s3ahy4xajez4d8v3vk28pvf7qte2jmlftvxzfke2u6mqsge3gvh,18.0,2024-12-06 13:47:16,2024-12-06 13:47:16,fa57f001e1634964bdb15a232d2f99434ebc8770e1f8a5c7c5bf1f12abdaa57a,1000.0,26103.00711679,0.00055506,873513,873513,2025-06-19 17:08:07.793113,99973.85150659826,99973851.50659826,buy,3.830976237817363,2024-12-06
bc1qcpflj68s3ahy4xajez4d8v3vk28pvf7qte2jmlftvxzfke2u6mqsge3gvh,18.0,2024-12-07 14:22:56,2024-12-07 14:22:56,0e104948120fea87e54bebd0d2a84f0770eb2a7556343054abb359a065d85955,200.0,26303.00711679,7.092e-05,873657,873657,2025-06-19 17:08:07.793113,99781.82999198174,19956365.99839635,buy,0.7603693338634806,2024-12-07
bc1qcpflj68s3ahy4xajez4d8v3vk28pvf7qte2jmlftvxzfke2u6mqsge3gvh,18.0,2024-12-09 11:25:55,2024-12-09 11:25:55,eaa7101e1bfa982c97357f6388efe15408ce5efc0cdeefa0897a979386195a17,1000.0,27303.00711679,0.00045135,873938,873938,2025-06-19 17:08:07.793113,97353.94700820888,97353947.00820889,buy,3.6626002246655442,2024-12-09
bc1qcpflj68s3ahy4xajez4d8v3vk28pvf7qte2jmlftvxzfke2u6mqsge3gvh,18.0,2024-12-11 20:51:13,2024-12-11 20:51:13,0f938c37f0c950cd8395b3c821626db4ca982798b9dc2cec8999d2b1fa07ff02,400.0,27703.00711679,0.00028468,874303,874303,2025-06-19 17:08:07.793113,101123.61811033696,40449447.244134784,buy,1.4438865727236212,2024-12-11
bc1qcpflj68s3ahy4xajez4d8v3vk28pvf7qte2jmlftvxzfke2u6mqsge3gvh,18.0,2024-12-15 22:07:29,2024-12-15 22:18:38,"9a0b639a469e432b9805eed5b75997d137e22e18ffaa260bbee25f54e05ddabc,ffd48da318d93cba7e461583fece869350bcc0c5edc3ce8550e2b3ff7bc7f754",6.6e-06,27703.00712339,0.01091904,874921,874923,2025-06-19 17:08:07.793113,104721.50151808978,0.6911619100193925,buy,2.382412844426386e-08,2024-12-15
bc1qcpflj68s3ahy4xajez4d8v3vk28pvf7qte2jmlftvxzfke2u6mqsge3gvh,18.0,2024-12-20 01:27:57,2024-12-20 14:22:00,"27866f90f37dc64bb09c33309c37e384bbd0475833b52f5c0ed9b9f4c791a264,b6c27b7d2c8f1cc988bc5b67c3e69ea8ff15ab74284c79578d033e7a0892e1a6,b61b7debc2db24cb28cff126407d7f3f30b866822fa587aadd337aed1babb063",-1000.00042839,26703.006695,0.00044277,875520,875600,2025-06-19 17:08:07.793113,97691.43431692652,-97691476.16696006,sell,3.7448982424037105,2024-12-20
bc1qcpflj68s3ahy4xajez4d8v3vk28pvf7qte2jmlftvxzfke2u6mqsge3gvh,18.0,2024-12-23 01:04:33,2024-12-23 22:08:00,"509dc7af05e58b00f74aeeb48ce697be460418f5d7bb59bdec5b9348992b00c0,f10550a73bc6fd952a256dec638e18784c861252829e5bdb16e4bb2e7a2d9a0b",-500.000053,26203.006642,5.3e-05,875966,876088,2025-06-19 17:08:07.793113,94644.9108546432,-47322460.443501875,sell,1.9081781714261947,2024-12-23
bc1qcpflj68s3ahy4xajez4d8v3vk28pvf7qte2jmlftvxzfke2u6mqsge3gvh,18.0,2024-12-25 12:37:58,2024-12-25 12:37:58,af2eac75a3171c1c893970dd21bc94d9c4377a85598761fe96cdb05458662b85,5.47e-06,26203.00664747,4.96e-06,876315,876315,2025-06-19 17:08:07.793113,99344.95417367227,0.5434168993299874,buy,2.0875466978245223e-08,2024-12-25
bc1qcpflj68s3ahy4xajez4d8v3vk28pvf7qte2jmlftvxzfke2u6mqsge3gvh,18.0,2024-12-26 12:10:34,2024-12-26 12:10:34,c64fc3f14f64695e23bdae5c5be6d409a05c2cf47c6902c75950bf85a9875a58,5.46e-06,26203.00665293,6.6e-06,876446,876446,2025-06-19 17:08:07.793113,95678.31244565404,0.5224035859532711,buy,2.083730341452807e-08,2024-12-26
bc1qcpflj68s3ahy4xajez4d8v3vk28pvf7qte2jmlftvxzfke2u6mqsge3gvh,18.0,2024-12-30 01:41:30,2024-12-30 23:53:50,"59786a1440debaf5b1a4a10b2e834ba9d4f416be1425f52051fdd2c05ffecebf,8eb79ad8871659b45bcf852545fc2f96b0d984b975e48d43cc4e530cd3361f85,e954aaa887c9c090c535cace38b6864c0b96f5d4c211d769c6a82f4ac5617738",-1538.0000429299998,24665.00661,5.139e-05,876979,877129,2025-06-19 17:08:07.793113,92627.28213113274,-142460763.89417142,sell,6.235554959496521,2024-12-30
bc1qcpflj68s3ahy4xajez4d8v3vk28pvf7qte2jmlftvxzfke2u6mqsge3gvh,18.0,2025-01-09 04:13:40,2025-01-09 04:13:40,521567aca301837c82439538bda174d3a1fdd23842fcb3fe89ffcf012c7981d9,5.46e-06,24665.00661546,3.08e-06,878427,878427,2025-06-19 17:08:07.793113,92376.275783461,0.5043744657776971,buy,2.2136624916117713e-08,2025-01-09
bc1qcpflj68s3ahy4xajez4d8v3vk28pvf7qte2jmlftvxzfke2u6mqsge3gvh,18.0,2025-01-10 04:11:36,2025-01-10 04:11:36,d284408c8d77e5f00076aa1abe2edeb1ff446826739729b8ab37cc221e291296,-1881.00002546,22784.00659,2.546e-05,878587,878587,2025-06-19 17:08:07.793113,94736.6267420969,-178199597.31387877,sell,8.255791263181862,2025-01-10
bc1qcpflj68s3ahy4xajez4d8v3vk28pvf7qte2jmlftvxzfke2u6mqsge3gvh,18.0,2025-01-11 20:21:50,2025-01-11 20:21:50,585dd711e1049bfddf788411c8cf7188f1fd65b5efd72f8e15a3101887fc1381,5.66e-06,22784.00659566,1.72e-06,878819,878819,2025-06-19 17:08:07.793113,94559.55167224212,0.5352070624648904,buy,2.4841987190602998e-08,2025-01-11
bc1qcpflj68s3ahy4xajez4d8v3vk28pvf7qte2jmlftvxzfke2u6mqsge3gvh,18.0,2025-01-14 02:49:46,2025-01-14 02:49:46,a483fb39e745c32244bae00ac81b80dfcc6221c0468942b5deb82eb9728f2259,-1500.00005366,21284.006542,5.366e-05,879155,879155,2025-06-19 17:08:07.793113,96574.07768799194,-144861121.71415293,sell,7.047545539417266,2025-01-14
bc1qcpflj68s3ahy4xajez4d8v3vk28pvf7qte2jmlftvxzfke2u6mqsge3gvh,18.0,2025-01-17 13:51:00,2025-01-17 16:59:14,"fd2ca2c5e3e6016aae41648d4c8f0bd333955e365587ce029fef4187e0ac84b1,d582f8482a538b6d01edd2d60fe3906ae4c7d3930ba8eb0957dd2e4bd74c9835,109ad58cfb1746e7ae712b25648efc2a5b629af18693ae6340f734e2d66a41ad",2899.99997,24184.006512,0.0008901600000000001,879645,879660,2025-06-19 17:08:07.793113,104160.69358484232,302066008.27122194,buy,11.991395919286708,2025-01-17
bc1qcpflj68s3ahy4xajez4d8v3vk28pvf7qte2jmlftvxzfke2u6mqsge3gvh,18.0,2025-01-20 23:23:53,2025-01-20 23:23:53,35017fe407c5563e18f88589d3e42d44f9e0ca7c64af8ca30830b84a490aa446,3.3e-06,24184.0065153,0.00622549,880136,880136,2025-06-19 17:08:07.793113,101764.90860170544,0.33582419838562794,buy,1.3645381702623415e-08,2025-01-20
bc1qcpflj68s3ahy4xajez4d8v3vk28pvf7qte2jmlftvxzfke2u6mqsge3gvh,18.0,2025-01-30 15:19:23,2025-01-30 15:25:40,"9085ddb3a719471977998973553a8b7344bb22a57c7330a9d9b308a530083eda,ef3c5386e026315b9775f95060d7569b7bd113b4555d2701c0d120d41fc05513",-557.0000073,23627.006508,2.022e-05,881509,881510,2025-06-19 17:08:07.793113,104781.5135100103,-58363303.789980784,sell,2.3574717648272636,2025-01-30
bc1qcpflj68s3ahy4xajez4d8v3vk28pvf7qte2jmlftvxzfke2u6mqsge3gvh,18.0,2025-02-03 02:01:54,2025-02-03 02:01:54,ad154ecc2457c6bb533d1a54e5e39e05f3578bf89f3cede3d4d77447f4766fe1,568.0,24195.006508,0.00010566,882065,882065,2025-06-19 17:08:07.793113,101466.8606657039,57633176.858119816,buy,2.3475918463266074,2025-02-03
bc1qcpflj68s3ahy4xajez4d8v3vk28pvf7qte2jmlftvxzfke2u6mqsge3gvh,18.0,2025-02-07 13:14:57,2025-02-07 22:55:36,"63cedca82ba573a82cb3d3ae245f8024fd8aefa348926152597b34d039fa7607,ad9f9a82815f3d1bbd4f3934d785c7e8a655db230c4c8230dd5c130851e06b8a",-844.220039,23350.786469,3.9e-05,882713,882790,2025-06-19 17:08:07.793113,96558.4563096667,-81516583.75152662,sell,3.6153816066142714,2025-02-07
bc1qcpflj68s3ahy4xajez4d8v3vk28pvf7qte2jmlftvxzfke2u6mqsge3gvh,18.0,2025-02-09 22:50:53,2025-02-09 22:50:53,4cdebb0a0abd0d5e2840c63d9057faa229dd95f90d01da94e4c7aafeefb5523f,-2164.000009,21186.78646,9e-06,883095,883095,2025-06-19 17:08:07.793113,96548.57865379583,-208931125.07575136,sell,10.213913342099168,2025-02-09
bc1qcpflj68s3ahy4xajez4d8v3vk28pvf7qte2jmlftvxzfke2u6mqsge3gvh,18.0,2025-02-13 13:05:20,2025-02-13 13:05:20,a9024deb5452da3b1ba87aad042aa74421c65943910b1cf26c88753dd65fc635,-630.000011,20556.786449,1.1e-05,883579,883579,2025-06-19 17:08:07.793113,96561.6639990985,-60833849.381610356,sell,3.0646814012637016,2025-02-13
bc1qcpflj68s3ahy4xajez4d8v3vk28pvf7qte2jmlftvxzfke2u6mqsge3gvh,18.0,2025-02-14 02:42:44,2025-02-14 02:42:44,eb0a6c13d79a22bb882a393e99839748fb299b469de21f32f641f1d7168b8dfe,-1790.000013,18766.786436,1.3e-05,883665,883665,2025-06-19 17:08:07.793113,97488.48148536457,-174504383.12615284,sell,9.538127473792073,2025-02-14
bc1qcpflj68s3ahy4xajez4d8v3vk28pvf7qte2jmlftvxzfke2u6mqsge3gvh,18.0,2025-02-17 14:07:17,2025-02-17 14:08:06,"c472207c332de8ae24990214f5e22ec04347ec10d61ce3825a5a6c106ffaae7e,a3613b31f5f08079c1079de2136026f9480c582ef8169324fc59d3ae8bf9f51a",-1034.3799980000001,17732.406438,1.092e-05,884192,884194,2025-06-19 17:08:07.793113,95776.15723852724,-99068941.33283551,sell,5.833274810255621,2025-02-17
bc1qcpflj68s3ahy4xajez4d8v3vk28pvf7qte2jmlftvxzfke2u6mqsge3gvh,18.0,2025-02-19 03:46:33,2025-02-19 03:46:33,ce2511af81541bd1bd231826aab00dce7836c3c90bff56a9e6d3a275729c05e2,-2424.000008,15308.40643,8e-06,884412,884412,2025-06-19 17:08:07.793113,96554.87156259285,-234049009.44016403,sell,15.834437236064423,2025-02-19
bc1qcpflj68s3ahy4xajez4d8v3vk28pvf7qte2jmlftvxzfke2u6mqsge3gvh,18.0,2025-02-20 21:52:31,2025-02-20 21:52:31,9573032052e933b6edd21e3ede4ca6413db51b1aa1b1e2a2a5beca90ecd63572,1e-05,15308.40644,6.12e-06,884629,884629,2025-06-19 17:08:07.793113,98384.31738240314,0.9838431738240315,buy,6.532358569910038e-08,2025-02-20
bc1qcpflj68s3ahy4xajez4d8v3vk28pvf7qte2jmlftvxzfke2u6mqsge3gvh,18.0,2025-02-25 22:11:57,2025-02-25 22:39:21,"e285fbe1127ccc24d5d9f45f9e2a079c06f4ab77c46c67a91d4b9e503fd6990d,2e4eb594d88797ae77e323645c0aa9f30dc7f963335f5784f4ccd587a4904098",-3400.000102,11908.406338,0.000102,885308,885312,2025-06-19 17:08:07.793113,88755.7693356979,-301769624.79446137,sell,28.551260391161836,2025-02-25
bc1qcpflj68s3ahy4xajez4d8v3vk28pvf7qte2jmlftvxzfke2u6mqsge3gvh,18.0,2025-03-19 16:57:51,2025-03-19 16:57:51,1f1bd7e737d9878fb2b6600014613d614f5ba5684c1a542ec305e839bf209bab,840.0,12748.406338,0.0001806,888506,888506,2025-06-19 17:08:07.793113,86815.44109470697,72924970.51955386,buy,6.589058881000345,2025-03-19
bc1qcpflj68s3ahy4xajez4d8v3vk28pvf7qte2jmlftvxzfke2u6mqsge3gvh,18.0,2025-03-23 11:17:25,2025-03-23 11:17:25,4a2bf9b576e317cc393817e4d010284f91de34788d375a33902111f90980b7b7,2e-05,12748.406358,4.21e-06,889057,889057,2025-06-19 17:08:07.793113,85787.70914901773,1.7157541829803546,buy,1.5688235406341135e-07,2025-03-23
bc1qcpflj68s3ahy4xajez4d8v3vk28pvf7qte2jmlftvxzfke2u6mqsge3gvh,18.0,2025-03-24 08:50:52,2025-03-24 14:19:36,"ada133a7ddefa7e6ccdfd423cf32b84a86dcfa86efe54b60100d17756b741e68,c58d48c0d1b244b02513790e8d9003576c74edeffee9b76b0b7d96325ac364bc",2425.0,15173.406358,0.0005086,889206,889237,2025-06-19 17:08:07.793113,87327.72969669085,211769744.51447532,buy,15.981909024149,2025-03-24
bc1qcpflj68s3ahy4xajez4d8v3vk28pvf7qte2jmlftvxzfke2u6mqsge3gvh,18.0,2025-03-25 00:17:31,2025-03-25 00:17:31,94e115d7a146aef2f4a2b41ecf7fcb68dc6f17dc6a77a0cc2d4a1d7c664650a7,813.0,15986.406358,0.0001585,889297,889297,2025-06-19 17:08:07.793113,87520.58391530563,71154234.72314347,buy,5.085570714228432,2025-03-25
bc1qcpflj68s3ahy4xajez4d8v3vk28pvf7qte2jmlftvxzfke2u6mqsge3gvh,18.0,2025-03-28 08:54:45,2025-03-28 08:54:45,c6c07a10bf8677cfb04b92fc47ee364ca69fd4558f180ed16c28c447e581f48a,5.46e-06,15986.40636346,3e-06,889808,889808,2025-06-19 17:08:07.793113,84359.46915506005,0.4606027015866279,buy,3.415401733112376e-08,2025-03-28
bc1qcpflj68s3ahy4xajez4d8v3vk28pvf7qte2jmlftvxzfke2u6mqsge3gvh,18.0,2025-03-30 03:18:35,2025-03-30 03:21:17,"20644af039cc383818a504bd5822ef0ff7cd22773a8b22dd8f86677bcfad1e36,dd595d524dc4623fcafc59d10cc95d5f12c90a1fc3ae29e1fa6490486951fd25",-4000.00002246,11986.406341,3.538e-05,890062,890063,2025-06-19 17:08:07.793113,82356.38111183756,-329425526.29707456,sell,33.37113650801103,2025-03-30
bc1qcpflj68s3ahy4xajez4d8v3vk28pvf7qte2jmlftvxzfke2u6mqsge3gvh,18.0,2025-04-02 16:10:05,2025-04-02 18:52:23,"991d307c73db8d95314492b6f73ce5948416f21cba6f7dcc98c9b098a74fdbb9,9f2eef9697582ca9117f7a723c3f52ff2476133a2a9c02532ec54dc094812643",2050.0,14036.406341,0.00035308,890580,890598,2025-06-19 17:08:07.793113,82526.4221526433,169179165.41291875,buy,14.604877845492403,2025-04-02
bc1qcpflj68s3ahy4xajez4d8v3vk28pvf7qte2jmlftvxzfke2u6mqsge3gvh,18.0,2025-04-06 12:02:28,2025-04-06 12:02:28,3355e4a69dbb3699f215ec30de7420bd373a0fa52bb7014aa365fa16dc502466,-1928.430012,12107.976329,1.2e-05,891185,891185,2025-06-19 17:08:07.793113,78211.48358199988,-150825372.22257385,sell,15.926939065623937,2025-04-06
bc1qcpflj68s3ahy4xajez4d8v3vk28pvf7qte2jmlftvxzfke2u6mqsge3gvh,18.0,2025-04-07 07:42:39,2025-04-07 07:42:39,b5039ed9046db1840c88bffdd58867db1d3b5847edb460c85a08e3721f31a066,500.0,12607.976329,5.068e-05,891312,891312,2025-06-19 17:08:07.793113,79179.29226757778,39589646.13378889,buy,3.9657434861289707,2025-04-07
bc1qcpflj68s3ahy4xajez4d8v3vk28pvf7qte2jmlftvxzfke2u6mqsge3gvh,18.0,2025-04-09 19:12:24,2025-04-09 19:40:29,"9afda18c34f35b850f9a2e09eb6ba20cf6d9a2b800a90e3fb25b22f4f7e8a8e3,e1d6ba5b61333c77894f420cdedb447da21a2906988e1aa628c420f7afd5606a",1800.0,14407.976329,0.0003548,891676,891679,2025-06-19 17:08:07.793113,82622.17029546302,148719906.5318334,buy,12.493079936403053,2025-04-09
bc1qcpflj68s3ahy4xajez4d8v3vk28pvf7qte2jmlftvxzfke2u6mqsge3gvh,18.0,2025-04-11 11:24:17,2025-04-11 21:23:46,"ed0f3575f4325f193b971d5eb50c43b00ea2ef3074a223f37a15aa7bb3aba311,090150a8d0822e56ca5d15c04fa86dd9df8775f9171b7186b76f0f23f6ee57be",1.092e-05,14407.97633992,3.35e-06,891920,891979,2025-06-19 17:08:07.793113,83439.28818043756,0.9111570269303783,buy,7.579135155673523e-08,2025-04-11
bc1qcpflj68s3ahy4xajez4d8v3vk28pvf7qte2jmlftvxzfke2u6mqsge3gvh,18.0,2025-04-14 15:32:38,2025-04-14 20:45:21,"d6ad364355148d7e8cc2abd2a031b8d1569bb6ce210c20cd10da519be2ef3678,f87f25686b70a45f7fbbbb2af326c0b642e7570338479b6d4f10219f68b52dcc,64d9052fedb18323d095996b2ab87f391593351e68d077ee3980fddb31d9fd00,2fda9cb0c718ad6dc4f02c677e34c25fd96c3ca83dab83fbd7a2489b2c286069",2371.9999919399997,16779.97633186,0.00022358,892398,892436,2025-06-19 17:08:07.793113,84523.4524914945,200489628.62856594,buy,14.135895933513943,2025-04-14
bc1qcpflj68s3ahy4xajez4d8v3vk28pvf7qte2jmlftvxzfke2u6mqsge3gvh,18.0,2025-04-15 13:43:04,2025-04-15 14:16:02,"65d741018cfe3914967705803b9a2abe51e4296bc94f78c74495b62ec0b11e1f,88723184ed86367c3fe59c4c2ef7463f0728be93c4741d29c047912829294128",1332.0,18111.97633186,0.0001973,892550,892553,2025-06-19 17:08:07.793113,83656.49248858042,111430447.99478912,buy,7.354249892966876,2025-04-15
bc1qcpflj68s3ahy4xajez4d8v3vk28pvf7qte2jmlftvxzfke2u6mqsge3gvh,18.0,2025-04-16 12:29:21,2025-04-16 12:29:21,46832d7c4e8ee534afed9f21c81e9f88d622614cbeef6b00eda2a6a35dc04aca,3.3e-06,18111.97633516,0.00098602,892678,892678,2025-06-19 17:08:07.793113,84105.77942167096,0.2775490720915142,buy,1.8219988470246907e-08,2025-04-16
bc1qcpflj68s3ahy4xajez4d8v3vk28pvf7qte2jmlftvxzfke2u6mqsge3gvh,18.0,2025-04-22 15:36:08,2025-04-22 15:36:08,ff279cf12087b20bd4096ec196af4daab61470613948fad42b2fc014087e3208,1000.0,19111.97633516,0.000268,893526,893526,2025-06-19 17:08:07.793113,93576.1658857398,93576165.8857398,buy,5.232321254816101,2025-04-22
bc1qcpflj68s3ahy4xajez4d8v3vk28pvf7qte2jmlftvxzfke2u6mqsge3gvh,18.0,2025-04-26 13:33:40,2025-04-26 13:33:40,01184e5e663c69268d644b068840d86b6cea655a13df1a3b9fee9bfac4038dcc,-1000.00007016,18111.976265,7.016e-05,894067,894067,2025-06-19 17:08:07.793113,94644.06637120109,-94644073.01142877,sell,5.521209036102941,2025-04-26
bc1qcpflj68s3ahy4xajez4d8v3vk28pvf7qte2jmlftvxzfke2u6mqsge3gvh,18.0,2025-05-07 22:58:49,2025-05-07 22:58:49,001464d15ba6d25f693aea7628ebc6f6c51684ee9bd66631dfeac269986a6294,-2000.000018,16111.976247,1.8e-05,895721,895721,2025-06-19 17:08:07.793113,97026.493769668,-194052989.28581288,sell,12.413126653984447,2025-05-07
bc1qcpflj68s3ahy4xajez4d8v3vk28pvf7qte2jmlftvxzfke2u6mqsge3gvh,18.0,2025-05-15 09:51:07,2025-05-15 14:03:28,"9835b9d24b0094d46ea30bff886612e2b643131e3f956ee616f13c155ac748fb,a8c7d7c527f3379abbb49ea2a5bf0e00229d8d4d21c61c534c8b339c5743b038,2bbc84ef1bcacc2c2aa45ed68531df017c90e0a22cca8ca4a8de9504532acc8d",3261.0,19372.976247,0.000623,896811,896836,2025-06-19 17:08:07.793113,103708.8513642364,338194564.2987749,buy,16.832725949916867,2025-05-15
bc1qcpflj68s3ahy4xajez4d8v3vk28pvf7qte2jmlftvxzfke2u6mqsge3gvh,18.0,2025-05-19 16:57:28,2025-05-19 16:57:28,8da43491f7b73ab505dd125f863051d2987dd0a781704b95d1aab466f6bb28fb,1350.0,20722.976247,0.0002519,897431,897431,2025-06-19 17:08:07.793113,105629.41580436694,142599711.3358954,buy,6.514508263239627,2025-05-19
bc1qcpflj68s3ahy4xajez4d8v3vk28pvf7qte2jmlftvxzfke2u6mqsge3gvh,18.0,2025-05-21 08:33:48,2025-05-21 08:33:48,2aff9437b45abccdb9c8f3a0928753cd29a7bed252d2ff87f06d105cac2ed45e,1500.0,22222.976247,0.0002406,897669,897669,2025-06-19 17:08:07.793113,109665.86371625264,164498795.57437897,buy,6.7497709727449005,2025-05-21
bc1qcpflj68s3ahy4xajez4d8v3vk28pvf7qte2jmlftvxzfke2u6mqsge3gvh,18.0,2025-05-23 08:39:43,2025-05-23 17:36:47,"52305441c5f9235a8c4d8a21a83a7cd2ff5976c5528ec667a866b1e24e1c2d27,3c31e5e47abea1e4673f778414a9e18adf7471a720b38b8ed0dd503fa5b2a451,0ce13ac5b467f5a60126a53d7be96e1ad928cdeb399031d6647ddbaf60912eef",1698.00001,23920.976257,0.00039003999999999997,897976,898035,2025-06-19 17:08:07.793113,107216.66856870624,182053904.30182987,buy,7.098372540305975,2025-05-23
bc1qcpflj68s3ahy4xajez4d8v3vk28pvf7qte2jmlftvxzfke2u6mqsge3gvh,18.0,2025-05-28 06:19:06,2025-05-28 06:19:06,79e9092ff3d4e5666255b643e43ecbc8bf6f5e21f56777e333c5315f76ea77c3,-712.0001266,23208.9761304,0.0001266,898699,898699,2025-06-19 17:08:07.793113,107838.18431100152,-76780800.88174722,sell,3.0677791325201773,2025-05-28
bc1qcpflj68s3ahy4xajez4d8v3vk28pvf7qte2jmlftvxzfke2u6mqsge3gvh,18.0,2025-06-01 09:48:57,2025-06-01 09:48:57,da6c78cfe08b28594c57b2f99c8d00a2f93d3b6bbed8175e5fd4988eff5bfd5d,-678.00000497,22530.97612543,4.97e-06,899340,899340,2025-06-19 17:08:07.793113,105710.00593822816,-71671384.55149741,sell,3.0091905525778033,2025-06-01
bc1qcpflj68s3ahy4xajez4d8v3vk28pvf7qte2jmlftvxzfke2u6mqsge3gvh,18.0,2025-06-05 07:08:16,2025-06-05 07:08:16,1fdc3d7e2055b782744c47368493290276a5feeefcfaf84b13c8880d4ab254b7,1000.0,23530.97612543,3.069e-05,899870,899870,2025-06-19 17:08:07.793113,101650.7387545425,101650738.7545425,buy,4.249717456129229,2025-06-05
bc1qcpflj68s3ahy4xajez4d8v3vk28pvf7qte2jmlftvxzfke2u6mqsge3gvh,18.0,2025-06-09 06:23:28,2025-06-09 06:23:28,74bc8536f093aff422dc4247ac6e33c68a1c6c212fbd965e0c3f50f69bf192ce,875.0,24405.97612543,4.65e-05,900440,900440,2025-06-19 17:08:07.793113,110261.57485948496,96478878.00204934,buy,3.5851874782762194,2025-06-09
